Account,Flag,Cleared,Check Number,Date,Payee,Category,Master Category,Sub Category,Memo,Outflow,Inflow,Running Balance
"Avidia Checking",,U,,06/08/2013,"",,,,"",$0.00,$0.00,$0.00
"Avidia Checking",,U,,06/09/2013,"Starting Balance","Income : Available this month","Income","Available this month","Starting balance",$0.00,$6865.05,$6865.05
"Avidia Checking",,U,,06/10/2013,"Transfer : Target",,,,"",$17.16,$0.00,$6847.89
"Avidia Checking",,U,,06/10/2013,"NGRID","Housing : Electricity","Hidden Categories","Housing ` Electricity","",$65.20,$0.00,$6782.69
"Avidia Checking",,U,,06/11/2013,"Isa Mattei","Personal : Gifts","Personal","Gifts","Laura B-Day",$55.00,$0.00,$6727.69
"Avidia Checking",,U,,06/11/2013,"Carleen Wilkish","Personal : Miscellaneous","Personal","Miscellaneous","",$69.00,$0.00,$6658.69
"Avidia Checking",,U,,06/12/2013,"Bancroft Schoole","Education : bancroft","Education","bancroft","Sports night",$30.00,$0.00,$6628.69
"Avidia Checking",,U,,06/15/2013,"softright","Income : Available next month","Income","Available next month","Salary",$0.00,$3267.66,$9896.35
"Avidia Checking",,U,,06/16/2013,"Lovely Valentine","Personal : Gifts","Personal","Gifts","?",$50.00,$0.00,$9846.35
"Avidia Checking",,U,,06/17/2013,"Transfer : Target Lisa",,,,"",$116.71,$0.00,$9729.64
"Avidia Checking",,U,,06/18/2013,"nstart","Housing : Gas","Hidden Categories","Housing ` Gas","",$57.10,$0.00,$9672.54
"Avidia Checking",,U,,06/19/2013,"Cliff Lander","Personal : Gifts","Personal","Gifts","Birthday/Fathers day",$200.00,$0.00,$9472.54
"Avidia Checking",,U,,06/20/2013,"","Income : Available next month","Income","Available next month","",$0.00,$383.38,$9855.92
"Avidia Checking",,U,,06/24/2013,"Misc Income?","Income : Available next month","Income","Available next month","",$0.00,$160.00,$10015.92
"Avidia Checking",,U,,06/24/2013,"avidia bank","Personal : Miscellaneous","Personal","Miscellaneous","Bank fee",$2.00,$0.00,$10013.92
"Avidia Checking",,U,,06/24/2013,"avidia bank","Personal : Miscellaneous","Personal","Miscellaneous","bank fee",$2.50,$0.00,$10011.42
"Avidia Checking",,U,,06/24/2013,"SMG","Personal : Doctor, Dentist","Personal","Doctor, Dentist","Lisa Medical",$5.00,$0.00,$10006.42
"Avidia Checking",,U,,06/24/2013,"","Recreation : Entertainment","Recreation","Entertainment","(Split 1/2) Mini golf",$40.00,$0.00,$9926.42
"Avidia Checking",,U,,06/24/2013,"","Food : Restaurants","Food","Restaurants","(Split 2/2) ",$40.00,$0.00,$9926.42
"Avidia Checking",,U,,06/28/2013,"softright","Income : Available next month","Income","Available next month","Salray",$0.00,$3267.67,$13194.09
"Avidia Checking",,U,,07/01/2013,"Bancroft Schoole","Education : bancroft","Education","bancroft","",$1.33,$0.00,$13192.76
"Avidia Checking",,U,,07/01/2013,"Save the children","Charity : Other","Charity","Other","",$28.00,$0.00,$13164.76
"Avidia Checking",,U,,07/03/2013,"Pumpkin Brook","Income : Available this month","Income","Available this month","",$0.00,$397.62,$13562.38
"Avidia Checking",,U,,07/03/2013,"verizon wireless","Housing : Cell Phones","Hidden Categories","Housing ` Cell Phones","",$93.79,$0.00,$13468.59
"Avidia Checking",,U,,07/03/2013,"Transfer : Discover",,,,"",$4437.74,$0.00,$9030.85
"Avidia Checking",,U,,07/05/2013,"Transfer : Lisa Cash Account",,,,"",$50.00,$0.00,$8980.85
"Avidia Checking",,U,,07/08/2013,"interest","Income : Available this month","Income","Available this month","",$0.00,$0.39,$8981.24
"Avidia Checking",,U,,07/08/2013,"Shell","Personal : Gifts","Personal","Gifts","alex",$20.00,$0.00,$8961.24
"Avidia Checking",,U,,07/08/2013,"SMG","Personal : Doctor, Dentist","Personal","Doctor, Dentist","",$20.00,$0.00,$8941.24
"Avidia Checking",,U,,07/08/2013,"verizon fios","Housing : Phone & Internet","Hidden Categories","Housing ` Phone & Internet","",$163.51,$0.00,$8777.73
"Avidia Checking",,U,,07/08/2013,"Westwind Equestrian","Recreation : Alyssa Horse","Recreation","Alyssa Horse","",$191.00,$0.00,$8586.73
"Avidia Checking",,U,,07/09/2013,"Mong & Associates","Education : bancroft","Education","bancroft","Bancroft commencement #4076",$20.00,$0.00,$8566.73
"Avidia Checking",,U,,07/09/2013,"azrael Acres","Recreation : Alyssa Horse","Recreation","Alyssa Horse","",$160.00,$0.00,$8406.73
"Avidia Checking",,U,,07/10/2013,"NGRID","Housing : Electricity","Hidden Categories","Housing ` Electricity","",$81.99,$0.00,$8324.74
"Avidia Checking",,U,,07/11/2013,"Mile Stone Stable","Recreation : Alyssa Horse","Recreation","Alyssa Horse","",$50.00,$0.00,$8274.74
"Avidia Checking",,U,,07/15/2013,"softright","Income : Available next month","Income","Available next month","",$0.00,$3267.66,$11542.40
"Avidia Checking",,U,,07/15/2013,"Transfer : Target Lisa",,,,"",$563.64,$0.00,$10978.76
"Avidia Checking",,U,,07/18/2013,"Pumpkin Brook","Income : Available next month","Income","Available next month","",$0.00,$315.38,$11294.14
"Avidia Checking",,U,,07/18/2013,"SMG","Personal : Doctor, Dentist","Personal","Doctor, Dentist","",$5.00,$0.00,$11289.14
"Avidia Checking",,U,,07/18/2013,"nstar","Housing : Gas","Hidden Categories","Housing ` Gas","",$46.19,$0.00,$11242.95
"Avidia Checking",,U,,07/19/2013,"Transfer : DCU Savings",,,,"",$1000.00,$0.00,$10242.95
"Avidia Checking",,U,,07/23/2013,"Mount Holyoke","Education : College","Education","College","",$35.00,$0.00,$10207.95
"Avidia Checking",,U,,07/23/2013,"Mount Holyoke","Education : College","Education","College","",$3284.00,$0.00,$6923.95
"Avidia Checking",,U,,07/24/2013,"bank fee","Personal : Miscellaneous","Personal","Miscellaneous","",$2.50,$0.00,$6921.45
"Avidia Checking",,U,,07/24/2013,"bank fee","Personal : Miscellaneous","Personal","Miscellaneous","",$3.00,$0.00,$6918.45
"Avidia Checking",,U,,07/24/2013,"Transfer : Lisa Cash Account",,,,"",$80.00,$0.00,$6838.45
"Avidia Checking",,U,,07/29/2013,"Pirates Cove","Personal : Gifts","Personal","Gifts","",$15.92,$0.00,$6822.53
"Avidia Checking",,U,,07/29/2013,"MFA Parking","Recreation : Hers","Recreation","Hers","",$17.00,$0.00,$6805.53
"Avidia Checking",,U,,07/29/2013,"MFA","Recreation : Hers","Recreation","Hers","",$43.00,$0.00,$6762.53
"Avidia Checking",,U,,07/29/2013,"Marlboro","Housing : Real Estate Tax","Hidden Categories","Housing ` Real Estate Tax","",$1241.53,$0.00,$5521.00
"Avidia Checking",,U,,07/30/2013,"Fastlane","Transportation : tolls","Transportation","tolls","",$10.40,$0.00,$5510.60
"Avidia Checking",,U,,07/31/2013,"softright","Income : Available next month","Income","Available next month","",$0.00,$3267.66,$8778.26
"Avidia Checking",,U,,08/01/2013,"Pumpkin Brook","Income : Available next month","Income","Available next month","",$0.00,$360.71,$9138.97
"Avidia Checking",,U,,08/01/2013,"Save the children","Charity : Other","Charity","Other","",$28.00,$0.00,$9110.97
"Avidia Checking",,U,,08/01/2013,"verizon wireless","Housing : Cell Phones","Hidden Categories","Housing ` Cell Phones","",$93.77,$0.00,$9017.20
"Avidia Checking",,U,,08/05/2013,"mcqaudes Market","Food : Groceries","Food","Groceries","",$33.15,$0.00,$8984.05
"Avidia Checking",,U,,08/05/2013,"verizon fios","Housing : Phone & Internet","Hidden Categories","Housing ` Phone & Internet","",$184.43,$0.00,$8799.62
"Avidia Checking",,U,,08/05/2013,"Transfer : Discover",,,,"",$2137.62,$0.00,$6662.00
"Avidia Checking",,U,,08/08/2013,"interest","Income : Available this month","Income","Available this month","",$0.00,$0.36,$6662.36
"Avidia Checking",,U,,08/08/2013,"Kelsey Herring","Recreation : Alyssa Horse","Recreation","Alyssa Horse","Riding boots",$100.00,$0.00,$6562.36
"Avidia Checking",,U,,08/09/2013,"Transfer : avidia - Lisa Business",,,,"",$0.00,$1500.00,$8062.36
"Avidia Checking",,U,,08/09/2013,"Rachel Miller","Recreation : Alyssa Horse","Recreation","Alyssa Horse","",$110.00,$0.00,$7952.36
"Avidia Checking",,U,,08/12/2013,"Sudbury Valley trustees","Charity : Other","Charity","Other","",$50.00,$0.00,$7902.36
"Avidia Checking",,U,,08/12/2013,"Transfer : Robert Cash Account",,,,"",$100.00,$0.00,$7802.36
"Avidia Checking",,U,,08/12/2013,"Block Island Hotel","Recreation : Vacation","Recreation","Vacation","Room on block island we ended up cancelling",$101.14,$0.00,$7701.22
"Avidia Checking",,U,,08/12/2013,"NGRID","Housing : Electricity","Hidden Categories","Housing ` Electricity","",$142.99,$0.00,$7558.23
"Avidia Checking",,U,,08/13/2013,"Safety Insurane","Housing : House/Rental Insurance","Hidden Categories","Housing ` House/Rental Insurance","",$1050.00,$0.00,$6508.23
"Avidia Checking",,U,,08/13/2013,"Mount Holyoke","Education : College","Education","College","",$3284.25,$0.00,$3223.98
"Avidia Checking",,U,,08/14/2013,"Transfer : Lisa Cash Account",,,,"",$100.00,$0.00,$3123.98
"Avidia Checking",,U,,08/15/2013,"softright","Income : Available next month","Income","Available next month","",$0.00,$3267.66,$6391.64
"Avidia Checking",,U,,08/15/2013,"Pumpkin Brook","Income : Available next month","Income","Available next month","",$0.00,$309.12,$6700.76
"Avidia Checking",,U,,08/15/2013,"SMG","Personal : Doctor, Dentist","Personal","Doctor, Dentist","",$5.00,$0.00,$6695.76
"Avidia Checking",,U,,08/15/2013,"Transfer : Target Lisa",,,,"",$110.20,$0.00,$6585.56
"Avidia Checking",,U,,08/15/2013,"Nicole Mac wedding","Personal : Gifts","Personal","Gifts","Beautiful wedding",$200.00,$0.00,$6385.56
"Avidia Checking",,U,,08/16/2013,"nstar","Housing : Gas","Hidden Categories","Housing ` Gas","",$47.28,$0.00,$6338.28
"Avidia Checking",,U,,08/21/2013,"Sandrinos","Food : Restaurants","Food","Restaurants","",$6.41,$0.00,$6331.87
"Avidia Checking",,U,,08/22/2013,"Bamboo Restaurant","Food : Restaurants","Food","Restaurants","Took tom to lunch",$37.46,$0.00,$6294.41
"Avidia Checking",,U,,08/23/2013,"bank  fee","Recreation : Vacation","Recreation","Vacation","",$2.50,$0.00,$6291.91
"Avidia Checking",,U,,08/23/2013,"bank fee","Recreation : Vacation","Recreation","Vacation","",$3.25,$0.00,$6288.66
"Avidia Checking",,U,,08/23/2013,"kelly's roastbeef","Food : Restaurants","Food","Restaurants","",$21.61,$0.00,$6267.05
"Avidia Checking",,U,,08/23/2013,"cash","Recreation : Vacation","Recreation","Vacation","",$100.00,$0.00,$6167.05
"Avidia Checking",,U,,08/25/2013,"parking","Recreation : Vacation","Recreation","Vacation","",$10.00,$0.00,$6157.05
"Avidia Checking",,U,,08/27/2013,"Harbor grill block Isl","Recreation : Vacation","Recreation","Vacation","",$120.05,$0.00,$6037.00
"Avidia Checking",,U,,08/28/2013,"SMG","Personal : Doctor, Dentist","Personal","Doctor, Dentist","",$5.00,$0.00,$6032.00
"Avidia Checking",,U,,08/28/2013,"water","Housing : Water","Hidden Categories","Housing ` Water","",$201.02,$0.00,$5830.98
"Avidia Checking",,U,,08/29/2013,"Pumpkin Brook","Income : Available this month","Income","Available this month","",$0.00,$451.38,$6282.36
"Avidia Checking",,U,,08/30/2013,"softright","Income : Available next month","Income","Available next month","",$0.00,$3357.69,$9640.05
"Avidia Checking",,U,,08/30/2013,"Sandrinos","Food : Restaurants","Food","Restaurants","",$18.65,$0.00,$9621.40
"Avidia Checking",,U,,09/03/2013,"Migrant winds","Personal : Miscellaneous","Personal","Miscellaneous","",$12.60,$0.00,$9608.80
"Avidia Checking",,U,,09/03/2013,"parking","Transportation : Parking","Transportation","Parking","",$16.00,$0.00,$9592.80
"Avidia Checking",,U,,09/03/2013,"Save the children","Charity : Other","Charity","Other","",$28.00,$0.00,$9564.80
"Avidia Checking",,U,,09/03/2013,"verizon wireless","Housing : Cell Phones","Hidden Categories","Housing ` Cell Phones","",$94.16,$0.00,$9470.64
"Avidia Checking",,U,,09/03/2013,"Transfer : Discover",,,,"",$1579.41,$0.00,$7891.23
"Avidia Checking",,U,,09/04/2013,"OneCard","Education : College","Education","College","",$50.00,$0.00,$7841.23
"Avidia Checking",,U,,09/05/2013,"verizon fios","Housing : Phone & Internet","Hidden Categories","Housing ` Phone & Internet","",$180.23,$0.00,$7661.00
"Avidia Checking",,U,,09/06/2013,"adult and pediatric dermotology","Personal : Doctor, Dentist","Personal","Doctor, Dentist","4089",$25.00,$0.00,$7636.00
"Avidia Checking",,U,,09/06/2013,"Safety Insurane","Transportation : Car Insurance","Transportation","Car Insurance","check 4091",$2247.00,$0.00,$5389.00
"Avidia Checking",,U,,09/08/2013,"interest","Income : Available this month","Income","Available this month","",$0.00,$0.29,$5389.29
"Avidia Checking",,U,,09/09/2013,"adult and pediatric dermotology","Personal : Doctor, Dentist","Personal","Doctor, Dentist","check 4090",$25.00,$0.00,$5364.29
"Avidia Checking",,U,,09/09/2013,"daltons","Housing : Dog","Hidden Categories","Housing ` Dog","",$80.00,$0.00,$5284.29
"Avidia Checking",,U,,09/10/2013,"Mount Holyoke","Education : College","Education","College","",$3284.25,$0.00,$2000.04
"Avidia Checking",,U,,09/11/2013,"NGRID","Housing : Electricity","Hidden Categories","Housing ` Electricity","",$93.74,$0.00,$1906.30
"Avidia Checking",,U,,09/12/2013,"Pumpkin Brook","Income : Available this month","Income","Available this month","",$0.00,$366.59,$2272.89
"Avidia Checking",,U,,09/12/2013,"SMG","Personal : Doctor, Dentist","Personal","Doctor, Dentist","#4092",$5.00,$0.00,$2267.89
"Avidia Checking",,U,,09/13/2013,"softright","Income : Available next month","Income","Available next month","",$0.00,$4342.69,$6610.58
"Avidia Checking",,U,,09/16/2013,"Transfer : Lisa Cash Account",,,,"",$50.00,$0.00,$6560.58
"Avidia Checking",,U,,09/16/2013,"Transfer : Target Lisa",,,,"",$412.25,$0.00,$6148.33
"Avidia Checking",,U,,09/17/2013,"nstar","Housing : Gas","Hidden Categories","Housing ` Gas","",$45.10,$0.00,$6103.23
"Avidia Checking",,U,,09/20/2013,"Transfer : Lisa Cash Account",,,,"",$50.00,$0.00,$6053.23
"Avidia Checking",,U,,09/23/2013,"Hair Razors","Personal : Miscellaneous","Personal","Miscellaneous","Haircut  #4095",$30.00,$0.00,$6023.23
"Avidia Checking",,U,,09/24/2013,"Bill Ross","Personal : Miscellaneous","Personal","Miscellaneous","#4093 - For information on 72t",$142.50,$0.00,$5880.73
"Avidia Checking",,U,,09/26/2013,"Pumpkin Brook","Income : Available this month","Income","Available this month","",$0.00,$390.94,$6271.67
"Avidia Checking",,U,,09/26/2013,"Charlton Orchards","Personal : Miscellaneous","Personal","Miscellaneous","#4094",$20.00,$0.00,$6251.67
"Avidia Checking",,U,,09/26/2013,"SMG","Personal : Doctor, Dentist","Personal","Doctor, Dentist","#4096",$25.00,$0.00,$6226.67
"Avidia Checking",,U,,09/30/2013,"Transfer : avidia - Lisa Business",,,,"",$0.00,$2000.00,$8226.67
"Avidia Checking",,U,,10/01/2013,"Save the children","Charity : Other","Charity","Other","",$28.00,$0.00,$8198.67
"Avidia Checking",,U,,10/01/2013,"Smart entry","Recreation : Alyssa","Recreation","Alyssa","Art contest?",$40.00,$0.00,$8158.67
"Avidia Checking",,U,,10/01/2013,"verizon wireless","Housing : Cell Phones","Hidden Categories","Housing ` Cell Phones",,$94.16,$0.00,$8064.51
"Avidia Checking",,U,,10/03/2013,"Transfer : Discover",,,,"",$2948.87,$0.00,$5115.64
"Avidia Checking",,U,,10/07/2013,"verizon fios","Housing : Phone & Internet","Hidden Categories","Housing ` Phone & Internet","",$150.87,$0.00,$4964.77
"Avidia Checking",,U,,10/08/2013,"interest","Income : Available this month","Income","Available this month","",$0.00,$0.23,$4965.00
"Avidia Checking",,U,,10/10/2013,"Pumpkin Brook","Income : Available this month","Income","Available this month","",$0.00,$410.92,$5375.92
"Avidia Checking",,U,,10/10/2013,"Transfer : Target",,,,"",$3.02,$0.00,$5372.90
"Avidia Checking",,U,,10/10/2013,"NGRID","Housing : Electricity","Hidden Categories","Housing ` Electricity","",$97.59,$0.00,$5275.31
"Avidia Checking",,U,,10/10/2013,"Cobra softright","Personal : Health Insurance","Personal","Health Insurance","",$920.33,$0.00,$4354.98
"Avidia Checking",,U,,10/11/2013,"SMG","Personal : Doctor, Dentist","Personal","Doctor, Dentist","#4099",$5.00,$0.00,$4349.98
"Avidia Checking",,U,,10/11/2013,"paradize city arts","Personal : Miscellaneous","Personal","Miscellaneous","",$30.00,$0.00,$4319.98
"Avidia Checking",,U,,10/15/2013,"Transfer : Target Lisa",,,,"",$342.90,$0.00,$3977.08
"Avidia Checking",,U,,10/16/2013,"Sandrinos","Food : Restaurants","Food","Restaurants","",$8.92,$0.00,$3968.16
"Avidia Checking",,U,,10/16/2013,"nstar","Housing : Gas","Hidden Categories","Housing ` Gas","",$44.99,$0.00,$3923.17
"Avidia Checking",,U,,10/16/2013,"Mike Riley","Personal : Gifts","Personal","Gifts","#4100 bird house",$110.00,$0.00,$3813.17
"Avidia Checking",,U,,10/16/2013,"MCH Western","Recreation : Alyssa Horse","Recreation","Alyssa Horse","#4101",$380.00,$0.00,$3433.17
"Avidia Checking",,U,,10/18/2013,"SMG","Personal : Doctor, Dentist","Personal","Doctor, Dentist","#4104",$25.00,$0.00,$3408.17
"Avidia Checking",,U,,10/21/2013,"Sandrinos","Food : Restaurants","Food","Restaurants","",$7.22,$0.00,$3400.95
"Avidia Checking",,U,,10/22/2013,"Transfer : avidia - Lisa Business",,,,"",$0.00,$1500.00,$4900.95
"Avidia Checking",,U,,10/22/2013,"Pumpkin Brook","Income : Available this month","Income","Available this month","",$0.00,$436.26,$5337.21
"Avidia Checking",,U,,10/24/2013,"Marlboro chamber of commerce","business (bob) : Memberships","Hidden Categories","business (bob) ` Memberships","#4108",$375.00,$0.00,$4962.21
"Avidia Checking",,U,,10/25/2013,"Deposit","Income : Available next month","Income","Available next month","",$0.00,$100.00,$5062.21
"Avidia Checking",,U,,10/28/2013,"Mount Holyoke Lacross","Personal : Gifts","Personal","Gifts","#4097",$26.00,$0.00,$5036.21
"Avidia Checking",,U,,10/28/2013,"Basha","Food : Groceries","Food","Groceries","",$55.23,$0.00,$4980.98
"Avidia Checking",,U,,10/29/2013,"Marlboro","Housing : Real Estate Tax","Hidden Categories","Housing ` Real Estate Tax","",$1241.53,$0.00,$3739.45
"Avidia Checking",,U,,10/31/2013,"MCH Western","Recreation : Alyssa Horse","Recreation","Alyssa Horse","#4107",$95.00,$0.00,$3644.45
"Avidia Checking",,U,,11/01/2013,"Save the children","Charity : Other","Charity","Other","",$28.00,$0.00,$3616.45
"Avidia Checking",,U,,11/01/2013,"verizon wireless","Housing : Cell Phones","Hidden Categories","Housing ` Cell Phones","",$94.46,$0.00,$3521.99
"Avidia Checking",,U,,11/01/2013,"Cobra softright","Personal : Health Insurance","Personal","Health Insurance","",$953.01,$0.00,$2568.98
"Avidia Checking",,U,,11/04/2013,"Transfer : Discover",,,,"",$2211.62,$0.00,$357.36
"Avidia Checking",,U,,11/05/2013,"Transfer : avidia - Lisa Business",,,,"",$0.00,$1800.00,$2157.36
"Avidia Checking",,U,,11/05/2013,"namecheap","business (bob) : Internet","Hidden Categories","business (bob) ` Internet","",$32.01,$0.00,$2125.35
"Avidia Checking",,U,,11/05/2013,"verizon fios","Housing : Phone & Internet","Hidden Categories","Housing ` Phone & Internet","",$76.38,$0.00,$2048.97
"Avidia Checking",,U,,11/07/2013,"Pumpkin Brook","Income : Available this month","Income","Available this month","",$0.00,$409.39,$2458.36
"Avidia Checking",,U,,11/07/2013,"interest","Income : Available this month","Income","Available this month","",$0.00,$0.16,$2458.52
"Avidia Checking",,U,,11/08/2013,"SMG","Personal : Doctor, Dentist","Personal","Doctor, Dentist","#4112",$5.00,$0.00,$2453.52
"Avidia Checking",,U,,11/08/2013,"NGRID","Housing : Electricity","Hidden Categories","Housing ` Electricity","",$70.57,$0.00,$2382.95
"Avidia Checking",,U,,11/12/2013,"Transfer : Target",,,,"",$28.90,$0.00,$2354.05
"Avidia Checking",,U,,11/12/2013,"MPCOA","Charity : Other","Charity","Other","#4113 Marlboro Police",$35.00,$0.00,$2319.05
"Avidia Checking",,U,,11/13/2013,"Springridge farm","Food : Groceries","Food","Groceries","#4114",$20.00,$0.00,$2299.05
"Avidia Checking",,U,,11/14/2013,"Red Barn","Food : Restaurants","Food","Restaurants","",$2.39,$0.00,$2296.66
"Avidia Checking",,U,,11/14/2013,"Red Barn coffee","Food : Restaurants","Food","Restaurants","",$2.66,$0.00,$2294.00
"Avidia Checking",,U,,11/14/2013,"Zach mattei-lownes","Personal : Gifts","Personal","Gifts","birthday",$25.00,$0.00,$2269.00
"Avidia Checking",,U,,11/15/2013,"Transfer : Target Lisa",,,,"",$153.62,$0.00,$2115.38
"Avidia Checking",,U,,11/18/2013,"hannaford","Food : Groceries","Food","Groceries","",$4.76,$0.00,$2110.62
"Avidia Checking",,U,,11/18/2013,"marlboro wine & spirits","Food : Groceries","Food","Groceries","",$10.49,$0.00,$2100.13
"Avidia Checking",,U,,11/18/2013,"A1 auto","Transportation : Repairs & Maintenance","Transportation","Repairs & Maintenance","",$34.35,$0.00,$2065.78
"Avidia Checking",,U,,11/18/2013,"gulf oil","Transportation : Gas","Transportation","Gas","",$39.75,$0.00,$2026.03
"Avidia Checking",,U,,11/18/2013,"nstar","Housing : Gas","Hidden Categories","Housing ` Gas","",$68.45,$0.00,$1957.58
"Avidia Checking",,U,,11/18/2013,"hanaford","Food : Groceries","Food","Groceries","",$78.13,$0.00,$1879.45
"Avidia Checking",,U,,11/20/2013,"Brookline Mass","Transportation : Parking","Transportation","Parking","",$3.00,$0.00,$1876.45
"Avidia Checking",,U,,11/20/2013,"hannaford","Food : Groceries","Food","Groceries","",$20.78,$0.00,$1855.67
"Avidia Checking",,U,,11/21/2013,"softright","Income : Available this month","Income","Available this month","",$0.00,$3600.00,$5455.67
"Avidia Checking",,U,,11/21/2013,"Pumpkin Brook","Income : Available this month","Income","Available this month","",$0.00,$338.04,$5793.71
"Avidia Checking",,U,,11/27/2013,"MHC Western","Education : College","Education","College","4110",$30.00,$0.00,$5763.71
"Avidia Checking",,U,,11/27/2013,"MHC Western","Education : College","Education","College","4109",$35.00,$0.00,$5728.71
"Avidia Checking",,U,,12/02/2013,"Save the children","Charity : Other","Charity","Other","",$28.00,$0.00,$5700.71
"Avidia Checking",,U,,12/03/2013,"Transfer : Discover",,,,"",$1384.99,$0.00,$4315.72
"Avidia Checking",,U,,12/04/2013,"verizon wireless","Housing : Cell Phones","Hidden Categories","Housing ` Cell Phones","",$96.65,$0.00,$4219.07
"Avidia Checking",,U,,12/05/2013,"Pumpkin Brook","Income : Available this month","Income","Available this month","",$0.00,$165.50,$4384.57
"Avidia Checking",,U,,12/05/2013,"Tallpc paypal","Personal : Miscellaneous","Personal","Miscellaneous","",$4.49,$0.00,$4380.08
"Avidia Checking",,U,,12/05/2013,"Sarafine","Personal : Gifts","Personal","Gifts","",$50.00,$0.00,$4330.08
"Avidia Checking",,U,,12/06/2013,"SMG","Personal : Doctor, Dentist","Personal","Doctor, Dentist","",$5.00,$0.00,$4325.08
"Avidia Checking",,U,,12/06/2013,"NGRID","Housing : Electricity","Hidden Categories","Housing ` Electricity","",$83.93,$0.00,$4241.15
"Avidia Checking",,U,,12/06/2013,"verizon fios","Housing : Phone & Internet","Hidden Categories","Housing ` Phone & Internet","",$94.03,$0.00,$4147.12
"Avidia Checking",,U,,12/08/2013,"interest","Income : Available this month","Income","Available this month","",$0.00,$0.14,$4147.26
"Avidia Checking",,U,,12/09/2013,"softright","Personal : Health Insurance","Personal","Health Insurance","4115",$954.00,$0.00,$3193.26
"Avidia Checking",,U,,12/10/2013,"Transfer : Target",,,,"",$10.96,$0.00,$3182.30
"Avidia Checking",,U,,12/10/2013,"Marlboro","Housing : Water","Hidden Categories","Housing ` Water","",$341.66,$0.00,$2840.64
"Avidia Checking",,U,,12/10/2013,"Transfer : Target Lisa",,,,"",$500.00,$0.00,$2340.64
"Avidia Checking",,U,,12/11/2013,"daltons","Housing : Dog","Hidden Categories","Housing ` Dog","",$80.00,$0.00,$2260.64
"Avidia Checking",,U,,12/16/2013,"Transfer : avidia - Lisa Business",,,,"",$0.00,$1700.00,$3960.64
"Avidia Checking",,U,,12/16/2013,"Transfer : Target Lisa",,,,"",$170.84,$0.00,$3789.80
"Avidia Checking",,U,,12/17/2013,"nstar","Housing : Gas","Hidden Categories","Housing ` Gas","",$169.28,$0.00,$3620.52
"Avidia Checking",,U,,12/18/2013,"Misc Income?","Income : Available this month","Income","Available this month","",$0.00,$30.00,$3650.52
"Avidia Checking",,U,,12/19/2013,"Pumpkin Brook","Income : Available this month","Income","Available this month","",$0.00,$420.00,$4070.52
"Avidia Checking",,U,,12/19/2013,"Pumpkin Brook","Income : Available this month","Income","Available this month","",$0.00,$250.00,$4320.52
"Avidia Checking",,U,,12/19/2013,"Pumpkin Brook","Income : Available this month","Income","Available this month","",$0.00,$21.32,$4341.84
"Avidia Checking",,U,,12/19/2013,"Providence Airport","Transportation : Parking","Transportation","Parking","",$6.00,$0.00,$4335.84
"Avidia Checking",,U,,12/23/2013,"Credit Ma DUA tax","Income : Available this month","Income","Available this month","",$0.00,$105.00,$4440.84
"Avidia Checking",,U,,12/23/2013,"AJ Tomaiolo","Food : Restaurants","Food","Restaurants","",$42.79,$0.00,$4398.05
"Avidia Checking",,U,,12/24/2013,"Fastlane","Transportation : tolls","Transportation","tolls","",$12.50,$0.00,$4385.55
"Avidia Checking",,U,,12/24/2013,"Jolicoeur","Housing : Maintenance & Repairs","Hidden Categories","Housing ` Maintenance & Repairs","4118",$75.00,$0.00,$4310.55
"Avidia Checking",,U,,12/26/2013,"Chinese Kitchen","Food : Restaurants","Food","Restaurants","",$37.02,$0.00,$4273.53
"Avidia Checking",,U,,12/27/2013,"Misc Income?","Income : Available this month","Income","Available this month","",$0.00,$350.00,$4623.53
"Avidia Checking",,U,,12/30/2013,"Mom gift","Income : Available this month","Income","Available this month","",$0.00,$2000.00,$6623.53
"Avidia Checking",,U,,12/30/2013,"Laura  Mattei (FOR ANNA GIFT)","Personal : Gifts","Personal","Gifts","",$50.00,$0.00,$6573.53
"Avidia Checking",,U,,01/02/2014,"McDonalds","Food : Restaurants","Food","Restaurants","",$11.02,$0.00,$6562.51
"Avidia Checking",,U,,01/02/2014,"Save the children","Charity : Other","Charity","Other","",$28.00,$0.00,$6534.51
"Avidia Checking",,U,,01/02/2014,"verizon wireless","Housing : Cell Phones","Hidden Categories","Housing ` Cell Phones","",$94.67,$0.00,$6439.84
"Avidia Checking",,U,,01/03/2014,"SMG","Personal : Doctor, Dentist","Personal","Doctor, Dentist","",$25.00,$0.00,$6414.84
"Avidia Checking",,U,,01/03/2014,"Transfer : Discover",,,,"",$2225.12,$0.00,$4189.72
"Avidia Checking",,U,,01/06/2014,"Ketztx","Recreation : Entertainment","Recreation","Entertainment","",$7.00,$0.00,$4182.72
"Avidia Checking",,U,,01/06/2014,"verizon fios","Housing : Phone & Internet","Hidden Categories","Housing ` Phone & Internet","",$94.03,$0.00,$4088.69
"Avidia Checking",,U,,01/06/2014,"Towing","Transportation : Repairs & Maintenance","Transportation","Repairs & Maintenance","",$125.00,$0.00,$3963.69
"Avidia Checking",,U,,01/07/2014,"NGRID","Housing : Electricity","Hidden Categories","Housing ` Electricity","",$98.52,$0.00,$3865.17
"Avidia Checking",,U,,01/08/2014,"Interst","Income : Available next month","Income","Available next month","",$0.00,$0.17,$3865.34
"Avidia Checking",,C,,01/09/2014,"SMG","Personal : Doctor, Dentist","Personal","Doctor, Dentist","4123",$5.00,$0.00,$3860.34
"Avidia Checking",,U,,01/09/2014,"Horseman's exchange","Personal : cloths","Personal","cloths","",$111.88,$0.00,$3748.46
"Avidia Checking",,U,,01/09/2014,"softright insurance","Personal : Health Insurance","Personal","Health Insurance","4121",$954.00,$0.00,$2794.46
"Avidia Checking",,U,,01/15/2014,"Rachel Miller","Recreation : Alyssa Horse","Recreation","Alyssa Horse","4124",$55.00,$0.00,$2739.46
"Avidia Checking",,U,,01/17/2014,"Deposit","Income : Available this month","Income","Available this month","",$0.00,$1188.00,$3927.46
"Avidia Checking",,U,,01/17/2014,"nstar","Housing : Gas","Hidden Categories","Housing ` Gas","",$204.28,$0.00,$3723.18
"Avidia Checking",,U,,01/21/2014,"unemployment","Income : Available this month","Income","Available this month","",$0.00,$94.00,$3817.18
"Avidia Checking",,U,,01/21/2014,"SMG","Personal : Doctor, Dentist","Personal","Doctor, Dentist","4125",$25.00,$0.00,$3792.18
"Avidia Checking",,U,,01/21/2014,"Shell","Transportation : Gas","Transportation","Gas","",$42.96,$0.00,$3749.22
"Avidia Checking",,U,,01/27/2014,"Recieved gift","Income : Available this month","Income","Available this month","",$0.00,$50.00,$3799.22
"Avidia Checking",,U,,01/28/2014,"unemployment","Income : Available this month","Income","Available this month","",$0.00,$94.00,$3893.22
"Avidia Checking",,U,,01/30/2014,"SMG","Personal : Doctor, Dentist","Personal","Doctor, Dentist","",$5.00,$0.00,$3888.22
"Avidia Checking",,U,,02/03/2014,"gift from mom","Income : Available this month","Income","Available this month","",$0.00,$200.00,$4088.22
"Avidia Checking",,U,,02/03/2014,"Save the children","Charity : Other","Charity","Other","",$28.00,$0.00,$4060.22
"Avidia Checking",,U,,02/03/2014,"verizon wireless","Housing : Cell Phones","Hidden Categories","Housing ` Cell Phones","",$94.46,$0.00,$3965.76
"Avidia Checking",,U,,02/03/2014,"city of marlboro","Housing : Real Estate Tax","Hidden Categories","Housing ` Real Estate Tax","",$1245.05,$0.00,$2720.71
"Avidia Checking",,U,,02/04/2014,"Transfer : avidia - Lisa Business",,,,"",$0.00,$400.00,$3120.71
"Avidia Checking",,U,,02/04/2014,"unemployment","Income : Available this month","Income","Available this month","",$0.00,$94.00,$3214.71
"Avidia Checking",,U,,02/04/2014,"Mass college of Art","Education : College","Education","College","",$50.00,$0.00,$3164.71
"Avidia Checking",,U,,02/04/2014,"Transfer : Discover",,,,"",$1447.30,$0.00,$1717.41
"Avidia Checking",,U,,02/05/2014,"verizon fios","Housing : Phone & Internet","Hidden Categories","Housing ` Phone & Internet","",$94.19,$0.00,$1623.22
"Avidia Checking",,U,,02/06/2014,"SMG","Personal : Doctor, Dentist","Personal","Doctor, Dentist","4128",$25.00,$0.00,$1598.22
"Avidia Checking",,U,,02/06/2014,"Transfer : Lisa Cash Account",,,,"",$100.00,$0.00,$1498.22
"Avidia Checking",,U,,02/08/2014,"interest","Income : Available this month","Income","Available this month","",$0.00,$0.13,$1498.35
"Avidia Checking",,U,,02/10/2014,"NGRID","Housing : Electricity","Hidden Categories","Housing ` Electricity","",$121.38,$0.00,$1376.97
"Avidia Checking",,U,,02/10/2014,"Transfer : Target",,,,"",$177.56,$0.00,$1199.41
"Avidia Checking",,U,,02/11/2014,"Deposit","Income : Available this month","Income","Available this month","",$0.00,$500.00,$1699.41
"Avidia Checking",,U,,02/11/2014,"unemployment","Income : Available this month","Income","Available this month","",$0.00,$94.00,$1793.41
"Avidia Checking",,U,,02/11/2014,"Fastlane","Transportation : tolls","Transportation","tolls","",$14.85,$0.00,$1778.56
"Avidia Checking",,U,,02/18/2014,,"Personal : Miscellaneous","Personal","Miscellaneous","4126",$10.00,$0.00,$1768.56
"Avidia Checking",,U,,02/18/2014,"Mont serrat","Education : College","Education","College","",$50.00,$0.00,$1718.56
"Avidia Checking",,U,,02/18/2014,"Transfer : Target Lisa",,,,"",$197.18,$0.00,$1521.38
"Avidia Checking",,U,,02/18/2014,"nstar","Housing : Gas","Hidden Categories","Housing ` Gas","",$245.55,$0.00,$1275.83
"Avidia Checking",,U,,02/20/2014,"unemployment","Income : Available this month","Income","Available this month","",$0.00,$94.00,$1369.83
"Avidia Checking",,U,,02/20/2014,"Transfer : Lisa Cash Account",,,,"",$50.00,$0.00,$1319.83
"Avidia Checking",,U,,02/20/2014,"Transfer : avidia - Lisa Business",,,,"",$150.00,$0.00,$1169.83
"Avidia Checking",,U,,02/21/2014,"Tax refund MASSACHUSETTS","Income : Available this month","Income","Available this month","",$0.00,$544.00,$1713.83
"Avidia Checking",,U,,02/21/2014,"MHC Western","Recreation : Alyssa Horse","Recreation","Alyssa Horse","4105",$150.00,$0.00,$1563.83
"Avidia Checking",,U,,02/25/2014,"unemployment","Income : Available this month","Income","Available this month","",$0.00,$94.00,$1657.83
"Avidia Checking",,U,,02/25/2014,"Fastlane","Transportation : tolls","Transportation","tolls","",$10.70,$0.00,$1647.13
"Avidia Checking",,U,,02/26/2014,"Transfer : Lisa Cash Account",,,,"",$50.00,$0.00,$1597.13
"Avidia Checking",,U,,02/27/2014,"Check From Mom","Income : Available this month","Income","Available this month","",$0.00,$500.00,$2097.13
"Avidia Checking",,U,,02/27/2014,"SMG","Personal : Doctor, Dentist","Personal","Doctor, Dentist","",$5.00,$0.00,$2092.13
"Avidia Checking",,U,,03/01/2014,"Save the children","Charity : Other","Charity","Other","",$28.00,$0.00,$2064.13
"Avidia Checking",,U,,03/03/2014,"SMG","Personal : Doctor, Dentist","Personal","Doctor, Dentist","",$25.00,$0.00,$2039.13
"Avidia Checking",,U,,03/05/2014,"irs","Income : Available this month","Income","Available this month","",$0.00,$4123.00,$6162.13
"Avidia Checking",,U,,03/05/2014,"unemployment","Income : Available this month","Income","Available this month","",$0.00,$94.00,$6256.13
"Avidia Checking",,U,,03/05/2014,"verizon wireless","Housing : Cell Phones","Hidden Categories","Housing ` Cell Phones","",$94.19,$0.00,$6161.94
"Avidia Checking",,U,,03/05/2014,"Marlboro","Housing : Water","Hidden Categories","Housing ` Water","",$270.75,$0.00,$5891.19
"Avidia Checking",,U,,03/08/2014,"interest","Income : Available this month","Income","Available this month","",$0.00,$0.09,$5891.28
"Avidia Checking",,U,,03/10/2014,"verizon fios","Housing : Phone & Internet","Hidden Categories","Housing ` Phone & Internet","",$94.19,$0.00,$5797.09
"Avidia Checking",,U,,03/10/2014,"Transfer : Target",,,,"",$504.84,$0.00,$5292.25
"Avidia Checking",,U,,03/11/2014,"Marlboro","Transportation : Auto Excise","Transportation","Auto Excise","",$37.50,$0.00,$5254.75
"Avidia Checking",,U,,03/11/2014,"Marlboro","Transportation : Auto Excise","Transportation","Auto Excise","",$48.75,$0.00,$5206.00
"Avidia Checking",,U,,03/11/2014,"simple clean heating","Housing : Maintenance & Repairs","Hidden Categories","Housing ` Maintenance & Repairs","Check 4131",$608.00,$0.00,$4598.00
"Avidia Checking",,U,,03/12/2014,"unemployment","Income : Available this month","Income","Available this month","",$0.00,$94.00,$4692.00
"Avidia Checking",,U,,03/12/2014,"Transfer : Lisa Cash Account",,,,"",$50.00,$0.00,$4642.00
"Avidia Checking",,U,,03/12/2014,"NGRID","Housing : Electricity","Hidden Categories","Housing ` Electricity","",$84.37,$0.00,$4557.63
"Avidia Checking",,U,,03/17/2014,"Endicott college","Education : College","Education","College","",$50.00,$0.00,$4507.63
"Avidia Checking",,U,,03/18/2014,"OCB","Personal : Miscellaneous","Personal","Miscellaneous","check 4132",$25.00,$0.00,$4482.63
"Avidia Checking",,U,,03/19/2014,"unemployment","Income : Available this month","Income","Available this month","",$0.00,$94.00,$4576.63
"Avidia Checking",,U,,03/19/2014,"Trustees of Hampshire college","Education : College","Education","College","check 4106",$60.00,$0.00,$4516.63
"Avidia Checking",,U,,03/20/2014,"nstar","Housing : Gas","Hidden Categories","Housing ` Gas","",$234.01,$0.00,$4282.62
"Avidia Checking",,U,,03/25/2014,"Fastlane","Transportation : tolls","Transportation","tolls","",$11.20,$0.00,$4271.42
"Avidia Checking",,U,,03/25/2014,"Fastlane","Transportation : tolls","Transportation","tolls","",$14.00,$0.00,$4257.42
"Avidia Checking",,U,,03/26/2014,"unemployment","Income : Available this month","Income","Available this month","",$0.00,$94.00,$4351.42
"Avidia Checking",,U,,03/26/2014,"SMG","Personal : Doctor, Dentist","Personal","Doctor, Dentist","check 4134",$25.00,$0.00,$4326.42
"Avidia Checking",,U,,04/01/2014,"Save the children","Charity : Other","Charity","Other","",$28.00,$0.00,$4298.42
"Avidia Checking",,U,,04/01/2014,"daltons","Housing : Dog","Hidden Categories","Housing ` Dog","#4135",$95.00,$0.00,$4203.42
"Avidia Checking",,U,,04/02/2014,"verizon wireless","Housing : Cell Phones","Hidden Categories","Housing ` Cell Phones","",$94.40,$0.00,$4109.02
"Avidia Checking",,U,,04/02/2014,"softright","Personal : Health Insurance","Personal","Health Insurance","#4136",$954.00,$0.00,$3155.02
"Avidia Checking",,U,,04/04/2014,"Nancy Lander","Personal : Gifts","Personal","Gifts","",$50.00,$0.00,$3105.02
"Avidia Checking",,U,,04/07/2014,"verizon fios","Housing : Phone & Internet","Hidden Categories","Housing ` Phone & Internet","",$94.19,$0.00,$3010.83
"Avidia Checking",,U,,04/08/2014,"interest","Income : Available this month","Income","Available this month","",$0.00,$0.17,$3011.00
"Avidia Checking",,U,,04/09/2014,"NGRID","Housing : Electricity","Hidden Categories","Housing ` Electricity","",$87.95,$0.00,$2923.05
"Avidia Checking",,U,,04/10/2014,"Pumpkin Brook","Income : Available this month","Income","Available this month","",$0.00,$252.23,$3175.28
"Avidia Checking",,U,,04/10/2014,"Transfer : Target",,,,"",$132.39,$0.00,$3042.89
"Avidia Checking",,U,,04/14/2014,"charles River Medical","Personal : Doctor, Dentist","Personal","Doctor, Dentist","",$25.00,$0.00,$3017.89
"Avidia Checking",,U,,04/14/2014,"Stone Pony Farm","Recreation : Alyssa Horse","Recreation","Alyssa Horse","#4138",$180.00,$0.00,$2837.89
"Avidia Checking",,U,,04/16/2014,"Friends Of Beverly Librar","Recreation : Entertainment","Recreation","Entertainment","#4139",$5.00,$0.00,$2832.89
"Avidia Checking",,U,,04/17/2014,"nstar","Housing : Gas","Hidden Categories","Housing ` Gas","",$192.59,$0.00,$2640.30
"Avidia Checking",,U,,04/18/2014,"Cow Parking Meter","Transportation : Parking","Transportation","Parking","",$1.00,$0.00,$2639.30
"Avidia Checking",,U,,04/18/2014,"charles River Medical","Personal : Doctor, Dentist","Personal","Doctor, Dentist","",$25.00,$0.00,$2614.30
"Avidia Checking",,U,,04/21/2014,,"Personal : Miscellaneous","Personal","Miscellaneous","ATM FEE",$2.50,$0.00,$2611.80
"Avidia Checking",,U,,04/21/2014,"","Personal : Miscellaneous","Personal","Miscellaneous","",$3.00,$0.00,$2608.80
"Avidia Checking",,U,,04/21/2014,"Zitis","Food : Restaurants","Food","Restaurants","",$75.97,$0.00,$2532.83
"Avidia Checking",,U,,04/21/2014,"Transfer : Robert Cash Account",,,,"",$100.00,$0.00,$2432.83
"Avidia Checking",,U,,04/24/2014,"Pumpkin Brook","Income : Available this month","Income","Available this month","",$0.00,$211.43,$2644.26
"Avidia Checking",,U,,05/01/2014,"Save the children","Charity : Other","Charity","Other","",$28.00,$0.00,$2616.26
"Avidia Checking",,U,,05/01/2014,"MHC Western","Recreation : Alyssa Horse","Recreation","Alyssa Horse","4137",$85.00,$0.00,$2531.26
"Avidia Checking",,U,,05/01/2014,"MHC Western","Recreation : Alyssa Horse","Recreation","Alyssa Horse","4140",$105.00,$0.00,$2426.26
"Avidia Checking",,U,,05/01/2014,"Marlboro","Housing : Real Estate Tax","Hidden Categories","Housing ` Real Estate Tax","",$1245.05,$0.00,$1181.21
"Avidia Checking",,U,,05/02/2014,"verizon wireless","Housing : Cell Phones","Hidden Categories","Housing ` Cell Phones","",$97.46,$0.00,$1083.75
"Avidia Checking",,U,,05/05/2014,"SMG","Personal : Doctor, Dentist","Personal","Doctor, Dentist","",$10.00,$0.00,$1073.75
"Avidia Checking",,U,,05/06/2014,"Transfer : avidia - Lisa Business",,,,"",$0.00,$1000.00,$2073.75
"Avidia Checking",,U,,05/06/2014,"verizon fios","Housing : Phone & Internet","Hidden Categories","Housing ` Phone & Internet","",$94.24,$0.00,$1979.51
"Avidia Checking",,U,,05/08/2014,"Pumpkin Brook","Income : Available this month","Income","Available this month","",$0.00,$114.91,$2094.42
"Avidia Checking",,U,,05/08/2014,"interest","Income : Available next month","Income","Available next month","",$0.00,$0.10,$2094.52
"Avidia Checking",,U,,05/09/2014,"NGRID","Housing : Electricity","Hidden Categories","Housing ` Electricity","",$89.43,$0.00,$2005.09
"Avidia Checking",,U,,05/12/2014,"Transfer : Target",,,,"",$164.13,$0.00,$1840.96
"Avidia Checking",,U,,05/16/2014,"CJS Pizza","Food : Restaurants","Food","Restaurants","",$28.88,$0.00,$1812.08
"Avidia Checking",,U,,05/19/2014,"nstar","Housing : Gas","Hidden Categories","Housing ` Gas","",$103.49,$0.00,$1708.59
"Avidia Checking",,U,,05/20/2014,"Transfer : Lisa Cash Account",,,,"",$100.00,$0.00,$1608.59
"Avidia Checking",,U,,05/21/2014,"Transfer : avidia - Lisa Business",,,,"",$0.00,$1500.00,$3108.59
"Avidia Checking",,U,,05/21/2014,"city of marlboro","Housing : Water","Hidden Categories","Housing ` Water","",$21.66,$0.00,$3086.93
"Avidia Checking",,U,,05/22/2014,"Pumpkin Brook","Income : Available this month","Income","Available this month","",$0.00,$266.59,$3353.52
"Avidia Checking",,U,,05/27/2014,"Russell Swinton","Personal : Gifts","Personal","Gifts","4144",$100.00,$0.00,$3253.52
"Avidia Checking",,U,,05/29/2014,"New Horizon","Personal : Miscellaneous","Personal","Miscellaneous","4143 - new horizon deposit",$50.00,$0.00,$3203.52
"Avidia Checking",,U,,06/02/2014,"bank  fee","Personal : BankFee","Personal","BankFee","",$2.50,$0.00,$3201.02
"Avidia Checking",,U,,06/02/2014,"bank  fee","Personal : BankFee","Personal","BankFee","",$3.00,$0.00,$3198.02
"Avidia Checking",,U,,06/02/2014,"Save the children","Charity : Other","Charity","Other","",$28.00,$0.00,$3170.02
"Avidia Checking",,U,,06/02/2014,"Transfer : Lisa Cash Account",,,,"",$80.00,$0.00,$3090.02
"Avidia Checking",,U,,06/02/2014,"Next Step Living","Housing : Maintenance & Repairs","Hidden Categories","Housing ` Maintenance & Repairs","",$100.00,$0.00,$2990.02
"Avidia Checking",,U,,06/02/2014,"Transfer : Lisa Cash Account",,,,"",$200.00,$0.00,$2790.02
"Avidia Checking",,U,,06/03/2014,"verizon wireless","Housing : Cell Phones","Hidden Categories","Housing ` Cell Phones","",$104.18,$0.00,$2685.84
"Avidia Checking",,U,,06/04/2014,"Cheri Hardenbrook","Charity : Other","Charity","Other","4145",$80.00,$0.00,$2605.84
"Avidia Checking",,U,,06/05/2014,"Pumpkin Brook","Income : Available this month","Income","Available this month","",$0.00,$262.98,$2868.82
"Avidia Checking",,U,,06/05/2014,"verizon wireless","Housing : Cell Phones","Hidden Categories","Housing ` Cell Phones","",$94.24,$0.00,$2774.58
"Avidia Checking",,U,,06/08/2014,"Credit RVM Charge","Personal : BankCredit","Personal","BankCredit","",$0.00,$3.00,$2777.58
"Avidia Checking",,U,,06/08/2014,"interest","Income : Available next month","Income","Available next month","",$0.00,$0.11,$2777.69
"Avidia Checking",,U,,06/09/2014,"MA dui","Transportation : Auto Excise","Transportation","Auto Excise","",$0.00,$73.00,$2850.69
"Avidia Checking",,U,,06/10/2014,"Transfer : Target",,,,"",$327.54,$0.00,$2523.15
"Avidia Checking",,U,,06/12/2014,"NGRID","Housing : Electricity","Hidden Categories","Housing ` Electricity","",$63.25,$0.00,$2459.90
"Avidia Checking",,U,,06/16/2014,"Transfer : Lisa Cash Account",,,,"",$50.00,$0.00,$2409.90
"Avidia Checking",,U,,06/18/2014,"nstar","Housing : Gas","Hidden Categories","Housing ` Gas","",$54.94,$0.00,$2354.96
"Avidia Checking",,U,,06/19/2014,"Pumpkin Brook","Income : Available this month","Income","Available this month","",$0.00,$301.30,$2656.26
"Avidia Checking",,U,,06/23/2014,"Transfer : avidia - Lisa Business",,,,"",$0.00,$2500.00,$5156.26
"Avidia Checking",,U,,06/23/2014,"savers marlboro","Personal : cloths","Personal","cloths","",$19.97,$0.00,$5136.29
"Avidia Checking",,U,,06/27/2014,"Deposit Marlboro","Income : Available this month","Income","Available this month","",$0.00,$400.00,$5536.29
"Avidia Checking",,U,,06/27/2014,"Kim Campos","Personal : Gifts","Personal","Gifts","",$50.00,$0.00,$5486.29
"Avidia Checking",,U,,06/30/2014,"Transfer : DCU Home Equity Credit line",,,,"4133",$1000.00,$0.00,$4486.29
"Avidia Checking",,U,,07/01/2014,"Save the children","Charity : Other","Charity","Other","",$28.00,$0.00,$4458.29
"Avidia Checking",,U,,07/02/2014,"verizon wireless","Housing : Cell Phones","Hidden Categories","Housing ` Cell Phones","",$97.27,$0.00,$4361.02
"Avidia Checking",,U,,07/03/2014,"Pumpkin Brook","Income : Available this month","Income","Available this month","",$0.00,$297.24,$4658.26
"Avidia Checking",,U,,07/04/2014,"Transfer : avidia - Lisa Business",,,,"",$0.00,$2500.00,$7158.26
"Avidia Checking",,U,,07/04/2014,"interest","Income : Available next month","Income","Available next month","",$0.00,$0.16,$7158.42
"Avidia Checking",,U,,07/10/2014,"bank  fee","Personal : BankFee","Personal","BankFee","",$2.50,$0.00,$7155.92
"Avidia Checking",,U,,07/10/2014,"bank  fee","Personal : BankFee","Personal","BankFee","",$3.00,$0.00,$7152.92
"Avidia Checking",,U,,07/10/2014,"NGRID","Housing : Electricity","Hidden Categories","Housing ` Electricity","",$74.81,$0.00,$7078.11
"Avidia Checking",,U,,07/10/2014,"Transfer : Target",,,,"",$182.96,$0.00,$6895.15
"Avidia Checking",,U,,07/10/2014,"Transfer : Robert Cash Account",,,,"",$200.00,$0.00,$6695.15
"Avidia Checking",,U,,07/16/2014,"Transfer : Discover",,,,"",$1769.65,$0.00,$4925.50
"Avidia Checking",,U,,07/17/2014,"Pumpkin Brook","Income : Available this month","Income","Available this month","",$0.00,$273.31,$5198.81
"Avidia Checking",,U,,07/18/2014,"Expedia","Recreation : Vacation","Recreation","Vacation","",$0.00,$140.05,$5338.86
"Avidia Checking",,U,,07/18/2014,"Expedia","Recreation : Vacation","Recreation","Vacation","",$0.00,$140.05,$5478.91
"Avidia Checking",,U,,07/18/2014,"nstar","Housing : Gas","Hidden Categories","Housing ` Gas","",$44.30,$0.00,$5434.61
"Avidia Checking",,U,,07/18/2014,"Expedia","Recreation : Vacation","Recreation","Vacation","",$280.10,$0.00,$5154.51
"Avidia Checking",,U,,07/18/2014,"hotels.com","Recreation : Vacation","Recreation","Vacation","Visit  Rose",$367.21,$0.00,$4787.30
"Avidia Checking",,U,,07/21/2014,"hotels.com","Recreation : Vacation","Recreation","Vacation","visit rose refund second night",$0.00,$168.64,$4955.94
"Avidia Checking",,U,,07/21/2014,"Ice Cream Bar","Food : Restaurants","Food","Restaurants","",$24.17,$0.00,$4931.77
"Avidia Checking",,U,4151,07/21/2014,"hillside meadows","Recreation : Alyssa Horse","Recreation","Alyssa Horse","",$100.00,$0.00,$4831.77
"Avidia Checking",,U,,07/25/2014,"Mom gift","Income : Available next month","Income","Available next month","(Split 1/2) 750",$0.00,$750.00,$5831.77
"Avidia Checking",,U,,07/25/2014,"Mom gift","Recreation : Vacation","Recreation","Vacation","(Split 2/2) 250",$0.00,$250.00,$5831.77
"Avidia Checking",,U,,07/31/2014,"Pumpkin Brook","Income : Available this month","Income","Available this month","",$0.00,$248.19,$6079.96
"Avidia Checking",,U,4152,07/31/2014,"HMEC","Recreation : Alyssa Horse","Recreation","Alyssa Horse","",$50.00,$0.00,$6029.96
"Avidia Checking",,U,,07/31/2014,"verizon wireless","Housing : Cell Phones","Hidden Categories","Housing ` Cell Phones","",$94.34,$0.00,$5935.62
"Avidia Checking",,U,,07/31/2014,"Marlboro","Housing : Real Estate Tax","Hidden Categories","Housing ` Real Estate Tax","",$1274.37,$0.00,$4661.25
"Avidia Checking",,U,,08/01/2014,"Save the children","Charity : Other","Charity","Other","",$28.00,$0.00,$4633.25
"Avidia Checking",,U,,08/04/2014,"Iroquis","Recreation : Vacation","Recreation","Vacation","",$21.29,$0.00,$4611.96
"Avidia Checking",,U,,08/05/2014,"bank fee","Recreation : Vacation","Recreation","Vacation","",$0.64,$0.00,$4611.32
"Avidia Checking",,U,,08/05/2014,"Antica pizza","Recreation : Vacation","Recreation","Vacation","",$63.71,$0.00,$4547.61
"Avidia Checking",,U,,08/05/2014,"verizon fios","Housing : Phone & Internet","Hidden Categories","Housing ` Phone & Internet","",$70.61,$0.00,$4477.00
"Avidia Checking",,U,4147,08/05/2014,"Safety Insurane","Transportation : Car Insurance","Transportation","Car Insurance","",$336.10,$0.00,$4140.90
"Avidia Checking",,U,,08/08/2014,"interest","Income : Available next month","Income","Available next month","",$0.00,$0.23,$4141.13
"Avidia Checking",,U,4148,08/08/2014,"HMEC","Recreation : Alyssa Horse","Recreation","Alyssa Horse","",$50.00,$0.00,$4091.13
"Avidia Checking",,U,4150,08/11/2014,"Richard Kaish","Personal : Gifts","Personal","Gifts","",$58.45,$0.00,$4032.68
"Avidia Checking",,U,,08/11/2014,"NGRID","Housing : Electricity","Hidden Categories","Housing ` Electricity","",$134.48,$0.00,$3898.20
"Avidia Checking",,U,,08/11/2014,"Transfer : Target",,,,"",$374.08,$0.00,$3524.12
"Avidia Checking",,U,,08/12/2014,"rite aid","Personal : Prescriptions, Medicine","Personal","Prescriptions, Medicine","",$10.59,$0.00,$3513.53
"Avidia Checking",,U,,08/12/2014,"Fastlane","Transportation : tolls","Transportation","tolls","",$10.85,$0.00,$3502.68
"Avidia Checking",,U,,08/12/2014,"Captain Frosty","Food : Restaurants","Food","Restaurants","",$50.63,$0.00,$3452.05
"Avidia Checking",,U,,08/13/2014,"Transfer : avidia - Lisa Business",,,,"",$0.00,$4000.00,$7452.05
"Avidia Checking",,U,,08/13/2014,"peterson market dennis","Food : Groceries","Food","Groceries","",$35.64,$0.00,$7416.41
"Avidia Checking",,U,,08/13/2014,"Transfer : Discover",,,,"",$1776.93,$0.00,$5639.48
"Avidia Checking",,U,,08/14/2014,"Pumpkin Brook","Income : Available this month","Income","Available this month","",$0.00,$128.69,$5768.17
"Avidia Checking",,U,,08/18/2014,"nstar","Housing : Gas","Hidden Categories","Housing ` Gas","",$40.43,$0.00,$5727.74
"Avidia Checking",,U,,08/19/2014,"Fastlane","Transportation : tolls","Transportation","tolls","",$11.60,$0.00,$5716.14
"Avidia Checking",,U,4149,08/19/2014,"A house of suede","Personal : cloths","Personal","cloths","",$17.95,$0.00,$5698.19
"Avidia Checking",,U,,08/19/2014,"Deb shop worcester","Personal : cloths","Personal","cloths","",$35.00,$0.00,$5663.19
"Avidia Checking",,U,,08/19/2014,"Transfer : Lisa Cash Account",,,,"",$300.00,$0.00,$5363.19
"Avidia Checking",,U,,08/20/2014,"aztec mexican","Food : Restaurants","Food","Restaurants","",$18.76,$0.00,$5344.43
"Avidia Checking",,U,,08/20/2014,"Hess","Transportation : Gas","Transportation","Gas","",$32.03,$0.00,$5312.40
"Avidia Checking",,U,,08/20/2014,"northside grill","Food : Restaurants","Food","Restaurants","",$39.68,$0.00,$5272.72
"Avidia Checking",,U,,08/25/2014,"hannaford","Food : Groceries","Food","Groceries","",$142.38,$0.00,$5130.34
"Avidia Checking",,U,,08/25/2014,"Marlboro","Housing : Water","Hidden Categories","Housing ` Water","",$205.77,$0.00,$4924.57
"Avidia Checking",,U,4155,08/26/2014,"Transfer : DCU Home Equity Credit line",,,,"",$1000.00,$0.00,$3924.57
"Avidia Checking",,U,,08/28/2014,"Pumpkin Brook","Income : Available next month","Income","Available next month","",$0.00,$133.28,$4057.85
"Avidia Checking",,U,4176,08/29/2014,"HMEC","Recreation : Alyssa Horse","Recreation","Alyssa Horse","",$100.00,$0.00,$3957.85
"Avidia Checking",,U,,08/29/2014,"Uconn","Education : College","Education","College","",$102.00,$0.00,$3855.85
"Avidia Checking",,U,,09/02/2014,"Deposit","Income : Available this month","Income","Available this month","",$0.00,$200.00,$4055.85
"Avidia Checking",,U,,09/02/2014,"Save the children","Charity : Other","Charity","Other","",$28.00,$0.00,$4027.85
"Avidia Checking",,U,,09/04/2014,"verizon wireless","Housing : Cell Phones","Hidden Categories","Housing ` Cell Phones","",$104.25,$0.00,$3923.60
"Avidia Checking",,U,,09/04/2014,"Transfer : Discover",,,,"",$2864.71,$0.00,$1058.89
"Avidia Checking",,U,,09/05/2014,"Transfer : avidia - Lisa Business",,,,"",$0.00,$3000.00,$4058.89
"Avidia Checking",,U,,09/05/2014,"verizon fios","Housing : Phone & Internet","Hidden Categories","Housing ` Phone & Internet","",$95.21,$0.00,$3963.68
"Avidia Checking",,U,,09/08/2014,"interest","Income : Available next month","Income","Available next month","",$0.00,$0.19,$3963.87
"Avidia Checking",,U,,09/09/2014,"peterson market dennis","Food : Groceries","Food","Groceries","",$11.05,$0.00,$3952.82
"Avidia Checking",,U,,09/09/2014,"NGRID","Housing : Electricity","Hidden Categories","Housing ` Electricity","",$70.08,$0.00,$3882.74
"Avidia Checking",,U,,09/09/2014,"Transfer : Lisa Cash Account",,,,"",$100.00,$0.00,$3782.74
"Avidia Checking",,U,,09/09/2014,"Transfer : Target",,,,"",$131.96,$0.00,$3650.78
"Avidia Checking",,U,4156,09/10/2014,"Larry Swedroe","Education : Investing","Education","Investing","",$30.00,$0.00,$3620.78
"Avidia Checking",,U,,09/11/2014,"Pumpkin Brook","Income : Available next month","Income","Available next month","",$0.00,$356.33,$3977.11
"Avidia Checking",,U,,09/15/2014,"Transfer : Lisa Cash Account",,,,"",$100.00,$0.00,$3877.11
"Avidia Checking",,U,,09/15/2014,"Transfer : avidia - Lisa Business",,,,"",$1500.00,$0.00,$2377.11
"Avidia Checking",,U,,09/17/2014,"nstar","Housing : Gas","Hidden Categories","Housing ` Gas","",$37.53,$0.00,$2339.58
"Avidia Checking",,U,4157,09/22/2014,"Uconn","Education : College","Education","College","Equestrian",$420.00,$0.00,$1919.58
"Avidia Checking",,U,,09/23/2014,"westward orchards Harvard","Food : Groceries","Food","Groceries","",$20.90,$0.00,$1898.68
"Avidia Checking",,U,,09/25/2014,"Pumpkin Brook","Income : Available next month","Income","Available next month","",$0.00,$239.00,$2137.68
"Avidia Checking",,U,,09/26/2014,"Deposit","Income : Available this month","Income","Available this month","",$0.00,$371.00,$2508.68
"Avidia Checking",,U,,09/29/2014,"Transfer : avidia - Lisa Business",,,,"",$0.00,$300.00,$2808.68
"Avidia Checking",,U,,10/01/2014,"Save the children","Charity : Other","Charity","Other","",$28.00,$0.00,$2780.68
"Avidia Checking",,U,,10/02/2014,"verizon wireless","Housing : Cell Phones","Hidden Categories","Housing ` Cell Phones","",$97.02,$0.00,$2683.66
"Avidia Checking",,U,,10/03/2014,"Transfer : Discover",,,,"",$1275.64,$0.00,$1408.02
"Avidia Checking",,U,,10/06/2014,"Transfer : avidia - Lisa Business",,,,"",$0.00,$9000.00,$10408.02
"Avidia Checking",,U,,10/06/2014,"verizon fios","Housing : Phone & Internet","Hidden Categories","Housing ` Phone & Internet","",$95.21,$0.00,$10312.81
"Avidia Checking",,U,,10/08/2014,"interest","Income : Available next month","Income","Available next month","",$0.00,$0.14,$10312.95
"Avidia Checking",,U,,10/09/2014,"Pumpkin Brook","Income : Available next month","Income","Available next month","",$0.00,$183.84,$10496.79
"Avidia Checking",,U,,10/09/2014,"NGRID","Housing : Electricity","Hidden Categories","Housing ` Electricity","",$94.31,$0.00,$10402.48
"Avidia Checking",,U,,10/09/2014,"Transfer : avidia - Lisa Business",,,,"",$3000.00,$0.00,$7402.48
"Avidia Checking",,U,,10/10/2014,"Deposit","Income : Available this month","Income","Available this month","",$0.00,$300.00,$7702.48
"Avidia Checking",,U,4177,10/10/2014,"Hudson appliance","Housing : Maintenance & Repairs","Hidden Categories","Housing ` Maintenance & Repairs","",$159.95,$0.00,$7542.53
"Avidia Checking",,U,,10/10/2014,"Transfer : Target",,,,"",$381.64,$0.00,$7160.89
"Avidia Checking",,U,,10/10/2014,"Safety Insurane","Transportation : Car Insurance","Transportation","Car Insurance","",$709.20,$0.00,$6451.69
"Avidia Checking",,U,4158,10/14/2014,"Run UC","Education : College","Education","College","",$60.00,$0.00,$6391.69
"Avidia Checking",,U,,10/17/2014,"nstar","Housing : Gas","Hidden Categories","Housing ` Gas","",$52.04,$0.00,$6339.65
"Avidia Checking",,U,,10/23/2014,"Pumpkin Brook","Income : Available next month","Income","Available next month","",$0.00,$110.31,$6449.96
"Avidia Checking",,U,,10/23/2014,"savers marlboro","Personal : cloths","Personal","cloths","",$6.35,$0.00,$6443.61
"Avidia Checking",,U,,10/24/2014,"Sorrentos Italian","Food : Restaurants","Food","Restaurants","",$63.74,$0.00,$6379.87
"Avidia Checking",,U,,10/27/2014,"Deposit","Income : Available this month","Income","Available this month","",$0.00,$100.00,$6479.87
"Avidia Checking",,U,4159,10/27/2014,"Mary Stapleton School","Housing : Supplies","Hidden Categories","Housing ` Supplies","",$20.00,$0.00,$6459.87
"Avidia Checking",,U,4161,10/27/2014,"Hair Razors","Personal : Miscellaneous","Personal","Miscellaneous","",$35.00,$0.00,$6424.87
"Avidia Checking",,U,,10/29/2014,"Cape cod art","Personal : Gifts","Personal","Gifts","",$10.00,$0.00,$6414.87
"Avidia Checking",,U,,10/29/2014,"Cape cod art","Personal : Gifts","Personal","Gifts","",$20.00,$0.00,$6394.87
"Avidia Checking",,U,,11/03/2014,"peterson market dennis","Food : Groceries","Food","Groceries","",$7.58,$0.00,$6387.29
"Avidia Checking",,U,,11/03/2014,"Save the children","Charity : Other","Charity","Other","",$28.00,$0.00,$6359.29
"Avidia Checking",,U,,11/03/2014,"verizon wireless","Housing : Cell Phones","Hidden Categories","Housing ` Cell Phones","",$103.88,$0.00,$6255.41
"Avidia Checking",,U,,11/03/2014,"city of marlboro","Housing : Real Estate Tax","Hidden Categories","Housing ` Real Estate Tax","",$1274.37,$0.00,$4981.04
"Avidia Checking",,U,,11/04/2014,"Transfer : Discover",,,,"",$1992.13,$0.00,$2988.91
"Avidia Checking",,U,,11/05/2014,"verizon fios","Housing : Phone & Internet","Hidden Categories","Housing ` Phone & Internet","",$95.30,$0.00,$2893.61
"Avidia Checking",,U,,11/06/2014,"Pumpkin Brook","Income : Available next month","Income","Available next month","",$0.00,$129.81,$3023.42
"Avidia Checking",,U,4162,11/06/2014,"Safety Insurane","Transportation : Car Insurance","Transportation","Car Insurance","",$342.10,$0.00,$2681.32
"Avidia Checking",,U,,11/08/2014,"Interest credit","Income : Available next month","Income","Available next month","",$0.00,$0.25,$2681.57
"Avidia Checking",,U,,11/10/2014,"NGRID","Housing : Electricity","Hidden Categories","Housing ` Electricity","",$77.18,$0.00,$2604.39
"Avidia Checking",,U,,11/10/2014,"Transfer : Target",,,,"",$411.15,$0.00,$2193.24
"Avidia Checking",,U,,11/12/2014,"Checks in Ma Purchase","Personal : BankFee","Personal","BankFee","",$24.76,$0.00,$2168.48
"Avidia Checking",,U,,11/17/2014,"nstar","Housing : Gas","Hidden Categories","Housing ` Gas","",$77.17,$0.00,$2091.31
"Avidia Checking",,U,4163,11/18/2014,"city of marlboro","Housing : Water","Hidden Categories","Housing ` Water","",$450.00,$0.00,$1641.31
"Avidia Checking",,U,,11/20/2014,"Pumpkin Brook","Income : Available next month","Income","Available next month","",$0.00,$234.42,$1875.73
"Avidia Checking",,U,4160,11/26/2014,"Uconn","Education : College","Education","College","",$55.00,$0.00,$1820.73
"Avidia Checking",,U,4165,11/28/2014,"Marlboro firefighters","Charity : Other","Charity","Other","",$20.00,$0.00,$1800.73
"Avidia Checking",,U,,12/01/2014,"peterson market dennis","Food : Groceries","Food","Groceries","",$8.46,$0.00,$1792.27
"Avidia Checking",,U,,12/01/2014,"Save the children","Charity : Other","Charity","Other","",$28.00,$0.00,$1764.27
"Avidia Checking",,U,,12/02/2014,"Transfer : avidia - Lisa Business",,,,"",$0.00,$1500.00,$3264.27
"Avidia Checking",,U,,12/03/2014,"Transfer : avidia - Lisa Business",,,,"",$0.00,$1000.00,$4264.27
"Avidia Checking",,U,,12/03/2014,"verizon wireless","Housing : Cell Phones","Hidden Categories","Housing ` Cell Phones","",$127.47,$0.00,$4136.80
"Avidia Checking",,U,,12/04/2014,"Pumpkin Brook","Income : Available next month","Income","Available next month","",$0.00,$96.51,$4233.31
"Avidia Checking",,U,,12/04/2014,"Credit card charge foriegn payment","Personal : Gifts","Personal","Gifts","",$0.29,$0.00,$4233.02
"Avidia Checking",,U,,12/04/2014,"topspin media","Personal : Gifts","Personal","Gifts","",$19.49,$0.00,$4213.53
"Avidia Checking",,U,,12/04/2014,"artprintori","Personal : Gifts","Personal","Gifts","",$29.08,$0.00,$4184.45
"Avidia Checking",,U,,12/04/2014,"Transfer : Discover",,,,"",$2637.60,$0.00,$1546.85
"Avidia Checking",,U,,12/08/2014,"interest","Income : Available next month","Income","Available next month","",$0.00,$0.08,$1546.93
"Avidia Checking",,U,,12/08/2014,"verizon fios","Housing : Phone & Internet","Hidden Categories","Housing ` Phone & Internet","",$95.30,$0.00,$1451.63
"Avidia Checking",,U,4158,12/08/2014,"Anna Mattei","Personal : Gifts","Personal","Gifts","Gift Sera",$200.00,$0.00,$1251.63
"Avidia Checking",,U,4167,12/08/2014,"Safety Insurane","Housing : House/Rental Insurance","Hidden Categories","Housing ` House/Rental Insurance","(Split 1/2) ",$90.00,$0.00,$909.53
"Avidia Checking",,U,4167,12/08/2014,"Safety Insurane","Transportation : Car Insurance","Transportation","Car Insurance","(Split 2/2) ",$252.10,$0.00,$909.53
"Avidia Checking",,U,,12/09/2014,"NGRID","Housing : Electricity","Hidden Categories","Housing ` Electricity","",$91.05,$0.00,$818.48
"Avidia Checking",,U,,12/10/2014,"Transfer : Target",,,,"",$257.98,$0.00,$560.50
"Avidia Checking",,U,4169,12/12/2014,"city of marlboro","Housing : Water","Hidden Categories","Housing ` Water","",$450.00,$0.00,$110.50
"Avidia Checking",,U,,12/15/2014,"Deposit","Income : Available this month","Income","Available this month","",$0.00,$60.00,$170.50
"Avidia Checking",,U,4166,12/15/2014,"Uconn Western","Recreation : Alyssa Horse","Recreation","Alyssa Horse","",$108.77,$0.00,$61.73
"Avidia Checking",,U,,12/17/2014,"nstar","Housing : Gas","Hidden Categories","Housing ` Gas","",$181.17,$0.00,-$119.44
"Avidia Checking",,U,,12/18/2014,"Pumpkin Brook","Income : Available next month","Income","Available next month","",$0.00,$105.00,-$14.44
"Avidia Checking",,U,,12/18/2014,"bank  fee","Personal : BankFee","Personal","BankFee","",$30.00,$0.00,-$44.44
"Avidia Checking",,U,,12/23/2014,"bank  fee","Personal : BankFee","Personal","BankFee","",$2.00,$0.00,-$46.44
"Avidia Checking",,U,,12/24/2014,"Transfer : avidia - Lisa Business",,,,"",$0.00,$2400.00,$2353.56
"Avidia Checking",,U,,12/24/2014,"bank  fee","Personal : BankFee","Personal","BankFee","",$2.00,$0.00,$2351.56
"Avidia Checking",,U,,12/24/2014,"Fastlane","Transportation : tolls","Transportation","tolls","",$11.40,$0.00,$2340.16
"Avidia Checking",,U,,12/29/2014,"Transfer : avidia - Lisa Business",,,,"",$0.00,$3000.00,$5340.16
"Avidia Checking",,U,,12/29/2014,"Deposit","Income : Available this month","Income","Available this month","",$0.00,$521.00,$5861.16
"Avidia Checking",,U,,12/31/2014,"unemployment","Income : Available next month","Income","Available next month","",$0.00,$188.00,$6049.16
"Avidia Checking",,U,4178,12/31/2014,"HMEC","Recreation : Alyssa Horse","Recreation","Alyssa Horse","",$50.00,$0.00,$5999.16
"Avidia Checking",,U,,01/02/2015,"Save the children","Charity : Other","Charity","Other","",$28.00,$0.00,$5971.16
"Avidia Checking",,U,,01/02/2015,"verizon wireless","Housing : Cell Phones","Hidden Categories","Housing ` Cell Phones","",$119.84,$0.00,$5851.32
"Avidia Checking",,U,,01/03/2015,"Transfer : Discover",,,,"",$2448.29,$0.00,$3403.03
"Avidia Checking",,U,,01/05/2015,"verizon fios","Housing : Phone & Internet","Hidden Categories","Housing ` Phone & Internet","",$95.30,$0.00,$3307.73
"Avidia Checking",,U,4170,01/07/2015,"Safety Insurane","Transportation : Car Insurance","Transportation","Car Insurance","(Split 1/2) ",$232.10,$0.00,$2965.63
"Avidia Checking",,U,4170,01/07/2015,"Safety Insurane","Housing : House/Rental Insurance","Hidden Categories","Housing ` House/Rental Insurance","(Split 2/2) ",$110.00,$0.00,$2965.63
"Avidia Checking",,U,,01/08/2015,"unemployment","Income : Available next month","Income","Available next month","",$0.00,$94.00,$3059.63
"Avidia Checking",,U,,01/08/2015,"Interest credit","Income : Available next month","Income","Available next month",,$0.00,$0.09,$3059.72
"Avidia Checking",,U,4171,01/09/2015,"HMEC","Recreation : Alyssa Horse","Recreation","Alyssa Horse","",$50.00,$0.00,$3009.72
"Avidia Checking",,U,,01/12/2015,"NGRID","Housing : Electricity","Hidden Categories","Housing ` Electricity","",$74.90,$0.00,$2934.82
"Avidia Checking",,U,,01/12/2015,"Transfer : Target",,,,"",$402.85,$0.00,$2531.97
"Avidia Checking",,U,,01/15/2015,"Deposit","Income : Available this month","Income","Available this month","",$0.00,$300.00,$2831.97
"Avidia Checking",,U,,01/15/2015,"Zitis","Food : Restaurants","Food","Restaurants","",$73.90,$0.00,$2758.07
"Avidia Checking",,U,4172,01/16/2015,"Marlboro dental","Personal : Doctor, Dentist","Personal","Doctor, Dentist",,$120.00,$0.00,$2638.07
"Avidia Checking",,U,,01/20/2015,"nstar","Housing : Gas","Hidden Categories","Housing ` Gas","",$231.62,$0.00,$2406.45
"Avidia Checking",,U,,01/21/2015,"Transfer : avidia - Lisa Business",,,,"",$0.00,$500.00,$2906.45
"Avidia Checking",,U,,01/21/2015,"OneCard","Education : College","Education","College","",$102.00,$0.00,$2804.45
"Avidia Checking",,U,4173,01/21/2015,"Belli Corp","Housing : Maintenance & Repairs","Hidden Categories","Housing ` Maintenance & Repairs","Plumbing",$295.00,$0.00,$2509.45
"Avidia Checking",,U,,01/27/2015,"etrade Refund for trades","Income : Available next month","Income","Available next month","",$0.00,$500.00,$3009.45
"Avidia Checking",,U,,01/27/2015,"unemployment","Income : Available next month","Income","Available next month","",$0.00,$60.00,$3069.45
"Avidia Checking",,U,4179,01/28/2015,"Belliplumbing","Housing : Maintenance & Repairs","Hidden Categories","Housing ` Maintenance & Repairs","Toilets shower etc",$788.63,$0.00,$2280.82
"Avidia Checking",,U,,01/30/2015,"Transfer : Dcu Checking",,,,"",$0.00,$5000.00,$7280.82
"Avidia Checking",,U,,02/02/2015,"unemployment","Income : Available next month","Income","Available next month","",$0.00,$60.00,$7340.82
"Avidia Checking",,U,,02/02/2015,"Save the children","Charity : Other","Charity","Other","",$28.00,$0.00,$7312.82
"Avidia Checking",,U,,02/02/2015,"verizon wireless","Housing : Cell Phones","Hidden Categories","Housing ` Cell Phones","",$105.11,$0.00,$7207.71
"Avidia Checking",,U,4180,02/02/2015,"Ma Health Connector","Personal : Health Insurance","Personal","Health Insurance","FEB and March",$492.00,$0.00,$6715.71
"Avidia Checking",,U,4182,02/02/2015,"sears","Housing : Maintenance & Repairs","Hidden Categories","Housing ` Maintenance & Repairs","Dish Washer",$569.36,$0.00,$6146.35
"Avidia Checking",,U,,02/02/2015,"Marlboro","Housing : Real Estate Tax","Hidden Categories","Housing ` Real Estate Tax","",$1276.39,$0.00,$4869.96
"Avidia Checking",,U,4175,02/04/2015,"Uconn","Recreation : Alyssa Horse","Recreation","Alyssa Horse","",$420.00,$0.00,$4449.96
"Avidia Checking",,U,,02/05/2015,"verizon fios","Housing : Phone & Internet","Hidden Categories","Housing ` Phone & Internet","",$95.45,$0.00,$4354.51
"Avidia Checking",,U,4183,02/05/2015,"Safety Insurane","Housing : House/Rental Insurance","Hidden Categories","Housing ` House/Rental Insurance","(Split 1/2) 100",$100.00,$0.00,$4012.41
"Avidia Checking",,U,4183,02/05/2015,"Safety Insurane","Transportation : Car Insurance","Transportation","Car Insurance","(Split 2/2) 242.10",$242.10,$0.00,$4012.41
"Avidia Checking",,U,,02/06/2015,"unemployment","Income : Available next month","Income","Available next month","",$0.00,$60.00,$4072.41
"Avidia Checking",,U,,02/06/2015,"savers marlboro","Personal : cloths","Personal","cloths","",$14.82,$0.00,$4057.59
"Avidia Checking",,U,4186,02/06/2015,"Sudbury Valley trustees","Charity : Other","Charity","Other","",$50.00,$0.00,$4007.59
"Avidia Checking",,U,,02/08/2015,"interest","Income : Available next month","Income","Available next month","",$0.00,$0.15,$4007.74
"Avidia Checking",,U,,02/08/2015,"Uconn","Education : College","Education","College","",$102.00,$0.00,$3905.74
"Avidia Checking",,U,4184,02/09/2015,"Marlboro","Housing : Water","Hidden Categories","Housing ` Water","",$450.00,$0.00,$3455.74
"Avidia Checking",,U,,02/09/2015,"Transfer : Target",,,,"one card",$451.11,$0.00,$3004.63
"Avidia Checking",,U,,02/09/2015,"RV Downpayment",,,,"",$500.00,$0.00,$2504.63
"Avidia Checking",,U,,02/10/2015,"Fastlane","Transportation : tolls","Transportation","tolls","",$13.40,$0.00,$2491.23
"Avidia Checking",,U,,02/10/2015,"Transfer : Lisa Cash Account",,,,"",$100.00,$0.00,$2391.23
"Avidia Checking",,U,,02/11/2015,"NGRID","Housing : Electricity","Hidden Categories","Housing ` Electricity","",$136.33,$0.00,$2254.90
"Avidia Checking",,U,,02/13/2015,"unemployment","Income : Available next month","Income","Available next month","",$0.00,$60.00,$2314.90
"Avidia Checking",,U,,02/17/2015,"Martins Chester VA","Food : Groceries","Food","Groceries","RV TRIP - GROCERIES?",$21.05,$0.00,$2293.85
"Avidia Checking",,U,,02/18/2015,"Tax refund MASSACHUSETTS","Income : Available this month","Income","Available this month","",$0.00,$647.00,$2940.85
"Avidia Checking",,U,,02/18/2015,"SMG","Personal : Doctor, Dentist","Personal","Doctor, Dentist","",$15.00,$0.00,$2925.85
"Avidia Checking",,U,,02/18/2015,"Eversource","Housing : Gas","Hidden Categories","Housing ` Gas","",$311.92,$0.00,$2613.93
"Avidia Checking",,U,,02/24/2015,"unemployment","Income : Available next month","Income","Available next month","",$0.00,$60.00,$2673.93
"Avidia Checking",,U,,03/02/2015,"Save the children","Charity : Other","Charity","Other","",$28.00,$0.00,$2645.93
"Avidia Checking",,U,,03/02/2015,"Safety Insurane","Transportation : Car Insurance","Transportation","Car Insurance","(Split 1/2) ",$300.00,$0.00,$2223.63
"Avidia Checking",,U,,03/02/2015,"Safety Insurane","Housing : House/Rental Insurance","Hidden Categories","Housing ` House/Rental Insurance","(Split 2/2) ",$122.30,$0.00,$2223.63
"Avidia Checking",,U,,03/03/2015,"unemployment","Income : Available next month","Income","Available next month","",$0.00,$60.00,$2283.63
"Avidia Checking",,U,,03/03/2015,"Marlboro","Transportation : Auto Excise","Transportation","Auto Excise","",$37.50,$0.00,$2246.13
"Avidia Checking",,U,,03/03/2015,"Marlboro","Transportation : Auto Excise","Transportation","Auto Excise","",$48.75,$0.00,$2197.38
"Avidia Checking",,U,,03/04/2015,"IRS  tax refund","Income : Available next month","Income","Available next month","",$0.00,$606.00,$2803.38
"Avidia Checking",,U,,03/04/2015,"verizon wireless","Housing : Cell Phones","Hidden Categories","Housing ` Cell Phones","",$108.56,$0.00,$2694.82
"Avidia Checking",,U,,03/06/2015,"unemployment","Income : Available next month","Income","Available next month","",$0.00,$60.00,$2754.82
"Avidia Checking",,U,4185,03/06/2015,"Marlboro","Housing : Dog","Hidden Categories","Housing ` Dog","License",$10.00,$0.00,$2744.82
"Avidia Checking",,U,,03/08/2015,"interest","Income : Available next month","Income","Available next month","",$0.00,$0.09,$2744.91
"Avidia Checking",,U,,03/09/2015,"verizon fios","Housing : Phone & Internet","Hidden Categories","Housing ` Phone & Internet","",$95.45,$0.00,$2649.46
"Avidia Checking",,U,,03/09/2015,"Transfer : Target",,,,"",$326.01,$0.00,$2323.45
"Avidia Checking",,U,,03/11/2015,"NGRID","Housing : Electricity","Hidden Categories","Housing ` Electricity","",$83.69,$0.00,$2239.76
"Avidia Checking",,U,,03/16/2015,"bank  fee","Personal : BankFee","Personal","BankFee","",$2.50,$0.00,$2237.26
"Avidia Checking",,U,,03/16/2015,"bank  fee","Personal : BankFee","Personal","BankFee","RV TRIP",$3.25,$0.00,$2234.01
"Avidia Checking",,U,4190,03/16/2015,"Twin Rivers Park","RV : Campgrounds","RV","Campgrounds","",$29.83,$0.00,$2204.18
"Avidia Checking",,U,,03/16/2015,"Jekyll Iland camp ground","RV : Campgrounds","RV","Campgrounds","",$40.16,$0.00,$2164.02
"Avidia Checking",,U,,03/16/2015,"100 cash withdrawal","RV : Campgrounds","RV","Campgrounds","100",$100.00,$0.00,$2064.02
"Avidia Checking",,U,,03/18/2015,"Eversource","Housing : Gas","Hidden Categories","Housing ` Gas","",$276.45,$0.00,$1787.57
"Avidia Checking",,U,,03/19/2015,"Mellow Mushroom","Food : Restaurants","Food","Restaurants","RV TRIP",$37.22,$0.00,$1750.35
"Avidia Checking",,U,,03/23/2015,"unemployment","Income : Available next month","Income","Available next month","",$0.00,$120.00,$1870.35
"Avidia Checking",,U,,03/24/2015,"gift from mom","Income : Available this month","Income","Available this month","",$0.00,$1000.00,$2870.35
"Avidia Checking",,U,,03/24/2015,"Ma Health Connector","Personal : Health Insurance","Personal","Health Insurance",,$246.00,$0.00,$2624.35
"Avidia Checking",,U,,03/30/2015,"uncon parking","Transportation : Parking","Transportation","Parking","",$0.00,$60.00,$2684.35
"Avidia Checking",,U,,03/30/2015,"Transfer : Lisa Cash Account",,,,"",$100.00,$0.00,$2584.35
"Avidia Checking",,U,,03/30/2015,"Safety Insurane","Transportation : Car Insurance","Transportation","Car Insurance","(Split 1/2) ",$300.00,$0.00,$2162.05
"Avidia Checking",,U,,03/30/2015,"Safety Insurane","Housing : House/Rental Insurance","Hidden Categories","Housing ` House/Rental Insurance","(Split 2/2) ",$122.30,$0.00,$2162.05
"Avidia Checking",,U,,04/01/2015,"Save the children","Charity : Other","Charity","Other","",$28.00,$0.00,$2134.05
"Avidia Checking",,U,,04/01/2015,"verizon wireless","Housing : Cell Phones","Hidden Categories","Housing ` Cell Phones",,$106.23,$0.00,$2027.82
"Avidia Checking",,U,,04/02/2015,"unemployment","Income : Available next month","Income","Available next month","",$0.00,$60.00,$2087.82
"Avidia Checking",,U,,04/06/2015,"Trombetta","Recreation : Hers","Recreation","Hers","Mini golf",$21.00,$0.00,$2066.82
"Avidia Checking",,U,,04/06/2015,"verizon fios","Housing : Phone & Internet","Hidden Categories","Housing ` Phone & Internet","",$95.45,$0.00,$1971.37
"Avidia Checking",,U,4192,04/07/2015,"city of marlboro","Housing : Water","Hidden Categories","Housing ` Water","",$500.00,$0.00,$1471.37
"Avidia Checking",,U,,04/09/2015,"interest","Income : Available next month","Income","Available next month","",$0.00,$0.09,$1471.46
"Avidia Checking",,U,4193,04/09/2015,"SMG","Personal : Doctor, Dentist","Personal","Doctor, Dentist","",$15.00,$0.00,$1456.46
"Avidia Checking",,U,4192,04/09/2015,"Kim Campos","Charity : Other","Charity","Other","",$30.00,$0.00,$1426.46
"Avidia Checking",,U,,04/10/2015,"NGRID","Housing : Electricity","Hidden Categories","Housing ` Electricity","",$50.28,$0.00,$1376.18
"Avidia Checking",,U,,04/14/2015,"Fastlane","Transportation : tolls","Transportation","tolls","",$14.00,$0.00,$1362.18
"Avidia Checking",,U,4196,04/15/2015,"Dr. Fridman","Personal : Doctor, Dentist","Personal","Doctor, Dentist","",$22.00,$0.00,$1340.18
"Avidia Checking",,U,,04/16/2015,"Eversource","Housing : Gas","Hidden Categories","Housing ` Gas","",$175.15,$0.00,$1165.03
"Avidia Checking",,U,4197,04/20/2015,"Dr Kofos","Personal : Doctor, Dentist","Personal","Doctor, Dentist","",$15.00,$0.00,$1150.03
"Avidia Checking",,U,4194,04/20/2015,"First choice Physical therapy","Personal : Doctor, Dentist","Personal","Doctor, Dentist","",$20.00,$0.00,$1130.03
"Avidia Checking",,U,4198,04/21/2015,"Waye Glazier MD","Personal : Doctor, Dentist","Personal","Doctor, Dentist","",$22.00,$0.00,$1108.03
"Avidia Checking",,U,,04/23/2015,"Pumpkin Brook","Income : Available next month","Income","Available next month","",$0.00,$185.12,$1293.15
"Avidia Checking",,U,,04/24/2015,"Ma Health Connector","Personal : Health Insurance","Personal","Health Insurance",,$246.00,$0.00,$1047.15
"Avidia Checking",,U,4199,04/27/2015,"First choice Physical therapy","Personal : Doctor, Dentist","Personal","Doctor, Dentist","",$20.00,$0.00,$1027.15
"Avidia Checking",,U,,04/27/2015,"Transfer : Lisa Cash Account",,,,"",$50.00,$0.00,$977.15
"Avidia Checking",,U,,04/29/2015,"unemployment","Income : Available next month","Income","Available next month","",$0.00,$120.00,$1097.15
"Avidia Checking",,U,4200,04/29/2015,"Carmine Imbriglio","Personal : Gifts","Personal","Gifts","",$10.00,$0.00,$1087.15
"Avidia Checking",,U,4201,05/01/2015,"First choice Physical therapy","Personal : Doctor, Dentist","Personal","Doctor, Dentist","",$20.00,$0.00,$1067.15
"Avidia Checking",,U,,05/01/2015,"Save the children","Charity : Other","Charity","Other","",$28.00,$0.00,$1039.15
"Avidia Checking",,U,,05/04/2015,"verizon wireless","Housing : Cell Phones","Hidden Categories","Housing ` Cell Phones",,$110.90,$0.00,$928.25
"Avidia Checking",,U,,05/06/2015,"ROTH DISTRIBUTION","Income : Available this month","Income","Available this month","",$0.00,$9000.00,$9928.25
"Avidia Checking",,U,,05/06/2015,"verizon fios","Housing : Phone & Internet","Hidden Categories","Housing ` Phone & Internet",,$95.57,$0.00,$9832.68
"Avidia Checking",,U,,05/07/2015,"Pumpkin Brook","Income : Available next month","Income","Available next month","",$0.00,$268.36,$10101.04
"Avidia Checking",,U,,05/08/2015,"interest","Income : Available next month","Income","Available next month","",$0.00,$0.09,$10101.13
"Avidia Checking",,U,,05/08/2015,"Safety Insurane","Transportation : Car Insurance","Transportation","Car Insurance","(Split 1/2) ",$382.70,$0.00,$9518.43
"Avidia Checking",,U,,05/08/2015,"Safety Insurane","Housing : House/Rental Insurance","Hidden Categories","Housing ` House/Rental Insurance","(Split 2/2) ",$200.00,$0.00,$9518.43
"Avidia Checking",,U,4202,05/11/2015,"First choice Physical therapy","Personal : Doctor, Dentist","Personal","Doctor, Dentist","",$20.00,$0.00,$9498.43
"Avidia Checking",,U,,05/11/2015,"Transfer : Target",,,,"",$316.99,$0.00,$9181.44
"Avidia Checking",,U,4204,05/11/2015,"city of marlboro","Housing : Water","Hidden Categories","Housing ` Water","",$500.00,$0.00,$8681.44
"Avidia Checking",,U,4203,05/11/2015,"city of marlboro","Housing : Real Estate Tax","Hidden Categories","Housing ` Real Estate Tax","",$1276.38,$0.00,$7405.06
"Avidia Checking",,U,,05/12/2015,"NGRID","Housing : Electricity","Hidden Categories","Housing ` Electricity","",$103.92,$0.00,$7301.14
"Avidia Checking",,U,,05/18/2015,"Eversource","Housing : Gas","Hidden Categories","Housing ` Gas","",$112.59,$0.00,$7188.55
"Avidia Checking",,U,,05/21/2015,"income","Income : Available next month","Income","Available next month","",$0.00,$268.36,$7456.91
"Avidia Checking",,U,,05/26/2015,"Ma Health Connector","Personal : Health Insurance","Personal","Health Insurance",,$246.00,$0.00,$7210.91
"Avidia Checking",,U,,05/28/2015,"Ma excise","Transportation : Auto Excise","Transportation","Auto Excise","",$158.13,$0.00,$7052.78
"Avidia Checking",,U,,06/01/2015,"Uconn","Education : College","Education","College","Dining Service",$12.85,$0.00,$7039.93
"Avidia Checking",,U,,06/01/2015,"Save the children","Charity : Other","Charity","Other","",$28.00,$0.00,$7011.93
"Avidia Checking",,U,,06/02/2015,"Massachuseet co payment","Personal : Miscellaneous","Personal","Miscellaneous","",$1240.00,$0.00,$5771.93
"Avidia Checking",,U,,06/03/2015,"verizon wireless","Housing : Cell Phones","Hidden Categories","Housing ` Cell Phones","",$105.48,$0.00,$5666.45
"Avidia Checking",,U,,06/04/2015,"income","Income : Available next month","Income","Available next month","",$0.00,$263.65,$5930.10
"Avidia Checking",,U,,06/05/2015,"verizon fios","Housing : Phone & Internet","Hidden Categories","Housing ` Phone & Internet",,$95.57,$0.00,$5834.53
"Avidia Checking",,U,,06/08/2015,"interest","Income : Available next month","Income","Available next month","",$0.00,$0.30,$5834.83
"Avidia Checking",,U,,06/10/2015,"Transfer : Target",,,,"",$198.67,$0.00,$5636.16
"Avidia Checking",,U,,06/11/2015,"NGRID","Housing : Electricity","Hidden Categories","Housing ` Electricity","",$90.05,$0.00,$5546.11
"Avidia Checking",,U,,06/16/2015,"Deposit","Income : Available this month","Income","Available this month","",$0.00,$150.00,$5696.11
"Avidia Checking",,U,,06/16/2015,"subway","Food : Restaurants","Food","Restaurants","",$9.95,$0.00,$5686.16
"Avidia Checking",,U,,06/17/2015,"Eversource","Housing : Gas","Hidden Categories","Housing ` Gas","",$39.17,$0.00,$5646.99
"Avidia Checking",,U,,06/18/2015,"income","Income : Available next month","Income","Available next month","",$0.00,$273.09,$5920.08
"Avidia Checking",,U,,06/18/2015,"Mass eft","Income Tax : Estimated","Hidden Categories","Income Tax ` Estimated","",$500.00,$0.00,$5420.08
"Avidia Checking",,U,4211,06/19/2015,"United States treasury","Income Tax : Estimated","Hidden Categories","Income Tax ` Estimated","",$1500.00,$0.00,$3920.08
"Avidia Checking",,U,4206,06/22/2015,"Cliff Lander","Personal : Gifts","Personal","Gifts","",$50.00,$0.00,$3870.08
"Avidia Checking",,U,,06/24/2015,"Ma Health Connector","Personal : Health Insurance","Personal","Health Insurance",,$246.00,$0.00,$3624.08
"Avidia Checking",,U,,06/25/2015,"Deposit","Income : Available this month","Income","Available this month","GIFT MOM",$0.00,$10000.00,$13624.08
"Avidia Checking",,U,,06/26/2015,"Transfer : Lisa Cash Account",,,,"",$100.00,$0.00,$13524.08
"Avidia Checking",,U,4208,06/30/2015,"Matt Swinton","Personal : Gifts","Personal","Gifts","",$100.00,$0.00,$13424.08
"Avidia Checking",,U,,07/01/2015,"Save the children","Charity : Other","Charity","Other","",$28.00,$0.00,$13396.08
"Avidia Checking",,U,,07/02/2015,"income","Income : Available next month","Income","Available next month","",$0.00,$254.25,$13650.33
"Avidia Checking",,U,,07/02/2015,"Fastlane","Transportation : tolls","Transportation","tolls",,$10.35,$0.00,$13639.98
"Avidia Checking",,U,,07/02/2015,"verizon fios","Housing : Phone & Internet","Hidden Categories","Housing ` Phone & Internet","",$95.57,$0.00,$13544.41
"Avidia Checking",,U,,07/02/2015,"verizon wireless","Housing : Cell Phones","Hidden Categories","Housing ` Cell Phones","",$111.54,$0.00,$13432.87
"Avidia Checking",,U,,07/02/2015,"Safety Insurane","Transportation : Car Insurance","Transportation","Car Insurance","",$500.00,$0.00,$12932.87
"Avidia Checking",,U,4210,07/06/2015,"Berlin post office","Recreation : Alyssa","Recreation","Alyssa","Passport",$25.00,$0.00,$12907.87
"Avidia Checking",,U,4212,07/07/2015,"Passports","Recreation : Alyssa","Recreation","Alyssa","PASSPORT",$110.00,$0.00,$12797.87
"Avidia Checking",,U,,07/08/2015,"interest","Income : Available next month","Income","Available next month","",$0.00,$0.35,$12798.22
"Avidia Checking",,U,,07/08/2015,"bank  fee","Personal : BankFee","Personal","BankFee","",$1.00,$0.00,$12797.22
"Avidia Checking",,U,,07/09/2015,"bank fee","Education : College","Education","College","",$7.73,$0.00,$12789.49
"Avidia Checking",,U,,07/09/2015,"ARTS AC UK","Education : College","Education","College","",$773.48,$0.00,$12016.01
"Avidia Checking",,U,,07/10/2015,"Transfer : Lisa Cash Account",,,,"",$100.00,$0.00,$11916.01
"Avidia Checking",,U,,07/10/2015,"NGRID","Housing : Electricity","Hidden Categories","Housing ` Electricity","",$147.72,$0.00,$11768.29
"Avidia Checking",,U,,07/10/2015,"Transfer : Target",,,,"",$297.66,$0.00,$11470.63
"Avidia Checking",,U,,07/13/2015,"Uconn","Education : College","Education","College","DINING",$14.33,$0.00,$11456.30
"Avidia Checking",,U,,07/13/2015,"Peppertree","RV : MISC","RV","MISC","",$102.00,$0.00,$11354.30
"Avidia Checking",,U,,07/14/2015,"Uconn","Education : College","Education","College","",$16.45,$0.00,$11337.85
"Avidia Checking",,U,,07/16/2015,"income","Income : Available next month","Income","Available next month","",$0.00,$136.53,$11474.38
"Avidia Checking",,U,,07/17/2015,"Eversource","Housing : Gas","Hidden Categories","Housing ` Gas","",$39.86,$0.00,$11434.52
"Avidia Checking",,U,,07/20/2015,"bank fee","Education : College","Education","College","",$7.99,$0.00,$11426.53
"Avidia Checking",,U,,07/20/2015,"ARTS AC UK","Education : College","Education","College","",$799.34,$0.00,$10627.19
"Avidia Checking",,U,,07/24/2015,"Ma Health Connector","Personal : Health Insurance","Personal","Health Insurance","",$246.00,$0.00,$10381.19
"Avidia Checking",,U,4214,07/28/2015,"CAPE COD HOSPITIAL","Personal : Prescriptions, Medicine","Personal","Prescriptions, Medicine","",$265.00,$0.00,$10116.19
"Avidia Checking",,U,,07/29/2015,"bank  fee","Personal : BankFee","Personal","BankFee","",$2.50,$0.00,$10113.69
"Avidia Checking",,U,,07/29/2015,"bank  fee","Personal : BankFee","Personal","BankFee","",$3.00,$0.00,$10110.69
"Avidia Checking",,U,,07/29/2015,"Transfer : Lisa Cash Account",,,,"",$100.00,$0.00,$10010.69
"Avidia Checking",,U,,07/30/2015,"Pumpkin Brook","Income : Available next month","Income","Available next month","",$0.00,$268.36,$10279.05
"Avidia Checking",,U,4215,07/31/2015,"WESTFORD DERMERTOLOGY","Personal : Doctor, Dentist","Personal","Doctor, Dentist","",$22.00,$0.00,$10257.05
"Avidia Checking",,U,,08/03/2015,"Save the children","Charity : Other","Charity","Other","",$28.00,$0.00,$10229.05
"Avidia Checking",,U,,08/03/2015,"verizon wireless","Housing : Cell Phones","Hidden Categories","Housing ` Cell Phones","",$110.32,$0.00,$10118.73
"Avidia Checking",,U,,08/03/2015,"city of marlboro","Housing : Real Estate Tax","Hidden Categories","Housing ` Real Estate Tax","",$1307.26,$0.00,$8811.47
"Avidia Checking",,U,,08/04/2015,"Uconn","Education : College","Education","College","",$2594.00,$0.00,$6217.47
"Avidia Checking",,U,,08/05/2015,"verizon fios","Housing : Phone & Internet","Hidden Categories","Housing ` Phone & Internet",,$97.29,$0.00,$6120.18
"Avidia Checking",,U,,08/08/2015,"interest","Income : Available next month","Income","Available next month","",$0.00,$0.42,$6120.60
"Avidia Checking",,U,,08/10/2015,"Transfer : avidia - Lisa Business",,,,"",$0.00,$7000.00,$13120.60
"Avidia Checking",,U,,08/10/2015,"Transfer : Target",,,,"",$167.72,$0.00,$12952.88
"Avidia Checking",,U,,08/11/2015,"NGRID","Housing : Electricity","Hidden Categories","Housing ` Electricity","",$158.54,$0.00,$12794.34
"Avidia Checking",,U,,08/13/2015,"Transfer : avidia - Lisa Business",,,,"",$0.00,$1300.00,$14094.34
"Avidia Checking",,U,,08/13/2015,"Pumpkin Brook","Income : Available next month","Income","Available next month","",$0.00,$260.74,$14355.08
"Avidia Checking",,U,,08/17/2015,"Eversource","Housing : Gas","Hidden Categories","Housing ` Gas","",$32.99,$0.00,$14322.09
"Avidia Checking",,U,4217,08/18/2015,"Shorehills Campground","RV : Campgrounds","RV","Campgrounds","",$40.00,$0.00,$14282.09
"Avidia Checking",,U,,08/19/2015,"Service Charge","Education : College","Education","College","Service fee on Tuition payment",$74.66,$0.00,$14207.43
"Avidia Checking",,U,,08/19/2015,"ARTS AC UK","Education : College","Education","College","Tuition",$7466.24,$0.00,$6741.19
"Avidia Checking",,U,4216,08/24/2015,"SMG","Personal : Doctor, Dentist","Personal","Doctor, Dentist","",$22.00,$0.00,$6719.19
"Avidia Checking",,U,4218,08/24/2015,"Shorehills Campground","RV : Campgrounds","RV","Campgrounds","",$121.57,$0.00,$6597.62
"Avidia Checking",,U,,08/24/2015,"Ma Health Connector","Personal : Health Insurance","Personal","Health Insurance","",$246.00,$0.00,$6351.62
"Avidia Checking",,U,4181,08/24/2015,"Transfer : DCU Home Equity Credit line",,,,"Check from DCU this alon with 200 above was 1000 loan payment",$800.00,$0.00,$5551.62
"Avidia Checking",,U,,08/25/2015,"Kalers Crab Lobster","Food : Restaurants","Food","Restaurants","Boothbay camping trip food",$50.15,$0.00,$5501.47
"Avidia Checking",,U,,08/26/2015,"Safety Insurane","Transportation : Car Insurance","Transportation","Car Insurance","(Split 1/2) ",$600.00,$0.00,$4711.29
"Avidia Checking",,U,,08/26/2015,"Safety Insurane","Housing : House/Rental Insurance","Hidden Categories","Housing ` House/Rental Insurance","(Split 2/2) ",$190.18,$0.00,$4711.29
"Avidia Checking",,U,,08/27/2015,"Pumpkin Brook","Income : Available next month","Income","Available next month","",$0.00,$235.41,$4946.70
"Avidia Checking",,U,,08/31/2015,"Service Charge","Recreation : Alyssa","Recreation","Alyssa","",$0.12,$0.00,$4946.58
"Avidia Checking",,U,,08/31/2015,"Harry Potter","Recreation : Alyssa","Recreation","Alyssa","",$12.46,$0.00,$4934.12
"Avidia Checking",,U,,09/01/2015,"Save the children","Charity : Other","Charity","Other","",$28.00,$0.00,$4906.12
"Avidia Checking",,U,,09/02/2015,"verizon wireless","Housing : Cell Phones","Hidden Categories","Housing ` Cell Phones",,$109.55,$0.00,$4796.57
"Avidia Checking",,U,,09/08/2015,"interest","Income : Available next month","Income","Available next month","",$0.00,$0.33,$4796.90
"Avidia Checking",,U,,09/08/2015,"verizon fios","Housing : Phone & Internet","Hidden Categories","Housing ` Phone & Internet",,$97.29,$0.00,$4699.61
"Avidia Checking",,U,,09/09/2015,"Transfer : Avidia-AlyssaAccount",,,,,$0.00,$1000.00,$5699.61
"Avidia Checking",,U,,09/09/2015,"Transfer : avidia - Lisa Business",,,,"",$0.00,$1000.00,$6699.61
"Avidia Checking",,U,,09/09/2015,"NGRID","Housing : Electricity","Hidden Categories","Housing ` Electricity","",$211.52,$0.00,$6488.09
"Avidia Checking",,U,4219,09/09/2015,"city of marlboro","Housing : Water","Hidden Categories","Housing ` Water","",$500.00,$0.00,$5988.09
"Avidia Checking",,U,,09/10/2015,"Pumpkin Brook","Income : Available next month","Income","Available next month","",$0.00,$240.12,$6228.21
"Avidia Checking",,U,,09/10/2015,"avidia bank","Education : College","Education","College","Service charge on tranfer to UAL",$23.11,$0.00,$6205.10
"Avidia Checking",,U,,09/10/2015,"Transfer : Target",,,,"",$380.41,$0.00,$5824.69
"Avidia Checking",,U,,09/10/2015,"University of Arts London","Education : College","Education","College","",$2310.98,$0.00,$3513.71
"Avidia Checking",,U,,09/14/2015,"Friendly icecream","Food : Restaurants","Food","Restaurants","",$33.42,$0.00,$3480.29
"Avidia Checking",,U,4220,09/14/2015,"Transfer : Lisa Cash Account",,,,"",$200.00,$0.00,$3280.29
"Avidia Checking",,U,,09/15/2015,"Transfer : Avidia-AlyssaAccount","Recreation : Alyssa","Recreation","Alyssa","",$0.00,$3334.00,$6614.29
"Avidia Checking",,U,,09/15/2015,"bank  fee","Personal : BankFee","Personal","BankFee","",$2.00,$0.00,$6612.29
"Avidia Checking",,U,,09/15/2015,"bank  fee","Personal : BankFee","Personal","BankFee","",$2.50,$0.00,$6609.79
"Avidia Checking",,U,,09/15/2015,"Transfer : Lisa Cash Account",,,,"",$100.00,$0.00,$6509.79
"Avidia Checking",,U,,09/15/2015,"Transfer : Robert Cash Account",,,,"",$100.00,$0.00,$6409.79
"Avidia Checking",,U,,09/16/2015,"bank  fee","Personal : BankFee","Personal","BankFee","",$2.50,$0.00,$6407.29
"Avidia Checking",,U,,09/16/2015,"bank  fee","Personal : BankFee","Personal","BankFee","",$2.75,$0.00,$6404.54
"Avidia Checking",,U,,09/16/2015,"bank  fee","Personal : BankFee","Personal","BankFee","",$3.10,$0.00,$6401.44
"Avidia Checking",,U,,09/16/2015,"Eversource","Housing : Gas","Hidden Categories","Housing ` Gas","",$32.99,$0.00,$6368.45
"Avidia Checking",,U,,09/16/2015,"Transfer : Robert Cash Account",,,,"",$60.00,$0.00,$6308.45
"Avidia Checking",,U,,09/16/2015,"Transfer : Robert Cash Account",,,,"",$309.74,$0.00,$5998.71
"Avidia Checking",,U,,09/17/2015,"bank fee","Personal : BankFee","Personal","BankFee","",$0.20,$0.00,$5998.51
"Avidia Checking",,U,,09/17/2015,"London Vacation","Recreation : Vacation","Recreation","Vacation","",$19.88,$0.00,$5978.63
"Avidia Checking",,U,,09/18/2015,"bank  fee","Personal : BankFee","Personal","BankFee","",$0.64,$0.00,$5977.99
"Avidia Checking",,U,,09/18/2015,"London Vacation","Recreation : Vacation","Recreation","Vacation","",$64.37,$0.00,$5913.62
"Avidia Checking",,U,,09/21/2015,"bank  fee","Personal : BankFee","Personal","BankFee","",$0.24,$0.00,$5913.38
"Avidia Checking",,U,,09/21/2015,"bank  fee","Personal : BankFee","Personal","BankFee","",$0.27,$0.00,$5913.11
"Avidia Checking",,U,,09/21/2015,"bank  fee","Personal : BankFee","Personal","BankFee","",$0.36,$0.00,$5912.75
"Avidia Checking",,U,,09/21/2015,"bank  fee","Personal : BankFee","Personal","BankFee","",$0.56,$0.00,$5912.19
"Avidia Checking",,U,,09/21/2015,"bank  fee","Personal : BankFee","Personal","BankFee","",$0.74,$0.00,$5911.45
"Avidia Checking",,U,,09/21/2015,"London Vacation","Recreation : Vacation","Recreation","Vacation","",$23.65,$0.00,$5887.80
"Avidia Checking",,U,,09/21/2015,"London Vacation","Recreation : Vacation","Recreation","Vacation","",$27.09,$0.00,$5860.71
"Avidia Checking",,U,,09/21/2015,"London Vacation","Recreation : Vacation","Recreation","Vacation","",$36.02,$0.00,$5824.69
"Avidia Checking",,U,,09/21/2015,"London Vacation","Recreation : Vacation","Recreation","Vacation","",$55.91,$0.00,$5768.78
"Avidia Checking",,U,,09/21/2015,"London Vacation","Recreation : Vacation","Recreation","Vacation","",$73.60,$0.00,$5695.18
"Avidia Checking",,U,,09/21/2015,"London Vacation","Recreation : Vacation","Recreation","Vacation","",$155.82,$0.00,$5539.36
"Avidia Checking",,U,,09/22/2015,"bank  fee","Personal : BankFee","Personal","BankFee","",$0.33,$0.00,$5539.03
"Avidia Checking",,U,,09/22/2015,"bank  fee","Personal : BankFee","Personal","BankFee","",$0.51,$0.00,$5538.52
"Avidia Checking",,U,,09/22/2015,"bank  fee","Personal : BankFee","Personal","BankFee","",$1.03,$0.00,$5537.49
"Avidia Checking",,U,,09/22/2015,"Warner Bros","Recreation : Vacation","Recreation","Vacation","",$12.35,$0.00,$5525.14
"Avidia Checking",,U,,09/22/2015,"Nandos Kings Crossing","Recreation : Vacation","Recreation","Vacation","",$33.40,$0.00,$5491.74
"Avidia Checking",,U,,09/22/2015,"DIshoom","Recreation : Vacation","Recreation","Vacation","",$51.32,$0.00,$5440.42
"Avidia Checking",,U,,09/22/2015,"Warner Bros","Recreation : Vacation","Recreation","Vacation","",$102.76,$0.00,$5337.66
"Avidia Checking",,U,,09/23/2015,"bank  fee","Personal : BankFee","Personal","BankFee","",$0.12,$0.00,$5337.54
"Avidia Checking",,U,,09/23/2015,"London Vacation","Recreation : Vacation","Recreation","Vacation","",$153.17,$0.00,$5184.37
"Avidia Checking",,U,,09/23/2015,"Ma Health Connector","Personal : Health Insurance","Personal","Health Insurance","",$246.00,$0.00,$4938.37
"Avidia Checking",,U,,09/24/2015,"income","Income : Available next month","Income","Available next month","",$0.00,$189.00,$5127.37
"Avidia Checking",,U,,09/24/2015,"Pumpkin Brook","Income : Available next month","Income","Available next month","",$0.00,$117.70,$5245.07
"Avidia Checking",,U,,09/24/2015,"bank  fee","Personal : BankFee","Personal","BankFee","",$0.07,$0.00,$5245.00
"Avidia Checking",,U,,09/24/2015,"bank  fee","Personal : BankFee","Personal","BankFee","",$0.23,$0.00,$5244.77
"Avidia Checking",,U,,09/24/2015,"bank  fee","Personal : BankFee","Personal","BankFee","",$0.65,$0.00,$5244.12
"Avidia Checking",,U,,09/24/2015,"London Vacation","Recreation : Vacation","Recreation","Vacation","",$7.15,$0.00,$5236.97
"Avidia Checking",,U,,09/24/2015,"London Vacation","Recreation : Vacation","Recreation","Vacation","",$22.83,$0.00,$5214.14
"Avidia Checking",,U,,09/24/2015,"London Vacation","Recreation : Vacation","Recreation","Vacation","",$64.56,$0.00,$5149.58
"Avidia Checking",,U,,09/24/2015,"London Vacation","Recreation : Vacation","Recreation","Vacation","",$96.93,$0.00,$5052.65
"Avidia Checking",,U,,09/28/2015,"bank  fee","Personal : BankFee","Personal","BankFee","",$0.97,$0.00,$5051.68
"Avidia Checking",,U,,09/28/2015,"BIGELOW NURSERIES  INC","Lisa Business : Cost of Goods Sold","Lisa Business","Cost of Goods Sold","",$161.50,$0.00,$4890.18
"Avidia Checking",,U,,10/01/2015,"Transfer : avidia - Lisa Business",,,,"",$0.00,$1000.00,$5890.18
"Avidia Checking",,U,,10/01/2015,"Save the children","Charity : Other","Charity","Other","",$28.00,$0.00,$5862.18
"Avidia Checking",,U,,10/01/2015,"CAVICCHIO GREENHOUSES","Lisa Business : Cost of Goods Sold","Lisa Business","Cost of Goods Sold","",$132.81,$0.00,$5729.37
"Avidia Checking",,U,,10/02/2015,"verizon wireless","Housing : Cell Phones","Hidden Categories","Housing ` Cell Phones","",$360.65,$0.00,$5368.72
"Avidia Checking",,U,,10/05/2015,"bank  fee","Personal : BankFee","Personal","BankFee","",$26.00,$0.00,$5342.72
"Avidia Checking",,U,,10/05/2015,"Hair Razors","Personal : Miscellaneous","Personal","Miscellaneous","",$35.00,$0.00,$5307.72
"Avidia Checking",,U,,10/05/2015,"London Vacation","Recreation : Vacation","Recreation","Vacation","",$316.00,$0.00,$4991.72
"Avidia Checking",,U,,10/05/2015,"Safety Insurane","Housing : House/Rental Insurance","Hidden Categories","Housing ` House/Rental Insurance","(Split 1/2) 100",$100.00,$0.00,$4609.13
"Avidia Checking",,U,,10/05/2015,"Safety Insurane","Transportation : Car Insurance","Transportation","Car Insurance","(Split 2/2) 282.59",$282.59,$0.00,$4609.13
"Avidia Checking",,U,,10/05/2015,"University of Arts London","Education : College","Education","College","",$2599.69,$0.00,$2009.44
"Avidia Checking",,U,,10/06/2015,"verizon fios","Housing : Phone & Internet","Hidden Categories","Housing ` Phone & Internet","",$96.35,$0.00,$1913.09
"Avidia Checking",,U,,10/08/2015,"Pumpkin Brook","Income : Available next month","Income","Available next month","",$0.00,$122.42,$2035.51
"Avidia Checking",,U,,10/08/2015,"interest","Income : Available next month","Income","Available next month","",$0.00,$0.19,$2035.70
"Avidia Checking",,U,,10/09/2015,"NGRID","Housing : Electricity","Hidden Categories","Housing ` Electricity","",$215.00,$0.00,$1820.70
"Avidia Checking",,U,,10/13/2015,"Transfer : Target",,,,"",$399.57,$0.00,$1421.13
"Avidia Checking",,U,4222,10/14/2015,"Zach mattei-lownes","Personal : Gifts","Personal","Gifts","",$50.00,$0.00,$1371.13
"Avidia Checking",,U,,10/16/2015,"Eversource","Housing : Gas","Hidden Categories","Housing ` Gas","",$35.06,$0.00,$1336.07
"Avidia Checking",,U,,10/19/2015,"Transfer : avidia - Lisa Business",,,,"",$0.00,$3000.00,$4336.07
"Avidia Checking",,U,,10/19/2015,"Transfer : Avidia-AlyssaAccount",,,,"",$0.00,$250.00,$4586.07
"Avidia Checking",,U,,10/20/2015,"Joshua Mattei-Lownes","Personal : Gifts","Personal","Gifts","",$50.00,$0.00,$4536.07
"Avidia Checking",,U,,10/22/2015,"Pumpkin Brook","Income : Available next month","Income","Available next month","",$0.00,$235.41,$4771.48
"Avidia Checking",,U,,10/23/2015,"Ma Health Connector","Personal : Health Insurance","Personal","Health Insurance","",$246.00,$0.00,$4525.48
"Avidia Checking",,U,,10/29/2015,"income","Income : Available next month","Income","Available next month","",$0.00,$220.56,$4746.04
"Avidia Checking",,U,,11/02/2015,"Save the children","Charity : Other","Charity","Other","",$28.00,$0.00,$4718.04
"Avidia Checking",,U,,11/02/2015,"Safety Insurane","Transportation : Car Insurance","Transportation","Car Insurance","(Split 1/2) ",$282.59,$0.00,$4335.45
"Avidia Checking",,U,,11/02/2015,"Safety Insurane","Housing : House/Rental Insurance","Hidden Categories","Housing ` House/Rental Insurance","(Split 2/2) ",$100.00,$0.00,$4335.45
"Avidia Checking",,U,,11/02/2015,"city of marlboro","Housing : Real Estate Tax","Hidden Categories","Housing ` Real Estate Tax","",$1307.26,$0.00,$3028.19
"Avidia Checking",,U,4227,11/03/2015,"Waye Glazier MD","Personal : Doctor, Dentist","Personal","Doctor, Dentist","",$22.00,$0.00,$3006.19
"Avidia Checking",,U,4225,11/03/2015,"reliant medicat","Personal : Doctor, Dentist","Personal","Doctor, Dentist","",$25.30,$0.00,$2980.89
"Avidia Checking",,U,,11/03/2015,"verizon wireless","Housing : Cell Phones","Hidden Categories","Housing ` Cell Phones","",$225.85,$0.00,$2755.04
"Avidia Checking",,U,,11/05/2015,"Pumpkin Brook","Income : Available next month","Income","Available next month","",$0.00,$230.83,$2985.87
"Avidia Checking",,U,,11/05/2015,"verizon fios","Housing : Phone & Internet","Hidden Categories","Housing ` Phone & Internet","",$103.01,$0.00,$2882.86
"Avidia Checking",,U,,11/06/2015,"income","Income : Available next month","Income","Available next month","",$0.00,$250.00,$3132.86
"Avidia Checking",,U,,11/06/2015,"interest","Income : Available next month","Income","Available next month","",$0.00,$0.14,$3133.00
"Avidia Checking",,U,,11/09/2015,"NGRID","Housing : Electricity","Hidden Categories","Housing ` Electricity","",$106.08,$0.00,$3026.92
"Avidia Checking",,U,4226,11/09/2015,"Sutherland","Housing : Maintenance & Repairs","Hidden Categories","Housing ` Maintenance & Repairs","Garage door",$150.00,$0.00,$2876.92
"Avidia Checking",,U,,11/09/2015,"Transfer : Target",,,,"",$199.41,$0.00,$2677.51
"Avidia Checking",,U,,11/16/2015,"sideline store","Personal : cloths","Personal","cloths","",$66.99,$0.00,$2610.52
"Avidia Checking",,U,,11/17/2015,"Eversource","Housing : Gas","Hidden Categories","Housing ` Gas","",$60.46,$0.00,$2550.06
"Avidia Checking",,U,,11/19/2015,"Pumpkin Brook","Income : Available next month","Income","Available next month","",$0.00,$127.13,$2677.19
"Avidia Checking",,U,,11/19/2015,"Transfer : Lisa Cash Account",,,,"",$50.00,$0.00,$2627.19
"Avidia Checking",,U,,11/23/2015,"Transfer : avidia - Lisa Business",,,,"",$0.00,$3000.00,$5627.19
"Avidia Checking",,U,,11/25/2015,"bob's turkey farm","Food : Groceries","Food","Groceries","",$64.32,$0.00,$5562.87
"Avidia Checking",,U,4229,11/25/2015,"city of marlboro","Housing : Water","Hidden Categories","Housing ` Water","",$801.30,$0.00,$4761.57
"Avidia Checking",,U,,11/27/2015,"Fastlane","Transportation : tolls","Transportation","tolls","",$14.70,$0.00,$4746.87
"Avidia Checking",,U,,11/27/2015,"barking Crab","Food : Restaurants","Food","Restaurants","",$67.78,$0.00,$4679.09
"Avidia Checking",,U,4230,11/30/2015,"serafine","Personal : Gifts","Personal","Gifts","",$100.00,$0.00,$4579.09
"Avidia Checking",,U,,12/01/2015,"Save the children","Charity : Other","Charity","Other","",$28.00,$0.00,$4551.09
"Avidia Checking",,U,,12/01/2015,"Safety Insurance","Transportation : Car Payment","Transportation","Car Payment","(Split 1/2) ",$200.00,$0.00,$4168.50
"Avidia Checking",,U,,12/01/2015,"Safety Insurance","Housing : House/Rental Insurance","Hidden Categories","Housing ` House/Rental Insurance","(Split 2/2) ",$182.59,$0.00,$4168.50
"Avidia Checking",,U,,12/02/2015,"verizon wireless","Housing : Cell Phones","Hidden Categories","Housing ` Cell Phones",,$180.30,$0.00,$3988.20
"Avidia Checking",,U,,12/03/2015,"Pumpkin Brook","Income : Available next month","Income","Available next month","",$0.00,$216.58,$4204.78
"Avidia Checking",,U,,12/04/2015,"Transfer : Robert Cash Account",,,,"",$100.00,$0.00,$4104.78
"Avidia Checking",,U,,12/07/2015,"verizon fios","Housing : Phone & Internet","Hidden Categories","Housing ` Phone & Internet",,$103.01,$0.00,$4001.77
"Avidia Checking",,U,,12/08/2015,"interest","Income : Available next month","Income","Available next month","",$0.00,$0.15,$4001.92
"Avidia Checking",,U,,12/08/2015,"NGRID","Housing : Electricity","Hidden Categories","Housing ` Electricity","",$87.62,$0.00,$3914.30
"Avidia Checking",,U,,12/10/2015,"Transfer : Target",,,,"",$182.03,$0.00,$3732.27
"Avidia Checking",,U,,12/11/2015,"Transfer : Avidia-AlyssaAccount",,,,"",$0.00,$1000.00,$4732.27
"Avidia Checking",,U,,12/11/2015,"Fastlane","Transportation : tolls","Transportation","tolls","",$10.00,$0.00,$4722.27
"Avidia Checking",,U,4231,12/11/2015,"Partners in Health","Charity : Other","Charity","Other","",$30.00,$0.00,$4692.27
"Avidia Checking",,U,,12/14/2015,"bank  fee","Personal : BankFee","Personal","BankFee","",$0.69,$0.00,$4691.58
"Avidia Checking",,U,,12/14/2015,"bank  fee","Personal : BankFee","Personal","BankFee","",$3.35,$0.00,$4688.23
"Avidia Checking",,U,,12/14/2015,"Sirena London","Recreation : Vacation","Recreation","Vacation","",$69.35,$0.00,$4618.88
"Avidia Checking",,U,,12/14/2015,"London Vacation","Recreation : Vacation","Recreation","Vacation","",$334.68,$0.00,$4284.20
"Avidia Checking",,U,,12/15/2015,"bank  fee","Personal : BankFee","Personal","BankFee","",$0.18,$0.00,$4284.02
"Avidia Checking",,U,,12/15/2015,"bank  fee","Personal : BankFee","Personal","BankFee","",$0.61,$0.00,$4283.41
"Avidia Checking",,U,,12/15/2015,"bank  fee","Personal : BankFee","Personal","BankFee","",$0.66,$0.00,$4282.75
"Avidia Checking",,U,,12/15/2015,"Edison Ford Summer Homes","Recreation : Vacation","Recreation","Vacation","",$18.48,$0.00,$4264.27
"Avidia Checking",,U,,12/15/2015,"Redd Roslindate","Food : Restaurants","Food","Restaurants","",$57.00,$0.00,$4207.27
"Avidia Checking",,U,,12/15/2015,"Carpet Center London","Recreation : Vacation","Recreation","Vacation","",$60.55,$0.00,$4146.72
"Avidia Checking",,U,,12/15/2015,"Tower of London","Recreation : Vacation","Recreation","Vacation","",$65.72,$0.00,$4081.00
"Avidia Checking",,U,,12/16/2015,"bank  fee","Personal : BankFee","Personal","BankFee","",$0.08,$0.00,$4080.92
"Avidia Checking",,U,,12/16/2015,"bank  fee","Personal : BankFee","Personal","BankFee","",$0.26,$0.00,$4080.66
"Avidia Checking",,U,,12/16/2015,"bank  fee","Personal : BankFee","Personal","BankFee","",$0.27,$0.00,$4080.39
"Avidia Checking",,U,,12/16/2015,"bank  fee","Personal : BankFee","Personal","BankFee","",$0.34,$0.00,$4080.05
"Avidia Checking",,U,,12/16/2015,"bank  fee","Personal : BankFee","Personal","BankFee","",$0.35,$0.00,$4079.70
"Avidia Checking",,U,,12/16/2015,"London Museum of Natural History","Recreation : Vacation","Recreation","Vacation","",$7.61,$0.00,$4072.09
"Avidia Checking",,U,,12/16/2015,"London Vacation","Recreation : Vacation","Recreation","Vacation","",$26.32,$0.00,$4045.77
"Avidia Checking",,U,,12/16/2015,"London Museum of Natural History","Recreation : Vacation","Recreation","Vacation","",$27.38,$0.00,$4018.39
"Avidia Checking",,U,,12/16/2015,"London Museum of Natural History","Recreation : Vacation","Recreation","Vacation","",$34.23,$0.00,$3984.16
"Avidia Checking",,U,,12/16/2015,"Loves  Fresh Pasta","Recreation : Vacation","Recreation","Vacation","",$35.14,$0.00,$3949.02
"Avidia Checking",,U,,12/17/2015,"Pumpkin Brook","Income : Available next month","Income","Available next month","",$0.00,$44.91,$3993.93
"Avidia Checking",,U,,12/17/2015,"bank  fee","Personal : BankFee","Personal","BankFee","",$0.08,$0.00,$3993.85
"Avidia Checking",,U,,12/17/2015,"bank  fee","Personal : BankFee","Personal","BankFee","",$0.14,$0.00,$3993.71
"Avidia Checking",,U,,12/17/2015,"bank  fee","Personal : BankFee","Personal","BankFee","",$0.20,$0.00,$3993.51
"Avidia Checking",,U,,12/17/2015,"bank  fee","Personal : BankFee","Personal","BankFee","",$0.66,$0.00,$3992.85
"Avidia Checking",,U,,12/17/2015,"london zoo","Recreation : Vacation","Recreation","Vacation","",$7.92,$0.00,$3984.93
"Avidia Checking",,U,,12/17/2015,"Udderlicious","Recreation : Vacation","Recreation","Vacation","",$14.48,$0.00,$3970.45
"Avidia Checking",,U,,12/17/2015,"MW Eat LTD London","Recreation : Vacation","Recreation","Vacation","",$20.49,$0.00,$3949.96
"Avidia Checking",,U,,12/17/2015,"london zoo","Recreation : Vacation","Recreation","Vacation","",$65.90,$0.00,$3884.06
"Avidia Checking",,U,,12/17/2015,"Eversource","Housing : Gas","Hidden Categories","Housing ` Gas","",$126.17,$0.00,$3757.89
"Avidia Checking",,U,,12/18/2015,"bank  fee","Personal : BankFee","Personal","BankFee","",$0.18,$0.00,$3757.71
"Avidia Checking",,U,,12/18/2015,"bank  fee","Personal : BankFee","Personal","BankFee","",$0.23,$0.00,$3757.48
"Avidia Checking",,U,,12/18/2015,"bank  fee","Personal : BankFee","Personal","BankFee","",$0.68,$0.00,$3756.80
"Avidia Checking",,U,,12/18/2015,"bank  fee","Personal : BankFee","Personal","BankFee","",$0.72,$0.00,$3756.08
"Avidia Checking",,U,,12/18/2015,"bank  fee","Personal : BankFee","Personal","BankFee","",$1.50,$0.00,$3754.58
"Avidia Checking",,U,,12/18/2015,"Tesco","Recreation : Vacation","Recreation","Vacation","",$17.87,$0.00,$3736.71
"Avidia Checking",,U,,12/18/2015,"Pizza Express Olympia","Recreation : Vacation","Recreation","Vacation","",$22.53,$0.00,$3714.18
"Avidia Checking",,U,,12/18/2015,"London","Recreation : Vacation","Recreation","Vacation","",$68.34,$0.00,$3645.84
"Avidia Checking",,U,,12/18/2015,"Giraffe concepts","Recreation : Vacation","Recreation","Vacation","",$72.07,$0.00,$3573.77
"Avidia Checking",,U,,12/18/2015,"London Vacation","Recreation : Vacation","Recreation","Vacation","",$150.20,$0.00,$3423.57
"Avidia Checking",,U,,12/21/2015,"bank  fee","Personal : BankFee","Personal","BankFee","",$0.13,$0.00,$3423.44
"Avidia Checking",,U,,12/21/2015,"bank  fee","Personal : BankFee","Personal","BankFee","",$0.14,$0.00,$3423.30
"Avidia Checking",,U,,12/21/2015,"bank  fee","Personal : BankFee","Personal","BankFee","",$0.16,$0.00,$3423.14
"Avidia Checking",,U,,12/21/2015,"bank  fee","Personal : BankFee","Personal","BankFee","",$0.18,$0.00,$3422.96
"Avidia Checking",,U,,12/21/2015,"bank  fee","Personal : BankFee","Personal","BankFee","",$0.19,$0.00,$3422.77
"Avidia Checking",,U,,12/21/2015,"bank  fee","Personal : BankFee","Personal","BankFee","",$0.26,$0.00,$3422.51
"Avidia Checking",,U,,12/21/2015,"bank  fee","Personal : BankFee","Personal","BankFee","",$0.28,$0.00,$3422.23
"Avidia Checking",,U,,12/21/2015,"bank  fee","Personal : BankFee","Personal","BankFee","",$0.30,$0.00,$3421.93
"Avidia Checking",,U,,12/21/2015,"bank  fee","Personal : BankFee","Personal","BankFee","",$0.40,$0.00,$3421.53
"Avidia Checking",,U,,12/21/2015,"bank  fee","Personal : BankFee","Personal","BankFee","",$0.47,$0.00,$3421.06
"Avidia Checking",,U,,12/21/2015,"bank  fee","Personal : BankFee","Personal","BankFee","",$0.48,$0.00,$3420.58
"Avidia Checking",,U,,12/21/2015,"bank  fee","Personal : BankFee","Personal","BankFee","",$0.51,$0.00,$3420.07
"Avidia Checking",,U,,12/21/2015,"bank  fee","Personal : BankFee","Personal","BankFee","",$0.72,$0.00,$3419.35
"Avidia Checking",,U,,12/21/2015,"bank  fee","Personal : BankFee","Personal","BankFee","",$0.87,$0.00,$3418.48
"Avidia Checking",,U,,12/21/2015,"London","Recreation : Vacation","Recreation","Vacation","",$13.39,$0.00,$3405.09
"Avidia Checking",,U,,12/21/2015,"London","Recreation : Vacation","Recreation","Vacation","",$13.93,$0.00,$3391.16
"Avidia Checking",,U,,12/21/2015,"London","Recreation : Vacation","Recreation","Vacation","",$16.48,$0.00,$3374.68
"Avidia Checking",,U,,12/21/2015,"London","Recreation : Vacation","Recreation","Vacation","",$17.97,$0.00,$3356.71
"Avidia Checking",,U,,12/21/2015,"London","Recreation : Vacation","Recreation","Vacation","",$18.50,$0.00,$3338.21
"Avidia Checking",,U,,12/21/2015,"London","Recreation : Vacation","Recreation","Vacation","",$25.88,$0.00,$3312.33
"Avidia Checking",,U,,12/21/2015,"London","Recreation : Vacation","Recreation","Vacation","",$27.86,$0.00,$3284.47
"Avidia Checking",,U,,12/21/2015,"London","Recreation : Vacation","Recreation","Vacation","",$29.96,$0.00,$3254.51
"Avidia Checking",,U,,12/21/2015,"London","Recreation : Vacation","Recreation","Vacation","",$39.66,$0.00,$3214.85
"Avidia Checking",,U,,12/21/2015,"London","Recreation : Vacation","Recreation","Vacation","",$47.18,$0.00,$3167.67
"Avidia Checking",,U,,12/21/2015,"London","Recreation : Vacation","Recreation","Vacation","",$47.93,$0.00,$3119.74
"Avidia Checking",,U,,12/21/2015,"London","Recreation : Vacation","Recreation","Vacation","",$51.15,$0.00,$3068.59
"Avidia Checking",,U,,12/21/2015,"Jennifer Hudzier","Personal : Gifts","Personal","Gifts","Kim",$60.00,$0.00,$3008.59
"Avidia Checking",,U,,12/21/2015,"London","Recreation : Vacation","Recreation","Vacation","",$71.90,$0.00,$2936.69
"Avidia Checking",,U,,12/21/2015,"London","Recreation : Vacation","Recreation","Vacation","",$86.88,$0.00,$2849.81
"Avidia Checking",,U,,12/22/2015,"bank  fee","Personal : BankFee","Personal","BankFee","",$0.23,$0.00,$2849.58
"Avidia Checking",,U,,12/22/2015,"bank  fee","Personal : BankFee","Personal","BankFee","",$0.28,$0.00,$2849.30
"Avidia Checking",,U,,12/22/2015,"bank  fee","Personal : BankFee","Personal","BankFee","",$0.41,$0.00,$2848.89
"Avidia Checking",,U,,12/22/2015,"bank  fee","Personal : BankFee","Personal","BankFee","",$0.46,$0.00,$2848.43
"Avidia Checking",,U,,12/22/2015,"bank  fee","Personal : BankFee","Personal","BankFee","",$0.74,$0.00,$2847.69
"Avidia Checking",,U,,12/22/2015,"London","Recreation : Vacation","Recreation","Vacation","",$22.88,$0.00,$2824.81
"Avidia Checking",,U,,12/22/2015,"London","Recreation : Vacation","Recreation","Vacation","",$27.66,$0.00,$2797.15
"Avidia Checking",,U,,12/22/2015,"London","Recreation : Vacation","Recreation","Vacation","",$41.09,$0.00,$2756.06
"Avidia Checking",,U,,12/22/2015,"London","Recreation : Vacation","Recreation","Vacation","",$45.62,$0.00,$2710.44
"Avidia Checking",,U,,12/22/2015,"London","Recreation : Vacation","Recreation","Vacation","",$73.94,$0.00,$2636.50
"Avidia Checking",,U,,12/23/2015,"bank  fee","Personal : BankFee","Personal","BankFee","",$0.52,$0.00,$2635.98
"Avidia Checking",,U,,12/23/2015,"dunkin donuts","Food : Restaurants","Food","Restaurants","",$5.01,$0.00,$2630.97
"Avidia Checking",,U,,12/23/2015,"London","Recreation : Vacation","Recreation","Vacation","",$51.76,$0.00,$2579.21
"Avidia Checking",,U,4233,12/24/2015,"Isabel Nanez","Personal : Gifts","Personal","Gifts","",$50.00,$0.00,$2529.21
"Avidia Checking",,U,,12/28/2015,"Chinese Kitchen","Food : Restaurants","Food","Restaurants","",$40.45,$0.00,$2488.76
"Avidia Checking",,U,,01/04/2016,"Save the children","Charity : Other","Charity","Other","",$28.00,$0.00,$2460.76
"Avidia Checking",,U,,01/04/2016,"tomten","Personal : Miscellaneous","Personal","Miscellaneous","",$30.00,$0.00,$2430.76
"Avidia Checking",,U,,01/04/2016,"verizon wireless","Housing : Cell Phones","Hidden Categories","Housing ` Cell Phones",,$183.32,$0.00,$2247.44
"Avidia Checking",,U,,01/05/2016,"NGRID","Housing : Electricity","Hidden Categories","Housing ` Electricity","",$99.99,$0.00,$2147.45
"Avidia Checking",,U,,01/05/2016,"verizon fios","Housing : Phone & Internet","Hidden Categories","Housing ` Phone & Internet","",$106.52,$0.00,$2040.93
"Avidia Checking",,U,,01/05/2016,"Safety Insurance","Housing : House/Rental Insurance","Hidden Categories","Housing ` House/Rental Insurance","(Split 1/2) ",$182.59,$0.00,$1658.34
"Avidia Checking",,U,,01/05/2016,"Safety Insurance","Transportation : Car Insurance","Transportation","Car Insurance","(Split 2/2) ",$200.00,$0.00,$1658.34
"Avidia Checking",,U,,01/08/2016,"interest","Income : Available next month","Income","Available next month","",$0.00,$0.13,$1658.47
"Avidia Checking",,U,,01/08/2016,"bank  fee","Personal : BankFee","Personal","BankFee","",$1.00,$0.00,$1657.47
"Avidia Checking",,U,,01/11/2016,"Deposit","Income : Available this month","Income","Available this month","",$0.00,$150.00,$1807.47
"Avidia Checking",,U,,01/11/2016,"Milforrd something","Personal : Miscellaneous","Personal","Miscellaneous","",$13.95,$0.00,$1793.52
"Avidia Checking",,U,,01/11/2016,"Clean & Green Car Wash","Personal : Gifts","Personal","Gifts","",$50.00,$0.00,$1743.52
"Avidia Checking",,U,,01/11/2016,"Yama Zakura","Personal : Gifts","Personal","Gifts","",$50.00,$0.00,$1693.52
"Avidia Checking",,U,4236,01/11/2016,"serafine","Personal : Gifts","Personal","Gifts","",$50.00,$0.00,$1643.52
"Avidia Checking",,U,,01/11/2016,"Transfer : Target",,,,"",$225.16,$0.00,$1418.36
"Avidia Checking",,U,4234,01/12/2016,"Metrowest medical center","Personal : Doctor, Dentist","Personal","Doctor, Dentist","",$10.49,$0.00,$1407.87
"Avidia Checking",,U,4239,01/14/2016,"Marlboro Hospital","Personal : Doctor, Dentist","Personal","Doctor, Dentist","",$401.00,$0.00,$1006.87
"Avidia Checking",,U,,01/15/2016,"bank credit","Income : Available next month","Income","Available next month","",$0.00,$1.00,$1007.87
"Avidia Checking",,U,,01/19/2016,"University of Arts London","Education : College","Education","College","",$0.00,$284.69,$1292.56
"Avidia Checking",,U,,01/19/2016,"Credit card charge foriegn payment","Lisa Business : Education","Lisa Business","Education","",$0.00,$2.85,$1295.41
"Avidia Checking",,U,,01/19/2016,"Eversource","Housing : Gas","Hidden Categories","Housing ` Gas","",$161.31,$0.00,$1134.10
"Avidia Checking",,U,,01/20/2016,"Transfer : Avidia-AlyssaAccount",,,,"",$0.00,$1000.00,$2134.10
"Avidia Checking",,U,,01/20/2016,"Transfer : avidia - Lisa Business",,,,"",$0.00,$500.00,$2634.10
"Avidia Checking",,U,,01/22/2016,"Ecology Project","Recreation : Vacation","Recreation","Vacation","Alyssa Galapcos",$257.50,$0.00,$2376.60
"Avidia Checking",,U,,01/22/2016,"Ecology Project","Recreation : Vacation","Recreation","Vacation","Alyssa galapacos",$772.50,$0.00,$1604.10
"Avidia Checking",,U,,01/25/2016,"Fastlane","Transportation : tolls","Transportation","tolls","",$10.15,$0.00,$1593.95
"Avidia Checking",,U,4235,01/26/2016,"Special Olympics","Charity : Other","Charity","Other","",$15.00,$0.00,$1578.95
"Avidia Checking",,U,4242,01/28/2016,"Uconn","Education : College","Education","College","Riding",$420.00,$0.00,$1158.95
"Avidia Checking",,U,4238,01/29/2016,"Joshua Mattei-Lownes","Personal : Gifts","Personal","Gifts","",$50.00,$0.00,$1108.95
"Avidia Checking",,U,,02/01/2016,"Transfer : Avidia-AlyssaAccount",,,,"",$0.00,$1000.00,$2108.95
"Avidia Checking",,U,,02/01/2016,"Save the children","Charity : Other","Charity","Other","",$28.00,$0.00,$2080.95
"Avidia Checking",,U,,02/01/2016,"Cash for vacation","Recreation : Vacation","Recreation","Vacation","",$50.00,$0.00,$2030.95
"Avidia Checking",,U,,02/01/2016,"Walmart","Food : Groceries","Food","Groceries","",$60.66,$0.00,$1970.29
"Avidia Checking",,U,4244,02/03/2016,"Metrowest radiology","Personal : Doctor, Dentist","Personal","Doctor, Dentist","",$168.50,$0.00,$1801.79
"Avidia Checking",,U,,02/03/2016,"verizon wireless","Housing : Cell Phones","Hidden Categories","Housing ` Cell Phones","",$181.44,$0.00,$1620.35
"Avidia Checking",,U,4243,02/04/2016,"reliant medicat","Personal : Doctor, Dentist","Personal","Doctor, Dentist","",$25.00,$0.00,$1595.35
"Avidia Checking",,U,,02/04/2016,"verizon fios","Housing : Phone & Internet","Hidden Categories","Housing ` Phone & Internet",,$103.76,$0.00,$1491.59
"Avidia Checking",,U,,02/08/2016,"interest","Income : Available next month","Income","Available next month","",$0.00,$0.06,$1491.65
"Avidia Checking",,U,,02/09/2016,"bank  fee","Personal : BankFee","Personal","BankFee","",$3.00,$0.00,$1488.65
"Avidia Checking",,U,,02/09/2016,"NGRID","Housing : Electricity","Hidden Categories","Housing ` Electricity","",$95.51,$0.00,$1393.14
"Avidia Checking",,U,,02/09/2016,"Cash for vacation","Recreation : Vacation","Recreation","Vacation","",$100.00,$0.00,$1293.14
"Avidia Checking",,U,,02/10/2016,"Transfer : Target",,,,"",$342.57,$0.00,$950.57
"Avidia Checking",,U,,02/11/2016,"Corral RV Park","Recreation : Vacation","Recreation","Vacation","RV TRIP",$10.00,$0.00,$940.57
"Avidia Checking",,U,,02/16/2016,"Transfer : Robert Cash Account",,,,"",$100.00,$0.00,$840.57
"Avidia Checking",,U,,02/17/2016,"Eversource","Housing : Gas","Hidden Categories","Housing ` Gas","",$217.67,$0.00,$622.90
"Avidia Checking",,U,,02/19/2016,"Deposit","Income : Available this month","Income","Available this month","",$0.00,$1200.00,$1822.90
"Avidia Checking",,U,,02/19/2016,"Fastlane","Transportation : tolls","Transportation","tolls","",$10.00,$0.00,$1812.90
"Avidia Checking",,U,,02/19/2016,"city of marlboro","Housing : Water","Hidden Categories","Housing ` Water","",$195.22,$0.00,$1617.68
"Avidia Checking",,U,4245,02/22/2016,"Sudbury Valley trustees","Charity : Other","Charity","Other","",$50.00,$0.00,$1567.68
"Avidia Checking",,U,4240,02/26/2016,"WesternTeam","Education : College","Education","College","Riding",$130.00,$0.00,$1437.68
"Avidia Checking",,U,,02/29/2016,"uconn one card","Education : College","Education","College","One Card",$42.00,$0.00,$1395.68
"Avidia Checking",,U,,02/29/2016,"Mexicana Grocery","Food : Restaurants","Food","Restaurants","",$46.50,$0.00,$1349.18
"Avidia Checking",,U,,03/01/2016,"Save the children","Charity : Other","Charity","Other","",$28.00,$0.00,$1321.18
"Avidia Checking",,U,4246,03/03/2016,"Dr Cheryl Hardenbook","Personal : Doctor, Dentist","Personal","Doctor, Dentist","",$50.00,$0.00,$1271.18
"Avidia Checking",,U,,03/03/2016,"verizon wireless","Housing : Cell Phones","Hidden Categories","Housing ` Cell Phones","",$227.22,$0.00,$1043.96
"Avidia Checking",,U,,03/07/2016,"verizon fios","Housing : Phone & Internet","Hidden Categories","Housing ` Phone & Internet",,$103.33,$0.00,$940.63
"Avidia Checking",,U,,03/08/2016,"interest","Income : Available next month","Income","Available next month","",$0.00,$0.04,$940.67
"Avidia Checking",,U,,03/09/2016,"Transfer : Avidia-AlyssaAccount",,,,"",$0.00,$1000.00,$1940.67
"Avidia Checking",,U,,03/09/2016,"bank  fee","Personal : BankFee","Personal","BankFee","",$2.50,$0.00,$1938.17
"Avidia Checking",,U,,03/09/2016,"bank  fee","Personal : BankFee","Personal","BankFee","",$4.00,$0.00,$1934.17
"Avidia Checking",,U,,03/09/2016,"Ma excise","Transportation : Auto Excise","Transportation","Auto Excise","",$37.50,$0.00,$1896.67
"Avidia Checking",,U,,03/09/2016,"Ma excise","Transportation : Auto Excise","Transportation","Auto Excise","",$48.75,$0.00,$1847.92
"Avidia Checking",,U,,03/09/2016,"NGRID","Housing : Electricity","Hidden Categories","Housing ` Electricity","",$70.53,$0.00,$1777.39
"Avidia Checking",,U,,03/09/2016,"Ma excise","Transportation : Auto Excise","Transportation","Auto Excise","",$172.50,$0.00,$1604.89
"Avidia Checking",,U,,03/09/2016,"Cash for vacation","Recreation : Vacation","Recreation","Vacation","",$200.00,$0.00,$1404.89
"Avidia Checking",,U,,03/10/2016,"Transfer : Target",,,,"",$400.70,$0.00,$1004.19
"Avidia Checking",,U,,03/14/2016,"Marathon","Recreation : Vacation","Recreation","Vacation","RV GAS",$54.13,$0.00,$950.06
"Avidia Checking",,U,,03/14/2016,"Cash for vacation","Recreation : Vacation","Recreation","Vacation","",$80.00,$0.00,$870.06
"Avidia Checking",,U,,03/15/2016,"Transfer : Avidia-AlyssaAccount",,,,"",$0.00,$2500.00,$3370.06
"Avidia Checking",,U,,03/15/2016,"Madam tussauds","Recreation : Vacation","Recreation","Vacation","",$53.26,$0.00,$3316.80
"Avidia Checking",,U,,03/17/2016,"Eversource","Housing : Gas","Hidden Categories","Housing ` Gas","",$192.87,$0.00,$3123.93
"Avidia Checking",,U,,03/25/2016,"bank  fee","Personal : BankFee","Personal","BankFee","",$4.00,$0.00,$3119.93
"Avidia Checking",,U,,03/28/2016,"uconn one card","Education : College","Education","College","",$52.00,$0.00,$3067.93
"Avidia Checking",,U,,03/28/2016,"serve","Recreation : Vacation","Recreation","Vacation","",$80.00,$0.00,$2987.93
"Avidia Checking",,U,,04/01/2016,"Save the children","Charity : Other","Charity","Other","",$28.00,$0.00,$2959.93
"Avidia Checking",,U,,04/01/2016,"verizon wireless","Housing : Cell Phones","Hidden Categories","Housing ` Cell Phones","",$202.01,$0.00,$2757.92
"Avidia Checking",,U,,04/05/2016,"verizon fios","Housing : Phone & Internet","Hidden Categories","Housing ` Phone & Internet","",$104.37,$0.00,$2653.55
"Avidia Checking",,U,,04/06/2016,"Transfer : Avidia-AlyssaAccount",,,,"",$0.00,$1000.00,$3653.55
"Avidia Checking",,U,,04/07/2016,"Transfer : Dcu Checking",,,,"",$0.00,$2000.00,$5653.55
"Avidia Checking",,U,,04/07/2016,"Deposit","Income : Available this month","Income","Available this month","",$0.00,$100.00,$5753.55
"Avidia Checking",,U,,04/08/2016,"interest","Income : Available next month","Income","Available next month","",$0.00,$0.12,$5753.67
"Avidia Checking",,U,,04/08/2016,"NGRID","Housing : Electricity","Hidden Categories","Housing ` Electricity","",$64.29,$0.00,$5689.38
"Avidia Checking",,U,,04/11/2016,"Randomwalk","Lisa Business : Misc","Lisa Business","Misc","Retirement software",$10.00,$0.00,$5679.38
"Avidia Checking",,U,4247,04/11/2016,"Greg Martel","Housing : Maintenance & Repairs","Hidden Categories","Housing ` Maintenance & Repairs","Fix heat",$250.00,$0.00,$5429.38
"Avidia Checking",,U,,04/11/2016,"Transfer : Target",,,,"",$260.41,$0.00,$5168.97
"Avidia Checking",,U,,04/12/2016,"Tax refund MASSACHUSETTS","Income : Available this month","Income","Available this month","",$0.00,$708.00,$5876.97
"Avidia Checking",,U,,04/13/2016,"IRS  tax refund","Income : Available next month","Income","Available next month","",$0.00,$3766.00,$9642.97
"Avidia Checking",,U,,04/14/2016,"Transfer : avidia - Lisa Business",,,,"",$500.00,$0.00,$9142.97
"Avidia Checking",,U,,04/15/2016,"Eversource","Housing : Gas","Hidden Categories","Housing ` Gas","",$135.73,$0.00,$9007.24
"Avidia Checking",,U,,04/19/2016,"Pizza plus","Food : Restaurants","Food","Restaurants","",$18.19,$0.00,$8989.05
"Avidia Checking",,U,,04/21/2016,"Pumpkin Brook","Income : Available next month","Income","Available next month","",$0.00,$131.77,$9120.82
"Avidia Checking",,U,4250,04/21/2016,"SMG","Personal : Doctor, Dentist","Personal","Doctor, Dentist","",$25.00,$0.00,$9095.82
"Avidia Checking",,U,,04/25/2016,"Uconn","Education : College","Education","College","",$102.00,$0.00,$8993.82
"Avidia Checking",,U,,04/25/2016,"Transfer : avidia - Lisa Business",,,,"",$1500.00,$0.00,$7493.82
"Avidia Checking",,U,,04/26/2016,"Deposit","Income : Available this month","Income","Available this month","",$0.00,$380.00,$7873.82
"Avidia Checking",,U,,05/02/2016,"Save the children","Charity : Other","Charity","Other",,$28.00,$0.00,$7845.82
"Avidia Checking",,U,,05/03/2016,"Uconn","Education : College","Education","College","",$14.98,$0.00,$7830.84
"Avidia Checking",,U,,05/03/2016,"city of marlboro","Housing : Real Estate Tax","Hidden Categories","Housing ` Real Estate Tax","",$1225.09,$0.00,$6605.75
"Avidia Checking",,U,4249,05/03/2016,"Ecology Project","Recreation : Alyssa","Recreation","Alyssa","",$4545.00,$0.00,$2060.75
"Avidia Checking",,U,,05/04/2016,"verizon wireless","Housing : Cell Phones","Hidden Categories","Housing ` Cell Phones","",$204.87,$0.00,$1855.88
"Avidia Checking",,U,,05/05/2016,"Deposit","Income : Available this month","Income","Available this month","",$0.00,$272.92,$2128.80
"Avidia Checking",,U,,05/06/2016,"verizon fios","Housing : Phone & Internet","Hidden Categories","Housing ` Phone & Internet","",$104.31,$0.00,$2024.49
"Avidia Checking",,U,,05/08/2016,"interest","Income : Available next month","Income","Available next month","",$0.00,$0.28,$2024.77
"Avidia Checking",,U,,05/09/2016,"NGRID","Housing : Electricity","Hidden Categories","Housing ` Electricity","",$63.03,$0.00,$1961.74
"Avidia Checking",,U,,05/09/2016,"Transfer : Target",,,,"",$99.72,$0.00,$1862.02
"Avidia Checking",,U,4224,05/09/2016,"Kelly Matteri","Personal : Gifts","Personal","Gifts","",$100.00,$0.00,$1762.02
"Avidia Checking",,U,,05/12/2016,"Fastlane","Transportation : tolls","Transportation","tolls","",$10.00,$0.00,$1752.02
"Avidia Checking",,U,,05/17/2016,"Eversource","Housing : Gas","Hidden Categories","Housing ` Gas","",$113.68,$0.00,$1638.34
"Avidia Checking",,U,,05/19/2016,"Pumpkin Brook","Income : Available next month","Income","Available next month","",$0.00,$244.70,$1883.04
"Avidia Checking",,U,,05/19/2016,"Transfer : Lisa Cash Account",,,,"",$50.00,$0.00,$1833.04
"Avidia Checking",,U,,05/26/2016,"Fastlane","Transportation : tolls","Transportation","tolls","",$10.30,$0.00,$1822.74
"Avidia Checking",,U,,05/26/2016,"Marlboro","Housing : Water","Hidden Categories","Housing ` Water","",$154.00,$0.00,$1668.74
"Avidia Checking",,U,,06/01/2016,"Save the children","Charity : Other","Charity","Other","",$28.00,$0.00,$1640.74
"Avidia Checking",,U,,06/02/2016,"Pumpkin Brook","Income : Available next month","Income","Available next month","",$0.00,$240.00,$1880.74
"Avidia Checking",,U,,06/02/2016,"verizon wireless","Housing : Cell Phones","Hidden Categories","Housing ` Cell Phones",,$172.68,$0.00,$1708.06
"Avidia Checking",,U,,06/06/2016,"Magnolia cafe","Food : Restaurants","Food","Restaurants","",$14.18,$0.00,$1693.88
"Avidia Checking",,U,,06/06/2016,"Transfer : Lisa Cash Account",,,,"",$100.00,$0.00,$1593.88
"Avidia Checking",,U,,06/06/2016,"verizon fios","Housing : Phone & Internet","Hidden Categories","Housing ` Phone & Internet","",$104.31,$0.00,$1489.57
"Avidia Checking",,U,,06/08/2016,"interest","Income : Available next month","Income","Available next month","",$0.00,$0.07,$1489.64
"Avidia Checking",,U,,06/08/2016,"NGRID","Housing : Electricity","Hidden Categories","Housing ` Electricity","",$63.85,$0.00,$1425.79
"Avidia Checking",,U,,06/10/2016,"Transfer : Target",,,,"",$177.97,$0.00,$1247.82
"Avidia Checking",,U,,06/13/2016,"Hoyt Solomon pond mall","Recreation : Entertainment","Recreation","Entertainment","",$13.14,$0.00,$1234.68
"Avidia Checking",,U,,06/13/2016,"Hoyt Solomon pond mall","Recreation : Entertainment","Recreation","Entertainment",,$25.20,$0.00,$1209.48
"Avidia Checking",,U,,06/13/2016,"Lowe's of Hudson","Housing : Garden","Hidden Categories","Housing ` Garden","",$39.94,$0.00,$1169.54
"Avidia Checking",,U,,06/13/2016,"silk road bistro","Food : Restaurants","Food","Restaurants","",$58.60,$0.00,$1110.94
"Avidia Checking",,U,,06/13/2016,"A1 auto","Transportation : Repairs & Maintenance","Transportation","Repairs & Maintenance","",$250.68,$0.00,$860.26
"Avidia Checking",,U,,06/14/2016,"Transfer : avidia - Lisa Business",,,,"",$0.00,$2000.00,$2860.26
"Avidia Checking",,U,,06/15/2016,"USPS","Housing : Supplies","Hidden Categories","Housing ` Supplies","",$10.90,$0.00,$2849.36
"Avidia Checking",,U,,06/15/2016,"gasoline","Transportation : Gas","Transportation","Gas","",$19.15,$0.00,$2830.21
"Avidia Checking",,U,,06/16/2016,"Pumpkin Brook","Income : Available next month","Income","Available next month","",$0.00,$268.22,$3098.43
"Avidia Checking",,U,,06/16/2016,"Honey Dew","Food : Restaurants","Food","Restaurants","",$5.55,$0.00,$3092.88
"Avidia Checking",,U,,06/16/2016,"Eversource","Housing : Gas","Hidden Categories","Housing ` Gas","",$47.80,$0.00,$3045.08
"Avidia Checking",,U,4248,06/16/2016,"Carol and ken oats","Housing : Maintenance & Repairs","Hidden Categories","Housing ` Maintenance & Repairs","",$300.00,$0.00,$2745.08
"Avidia Checking",,U,,06/17/2016,"Papa johns","Food : Restaurants","Food","Restaurants","",$30.72,$0.00,$2714.36
"Avidia Checking",,U,,06/20/2016,"Burger King","Food : Restaurants","Food","Restaurants","",$2.66,$0.00,$2711.70
"Avidia Checking",,U,,06/30/2016,"Pumpkin Brook","Income : Available next month","Income","Available next month","",$0.00,$258.81,$2970.51
"Avidia Checking",,U,,07/01/2016,"Save the children","Charity : Other","Charity","Other","",$28.00,$0.00,$2942.51
"Avidia Checking",,U,,07/05/2016,"Transfer : Lisa Cash Account",,,,"",$50.00,$0.00,$2892.51
"Avidia Checking",,U,,07/05/2016,"verizon wireless","Housing : Cell Phones","Hidden Categories","Housing ` Cell Phones","",$172.68,$0.00,$2719.83
"Avidia Checking",,U,,07/06/2016,"verizon fios","Housing : Phone & Internet","Hidden Categories","Housing ` Phone & Internet",,$104.31,$0.00,$2615.52
"Avidia Checking",,U,,07/08/2016,"interest","Income : Available next month","Income","Available next month","",$0.00,$0.11,$2615.63
"Avidia Checking",,U,,07/11/2016,"Pumpkin Brook","Income : Available next month","Income","Available next month","",$0.00,$254.11,$2869.74
"Avidia Checking",,U,,07/11/2016,"NGRID","Housing : Electricity","Hidden Categories","Housing ` Electricity","",$102.24,$0.00,$2767.50
"Avidia Checking",,U,,07/11/2016,"Transfer : Target",,,,"",$332.07,$0.00,$2435.43
"Avidia Checking",,U,,07/18/2016,"Eversource","Housing : Gas","Hidden Categories","Housing ` Gas","",$34.70,$0.00,$2400.73
"Avidia Checking",,U,,07/18/2016,"Transfer : Lisa Cash Account",,,,"",$90.00,$0.00,$2310.73
"Avidia Checking",,U,,07/28/2016,"Pumpkin Brook","Income : Available next month","Income","Available next month","",$0.00,$270.41,$2581.14
"Avidia Checking",,U,,08/01/2016,"Transfer : avidia - Lisa Business",,,,"",$0.00,$3000.00,$5581.14
"Avidia Checking",,U,,08/01/2016,"Save the children","Charity : Other","Charity","Other",,$28.00,$0.00,$5553.14
"Avidia Checking",,U,,08/02/2016,"Massport Logan","Transportation : Parking","Transportation","Parking","",$12.00,$0.00,$5541.14
"Avidia Checking",,U,,08/03/2016,"verizon wireless","Housing : Cell Phones","Hidden Categories","Housing ` Cell Phones",,$183.17,$0.00,$5357.97
"Avidia Checking",,U,,08/05/2016,"ATM charge","Personal : BankFee","Personal","BankFee","",$2.50,$0.00,$5355.47
"Avidia Checking",,U,,08/05/2016,"ATM charge","Personal : BankFee","Personal","BankFee","",$2.50,$0.00,$5352.97
"Avidia Checking",,U,,08/05/2016,"Nicky DS Donuts","Food : Restaurants","Food","Restaurants","",$8.35,$0.00,$5344.62
"Avidia Checking",,U,,08/05/2016,"Transfer : Lisa Cash Account",,,,"",$100.00,$0.00,$5244.62
"Avidia Checking",,U,,08/05/2016,"verizon fios","Housing : Phone & Internet","Hidden Categories","Housing ` Phone & Internet","",$104.06,$0.00,$5140.56
"Avidia Checking",,U,,08/08/2016,"interest","Income : Available next month","Income","Available next month","",$0.00,$0.13,$5140.69
"Avidia Checking",,U,,08/08/2016,"Count  Orlk's Nigh","Recreation : Alyssa","Recreation","Alyssa","",$32.00,$0.00,$5108.69
"Avidia Checking",,U,,08/08/2016,"Museum of Natural History","Recreation : Alyssa","Recreation","Alyssa","",$66.00,$0.00,$5042.69
"Avidia Checking",,U,,08/09/2016,"NGRID","Housing : Electricity","Hidden Categories","Housing ` Electricity","",$116.12,$0.00,$4926.57
"Avidia Checking",,U,,08/10/2016,"Transfer : Target",,,,"",$276.22,$0.00,$4650.35
"Avidia Checking",,U,,08/11/2016,"Pumpkin Brook","Income : Available next month","Income","Available next month","",$0.00,$258.69,$4909.04
"Avidia Checking",,U,,08/12/2016,"Transfer : Lisa Cash Account",,,,"",$100.00,$0.00,$4809.04
"Avidia Checking",,U,,08/13/2016,"Fastlane","Transportation : tolls","Transportation","tolls","",$13.15,$0.00,$4795.89
"Avidia Checking",,U,,08/16/2016,"Eversource","Housing : Gas","Hidden Categories","Housing ` Gas","",$34.26,$0.00,$4761.63
"Avidia Checking",,U,,08/22/2016,"Ferjulians","Food : Groceries","Food","Groceries","",$18.28,$0.00,$4743.35
"Avidia Checking",,U,,08/22/2016,"Alice's DIner","Food : Restaurants","Food","Restaurants","",$32.74,$0.00,$4710.61
"Avidia Checking",,U,,08/22/2016,"Narranga nset north kin","Recreation : Alyssa","Recreation","Alyssa","POLO",$37.50,$0.00,$4673.11
"Avidia Checking",,U,,08/25/2016,"Pumpkin Brook","Income : Available next month","Income","Available next month","",$0.00,$207.05,$4880.16
"Avidia Checking",,U,,08/29/2016,"paypal","Income : Available next month","Income","Available next month","",$0.00,$99.71,$4979.87
"Avidia Checking",,U,,08/30/2016,"uconn icecream","Food : Restaurants","Food","Restaurants","",$9.84,$0.00,$4970.03
"Avidia Checking",,U,,08/30/2016,"city of marlboro","Housing : Water","Hidden Categories","Housing ` Water","",$294.00,$0.00,$4676.03
"Avidia Checking",,U,,09/01/2016,"Save the children","Charity : Other","Charity","Other","",$28.00,$0.00,$4648.03
"Avidia Checking",,U,,09/01/2016,"verizon wireless","Housing : Cell Phones","Hidden Categories","Housing ` Cell Phones","",$182.16,$0.00,$4465.87
"Avidia Checking",,U,,09/06/2016,"Transfer : Lisa Cash Account",,,,"",$50.00,$0.00,$4415.87
"Avidia Checking",,U,,09/06/2016,"verizon fios","Housing : Phone & Internet","Hidden Categories","Housing ` Phone & Internet","",$104.13,$0.00,$4311.74
"Avidia Checking",,U,,09/08/2016,"Pumpkin Brook","Income : Available next month","Income","Available next month","",$0.00,$263.51,$4575.25
"Avidia Checking",,U,,09/08/2016,"interest","Income : Available next month","Income","Available next month","",$0.00,$0.20,$4575.45
"Avidia Checking",,U,,09/08/2016,"NGRID","Housing : Electricity","Hidden Categories","Housing ` Electricity","",$153.95,$0.00,$4421.50
"Avidia Checking",,U,,09/12/2016,"Transfer : Target",,,,"",$201.87,$0.00,$4219.63
"Avidia Checking",,U,,09/16/2016,"Uconn","Food : Restaurants","Food","Restaurants","",$11.26,$0.00,$4208.37
"Avidia Checking",,U,,09/16/2016,"Eversource","Housing : Gas","Hidden Categories","Housing ` Gas",,$35.23,$0.00,$4173.14
"Avidia Checking",,U,,09/22/2016,"Pumpkin Brook","Income : Available next month","Income","Available next month","",$0.00,$240.00,$4413.14
"Avidia Checking",,U,,10/03/2016,"Save the children","Charity : Other","Charity","Other","",$28.00,$0.00,$4385.14
"Avidia Checking",,U,,10/04/2016,"TicketLeapTickets","Recreation : Entertainment","Recreation","Entertainment","Puppet show tickets",$30.30,$0.00,$4354.84
"Avidia Checking",,U,,10/04/2016,"verizon wireless","Housing : Cell Phones","Hidden Categories","Housing ` Cell Phones","",$182.16,$0.00,$4172.68
"Avidia Checking",,U,,10/05/2016,"NGRID","Housing : Electricity","Hidden Categories","Housing ` Electricity","",$124.07,$0.00,$4048.61
"Avidia Checking",,U,,10/06/2016,"verizon fios","Housing : Phone & Internet","Hidden Categories","Housing ` Phone & Internet","",$104.13,$0.00,$3944.48
"Avidia Checking",,U,,10/08/2016,"interest","Income : Available next month","Income","Available next month","",$0.00,$0.17,$3944.65
"Avidia Checking",,U,,10/11/2016,"Transfer : Target",,,,"",$278.85,$0.00,$3665.80
"Avidia Checking",,U,,10/14/2016,"Eversource","Housing : Gas","Hidden Categories","Housing ` Gas","",$38.80,$0.00,$3627.00
"Avidia Checking",,U,,11/07/2016,"Save the children","Charity : Other","Charity","Other",,$28.00,$0.00,$3599.00
"Avidia Checking",,U,,11/07/2016,"verizon fios","Housing : Phone & Internet","Hidden Categories","Housing ` Phone & Internet",,$106.82,$0.00,$3492.18
"Avidia Checking",,U,,11/08/2016,"interest","Income : Available next month","Income","Available next month","",$0.00,$0.16,$3492.34
"Avidia Checking",,U,,11/08/2016,"bank  fee","Personal : BankFee","Personal","BankFee","",$1.00,$0.00,$3491.34
"Avidia Checking",,U,,11/10/2016,"Transfer : Target","Food : Groceries","Food","Groceries","",$292.59,$0.00,$3198.75
"Avidia Checking",,U,,11/17/2016,"Eversource","Housing : Gas","Hidden Categories","Housing ` Gas","",$78.88,$0.00,$3119.87
"Avidia Checking",,U,,11/21/2016,"Transfer : Lisa Cash Account",,,,"",$500.00,$0.00,$2619.87
"Avidia Checking",,U,,11/29/2016,"Transfer : Lisa Cash Account",,,,"",$50.00,$0.00,$2569.87
"Avidia Checking",,U,,12/06/2016,"verizon fios","Housing : Phone & Internet","Hidden Categories","Housing ` Phone & Internet",,$106.82,$0.00,$2463.05
"Avidia Checking",,U,,12/06/2016,"Transfer : Lisa Cash Account",,,,"",$2463.05,$0.00,$0.00
"avidia - Lisa Business",,C,,06/07/2013,"Starting Balance","Income : Available this month","Income","Available this month","",$0.00,$2139.72,$2139.72
"avidia - Lisa Business",,U,,06/10/2013,"Pumpkin Brook","Lisa Business : Services paid for","Lisa Business","Services paid for","soil amendment",$35.84,$0.00,$2103.88
"avidia - Lisa Business",,U,,06/17/2013,"Cavichio","Lisa Business : Cost of Goods Sold","Lisa Business","Cost of Goods Sold","",$138.13,$0.00,$1965.75
"avidia - Lisa Business",,U,,06/20/2013,"Garden Center Wayland","Lisa Business : Business expenses","Lisa Business","Business expenses","",$12.43,$0.00,$1953.32
"avidia - Lisa Business",,U,,06/21/2013,"Home Depot","Lisa Business : Business expenses","Lisa Business","Business expenses","",$29.40,$0.00,$1923.92
"avidia - Lisa Business",,U,,06/24/2013,,"Income : Available next month","Income","Available next month","",$0.00,$1669.50,$3593.42
"avidia - Lisa Business",,U,,06/27/2013,"Officemax","Lisa Business : Office supplies","Lisa Business","Office supplies","",$6.68,$0.00,$3586.74
"avidia - Lisa Business",,U,,06/27/2013,"Home Depot","Lisa Business : Business expenses","Lisa Business","Business expenses","",$21.23,$0.00,$3565.51
"avidia - Lisa Business",,U,,07/01/2013,"CTS Store Hyannis ma","Lisa Business : Business expenses","Lisa Business","Business expenses","",$14.75,$0.00,$3550.76
"avidia - Lisa Business",,U,,07/05/2013,"Godaddy","Lisa Business : Advertizing","Lisa Business","Advertizing","",$13.17,$0.00,$3537.59
"avidia - Lisa Business",,U,,07/05/2013,"Amazon","Lisa Business : Business expenses","Lisa Business","Business expenses","",$21.48,$0.00,$3516.11
"avidia - Lisa Business",,U,,07/05/2013,"Grow Native","Lisa Business : Fees","Lisa Business","Fees","",$25.00,$0.00,$3491.11
"avidia - Lisa Business",,U,,07/05/2013,"New England Wildflower Society","Lisa Business : Business expenses","Lisa Business","Business expenses","",$40.00,$0.00,$3451.11
"avidia - Lisa Business",,U,,07/15/2013,"Deposit","Income : Available next month","Income","Available next month","",$0.00,$570.00,$4021.11
"avidia - Lisa Business",,U,,07/17/2013,"Ocean State Joblot","Lisa Business : Supplies","Lisa Business","Supplies","",$19.14,$0.00,$4001.97
"avidia - Lisa Business",,U,,07/18/2013,"United States treasury","Income Tax : Estimated","Hidden Categories","Income Tax ` Estimated","1018",$1800.00,$0.00,$2201.97
"avidia - Lisa Business",,U,,07/22/2013,"Home Depot","Lisa Business : Supplies","Lisa Business","Supplies","",$13.41,$0.00,$2188.56
"avidia - Lisa Business",,U,,07/22/2013,"Trombetta","Lisa Business : Supplies","Lisa Business","Supplies","",$13.80,$0.00,$2174.76
"avidia - Lisa Business",,U,,07/22/2013,"Common Wealth Ma","Income Tax : Estimated","Hidden Categories","Income Tax ` Estimated","1019",$450.00,$0.00,$1724.76
"avidia - Lisa Business",,U,,07/25/2013,"Deposit","Income : Available next month","Income","Available next month","",$0.00,$1424.00,$3148.76
"avidia - Lisa Business",,U,,07/25/2013,"city of marlboro","Lisa Business : Business expenses","Lisa Business","Business expenses","",$50.00,$0.00,$3098.76
"avidia - Lisa Business",,U,,07/30/2013,"lowes","Lisa Business : Supplies","Lisa Business","Supplies","",$18.07,$0.00,$3080.69
"avidia - Lisa Business",,U,,08/09/2013,"Deposit","Income : Available next month","Income","Available next month","",$0.00,$1227.50,$4308.19
"avidia - Lisa Business",,U,,08/09/2013,"Transfer : Avidia Checking",,,,"",$1500.00,$0.00,$2808.19
"avidia - Lisa Business",,U,,08/23/2013,"Deposit","Income : Available next month","Income","Available next month","",$0.00,$870.00,$3678.19
"avidia - Lisa Business",,U,,09/04/2013,"Trombetta","Lisa Business : Supplies","Lisa Business","Supplies","",$22.28,$0.00,$3655.91
"avidia - Lisa Business",,U,,09/06/2013,"Deposit","Income : Available next month","Income","Available next month","",$0.00,$340.00,$3995.91
"avidia - Lisa Business",,U,,09/06/2013,"Groupon","Lisa Business : Fees","Lisa Business","Fees","",$25.00,$0.00,$3970.91
"avidia - Lisa Business",,U,,09/16/2013,"Deposit","Income : Available next month","Income","Available next month","",$0.00,$497.50,$4468.41
"avidia - Lisa Business",,U,,09/16/2013,"Colonial Garden club","Lisa Business : Fees","Lisa Business","Fees","1020",$25.00,$0.00,$4443.41
"avidia - Lisa Business",,U,,09/16/2013,"Cavichio","Lisa Business : Cost of Goods Sold","Lisa Business","Cost of Goods Sold","",$90.21,$0.00,$4353.20
"avidia - Lisa Business",,U,,09/16/2013,"Common Wealth Ma","Income Tax : Estimated","Hidden Categories","Income Tax ` Estimated","1022",$300.00,$0.00,$4053.20
"avidia - Lisa Business",,U,,09/16/2013,"United States treasury","Income Tax : Estimated","Hidden Categories","Income Tax ` Estimated","1021",$1000.00,$0.00,$3053.20
"avidia - Lisa Business",,U,,09/20/2013,"Deposit","Income : Available next month","Income","Available next month","",$0.00,$100.00,$3153.20
"avidia - Lisa Business",,U,,09/20/2013,"organic gardening inc","Lisa Business : Business expenses","Lisa Business","Business expenses","",$6.65,$0.00,$3146.55
"avidia - Lisa Business",,U,,09/30/2013,"organic gardening inc","Lisa Business : Business expenses","Lisa Business","Business expenses","",$6.65,$0.00,$3139.90
"avidia - Lisa Business",,U,,09/30/2013,"organic gardening inc","Lisa Business : Business expenses","Lisa Business","Business expenses","",$6.65,$0.00,$3133.25
"avidia - Lisa Business",,U,,09/30/2013,"Transfer : Avidia Checking",,,,"",$2000.00,$0.00,$1133.25
"avidia - Lisa Business",,U,,10/04/2013,"lowes","Lisa Business : Supplies","Lisa Business","Supplies","",$48.21,$0.00,$1085.04
"avidia - Lisa Business",,U,,10/07/2013,"Deposit","Income : Available next month","Income","Available next month","",$0.00,$1791.50,$2876.54
"avidia - Lisa Business",,U,,10/08/2013,"Deposit","Income : Available next month","Income","Available next month","",$0.00,$100.00,$2976.54
"avidia - Lisa Business",,U,,10/17/2013,"monnick home supplies","Lisa Business : Supplies","Lisa Business","Supplies","",$20.60,$0.00,$2955.94
"avidia - Lisa Business",,U,,10/18/2013,"Deposit","Income : Available next month","Income","Available next month","",$0.00,$340.00,$3295.94
"avidia - Lisa Business",,U,,10/21/2013,"Amazon","Lisa Business : Business expenses","Lisa Business","Business expenses","",$20.99,$0.00,$3274.95
"avidia - Lisa Business",,U,,10/21/2013,"Amazon","Lisa Business : Business expenses","Lisa Business","Business expenses","",$28.46,$0.00,$3246.49
"avidia - Lisa Business",,U,,10/22/2013,"Transfer : Avidia Checking",,,,"",$1500.00,$0.00,$1746.49
"avidia - Lisa Business",,U,,10/25/2013,"Deposit","Income : Available this month","Income","Available this month","",$0.00,$496.50,$2242.99
"avidia - Lisa Business",,U,,10/28/2013,"lowes","Lisa Business : Supplies","Lisa Business","Supplies","",$34.67,$0.00,$2208.32
"avidia - Lisa Business",,U,,10/28/2013,"cts Store natick ma","Lisa Business : Business expenses","Lisa Business","Business expenses","",$55.89,$0.00,$2152.43
"avidia - Lisa Business",,U,,11/05/2013,"Deposit","Income : Available this month","Income","Available this month","",$0.00,$380.00,$2532.43
"avidia - Lisa Business",,U,,11/05/2013,"Grow Native","Lisa Business : Fees","Lisa Business","Fees","",$13.00,$0.00,$2519.43
"avidia - Lisa Business",,U,,11/05/2013,"Ocean State Joblot","Lisa Business : Supplies","Lisa Business","Supplies","",$21.42,$0.00,$2498.01
"avidia - Lisa Business",,U,,11/05/2013,"Pumpkin Brook","Lisa Business : Services paid for","Lisa Business","Services paid for","1023 soil test",$45.00,$0.00,$2453.01
"avidia - Lisa Business",,U,,11/05/2013,"Transfer : Avidia Checking",,,,"",$1800.00,$0.00,$653.01
"avidia - Lisa Business",,U,,11/12/2013,"Best Buy","Lisa Business : Business expenses","Lisa Business","Business expenses","",$106.23,$0.00,$546.78
"avidia - Lisa Business",,U,,11/15/2013,"Deposit","Income : Available this month","Income","Available this month","",$0.00,$845.00,$1391.78
"avidia - Lisa Business",,U,,11/15/2013,"Colonial Garden club","Lisa Business : Fees","Lisa Business","Fees","1024",$30.00,$0.00,$1361.78
"avidia - Lisa Business",,U,,11/18/2013,"American Meadows","Lisa Business : Business expenses","Lisa Business","Business expenses","",$7.75,$0.00,$1354.03
"avidia - Lisa Business",,U,,11/20/2013,"USPS","Lisa Business : Office supplies","Lisa Business","Office supplies","",$7.45,$0.00,$1346.58
"avidia - Lisa Business",,U,,11/25/2013,"Deposit","Income : Available next month","Income","Available next month","",$0.00,$315.00,$1661.58
"avidia - Lisa Business",,U,,12/10/2013,"Deposit","Income : Available next month","Income","Available next month","",$0.00,$577.50,$2239.08
"avidia - Lisa Business",,U,,12/10/2013,"dollar tree","Lisa Business : Office supplies","Lisa Business","Office supplies","",$5.31,$0.00,$2233.77
"avidia - Lisa Business",,U,,12/16/2013,"Umass Dartmouth","Lisa Business : Services paid for","Lisa Business","Services paid for","1025 Soil Test",$35.00,$0.00,$2198.77
"avidia - Lisa Business",,U,,12/16/2013,"Transfer : Avidia Checking",,,,"",$1700.00,$0.00,$498.77
"avidia - Lisa Business",,U,,12/18/2013,"Deposit","Income : Available next month","Income","Available next month","",$0.00,$320.00,$818.77
"avidia - Lisa Business",,U,,12/27/2013,"Deposit","Income : Available next month","Income","Available next month","",$0.00,$85.00,$903.77
"avidia - Lisa Business",,U,1027,01/02/2014,"Nofa","Lisa Business : Fees","Lisa Business","Fees","1027",$40.00,$0.00,$863.77
"avidia - Lisa Business",,U,,01/06/2014,"Micheals Bellingham","Lisa Business : Cost of Goods Sold","Lisa Business","Cost of Goods Sold","",$359.91,$0.00,$503.86
"avidia - Lisa Business",,U,1026,01/07/2014,"Macy Horton","Lisa Business : Business expenses","Lisa Business","Business expenses","30",$30.00,$0.00,$473.86
"avidia - Lisa Business",,U,,02/04/2014,"Transfer : Avidia Checking",,,,"",$400.00,$0.00,$73.86
"avidia - Lisa Business",,U,,02/07/2014,"parking","Lisa Business : Parking","Lisa Business","Parking","",$12.00,$0.00,$61.86
"avidia - Lisa Business",,U,,02/10/2014,"Godaddy","Lisa Business : Advertizing","Lisa Business","Advertizing","",$17.17,$0.00,$44.69
"avidia - Lisa Business",,U,1028,02/18/2014,"Nofa","Lisa Business : Fees","Lisa Business","Fees","1028",$58.43,$0.00,-$13.74
"avidia - Lisa Business",,U,,02/20/2014,"Transfer : Avidia Checking",,,,"",$0.00,$150.00,$136.26
"avidia - Lisa Business",,U,,02/20/2014,"parking","Lisa Business : Parking","Lisa Business","Parking","",$2.00,$0.00,$134.26
"avidia - Lisa Business",,U,,02/24/2014,"Amazon","Lisa Business : Office supplies","Lisa Business","Office supplies","",$0.00,$20.99,$155.25
"avidia - Lisa Business",,U,1029,02/25/2014,"Holden Chamber of commerce","Lisa Business : Fees","Lisa Business","Fees","",$5.00,$0.00,$150.25
"avidia - Lisa Business",,U,,03/07/2014,"parking","Lisa Business : Parking","Lisa Business","Parking","cambridge",$0.75,$0.00,$149.50
"avidia - Lisa Business",,U,,03/07/2014,"parking","Lisa Business : Parking","Lisa Business","Parking","cambridge",$2.00,$0.00,$147.50
"avidia - Lisa Business",,U,,03/13/2014,"Deposit","Income : Available next month","Income","Available next month","",$0.00,$200.00,$347.50
"avidia - Lisa Business",,U,,03/13/2014,"Price Chopper","Lisa Business : Business expenses","Lisa Business","Business expenses","",$6.32,$0.00,$341.18
"avidia - Lisa Business",,U,,03/17/2014,"Wachusett area Chamber","Lisa Business : Fees","Lisa Business","Fees","",$5.00,$0.00,$336.18
"avidia - Lisa Business",,U,,03/17/2014,"Yelping DEal Green","Lisa Business : Education","Lisa Business","Education","",$25.00,$0.00,$311.18
"avidia - Lisa Business",,U,,03/18/2014,"Green City","Lisa Business : Education","Lisa Business","Education","",$238.25,$0.00,$72.93
"avidia - Lisa Business",,U,,03/24/2014,"lowes","Lisa Business : Supplies","Lisa Business","Supplies","",$14.42,$0.00,$58.51
"avidia - Lisa Business",,U,1030,03/24/2014,"Pumpkin Brook","Lisa Business : Services paid for","Lisa Business","Services paid for","1030",$26.00,$0.00,$32.51
"avidia - Lisa Business",,U,,03/31/2014,"Deposit","Income : Available next month","Income","Available next month","",$0.00,$150.00,$182.51
"avidia - Lisa Business",,U,,03/31/2014,"USPS","Lisa Business : Office supplies","Lisa Business","Office supplies","",$5.60,$0.00,$176.91
"avidia - Lisa Business",,U,,04/04/2014,"parking","Lisa Business : Parking","Lisa Business","Parking","",$2.00,$0.00,$174.91
"avidia - Lisa Business",,U,,04/10/2014,"lowes","Lisa Business : Supplies","Lisa Business","Supplies","",$25.39,$0.00,$149.52
"avidia - Lisa Business",,U,,04/10/2014,"Cavichio","Lisa Business : Cost of Goods Sold","Lisa Business","Cost of Goods Sold","",$93.50,$0.00,$56.02
"avidia - Lisa Business",,U,,04/14/2014,"Prides Crossing","Lisa Business : Business expenses","Lisa Business","Business expenses","",$8.00,$0.00,$48.02
"avidia - Lisa Business",,U,,04/14/2014,"wrapture","Lisa Business : Services paid for","Lisa Business","Services paid for","",$27.77,$0.00,$20.25
"avidia - Lisa Business",,U,1031,04/17/2014,"Umass Dartmouth","Lisa Business : Services paid for","Lisa Business","Services paid for","1031 Soil Test",$20.00,$0.00,$0.25
"avidia - Lisa Business",,U,,04/18/2014,"Sui lee","Income : Available next month","Income","Available next month","",$0.00,$8910.00,$8910.25
"avidia - Lisa Business",,U,,04/25/2014,"Cornerstone Supply","Lisa Business : Cost of Goods Sold","Lisa Business","Cost of Goods Sold","",$224.87,$0.00,$8685.38
"avidia - Lisa Business",,U,1032,04/25/2014,"Sue Bringola","Lisa Business : Contract Work","Lisa Business","Contract Work","Sue Brigola",$1250.00,$0.00,$7435.38
"avidia - Lisa Business",,U,,04/28/2014,"Ocean State Joblot","Lisa Business : Supplies Hardware","Lisa Business","Supplies Hardware","",$51.39,$0.00,$7383.99
"avidia - Lisa Business",,U,,04/28/2014,"Organic Mulch Landscape","Lisa Business : Cost of Goods Sold","Lisa Business","Cost of Goods Sold","",$202.50,$0.00,$7181.49
"avidia - Lisa Business",,U,,04/29/2014,"Home Depot","Lisa Business : Supplies","Lisa Business","Supplies","",$9.56,$0.00,$7171.93
"avidia - Lisa Business",,U,,05/01/2014,"Uhaul","Lisa Business : Equipment Rental","Lisa Business","Equipment Rental","",$7.59,$0.00,$7164.34
"avidia - Lisa Business",,U,,05/01/2014,"Shell oil","Lisa Business : Business expenses","Lisa Business","Business expenses","",$8.68,$0.00,$7155.66
"avidia - Lisa Business",,U,,05/01/2014,"Uhaul","Lisa Business : Equipment Rental","Lisa Business","Equipment Rental","",$48.56,$0.00,$7107.10
"avidia - Lisa Business",,U,,05/01/2014,"Cavichio","Lisa Business : Cost of Goods Sold","Lisa Business","Cost of Goods Sold","",$263.29,$0.00,$6843.81
"avidia - Lisa Business",,U,,05/02/2014,"depost","Income : Available next month","Income","Available next month","",$0.00,$1919.33,$8763.14
"avidia - Lisa Business",,U,,05/05/2014,"vistaprint","Lisa Business : Advertizing","Lisa Business","Advertizing","",$36.97,$0.00,$8726.17
"avidia - Lisa Business",,U,,05/06/2014,"Bigelow Nursery","Lisa Business : Cost of Goods Sold","Lisa Business","Cost of Goods Sold","",$215.42,$0.00,$8510.75
"avidia - Lisa Business",,U,,05/06/2014,"Transfer : Avidia Checking",,,,"",$1000.00,$0.00,$7510.75
"avidia - Lisa Business",,U,,05/08/2014,"USPS","Lisa Business : Office supplies","Lisa Business","Office supplies","",$5.60,$0.00,$7505.15
"avidia - Lisa Business",,U,,05/08/2014,"Cavichio","Lisa Business : Cost of Goods Sold","Lisa Business","Cost of Goods Sold","",$57.38,$0.00,$7447.77
"avidia - Lisa Business",,U,,05/09/2014,"Deposit","Income : Available next month","Income","Available next month","",$0.00,$535.00,$7982.77
"avidia - Lisa Business",,U,,05/09/2014,"city of cambridge","Lisa Business : Parking","Lisa Business","Parking","",$2.00,$0.00,$7980.77
"avidia - Lisa Business",,U,1034,05/09/2014,"Colonial Garden club","Lisa Business : Fees","Lisa Business","Fees","1034",$26.00,$0.00,$7954.77
"avidia - Lisa Business",,U,,05/20/2014,"Deposit","Income : Available next month","Income","Available next month","",$0.00,$180.00,$8134.77
"avidia - Lisa Business",,U,1033,05/21/2014,"Umass","Lisa Business : Services paid for","Lisa Business","Services paid for","1033 soil test",$15.00,$0.00,$8119.77
"avidia - Lisa Business",,U,1035,05/21/2014,"hopkinton garden club","Lisa Business : Fees","Lisa Business","Fees","1035",$31.00,$0.00,$8088.77
"avidia - Lisa Business",,U,,05/21/2014,"Bigelow Nursery","Lisa Business : Cost of Goods Sold","Lisa Business","Cost of Goods Sold","",$1108.80,$0.00,$6979.97
"avidia - Lisa Business",,U,,05/21/2014,"Transfer : Avidia Checking",,,,"",$1500.00,$0.00,$5479.97
"avidia - Lisa Business",,U,,05/22/2014,"Cavichio","Lisa Business : Cost of Goods Sold","Lisa Business","Cost of Goods Sold","",$13.28,$0.00,$5466.69
"avidia - Lisa Business",,U,,05/23/2014,"depost","Income : Available next month","Income","Available next month","",$0.00,$485.00,$5951.69
"avidia - Lisa Business",,U,,05/29/2014,"Cavichio","Lisa Business : Cost of Goods Sold","Lisa Business","Cost of Goods Sold","",$81.87,$0.00,$5869.82
"avidia - Lisa Business",,U,,05/30/2014,"depost","Income : Available next month","Income","Available next month","",$0.00,$180.00,$6049.82
"avidia - Lisa Business",,U,,06/02/2014,"lowes","Lisa Business : Supplies","Lisa Business","Supplies","",$0.00,$35.72,$6085.54
"avidia - Lisa Business",,U,,06/02/2014,"Home Depot","Lisa Business : Supplies","Lisa Business","Supplies","",$34.40,$0.00,$6051.14
"avidia - Lisa Business",,U,,06/02/2014,"lowes","Lisa Business : Supplies","Lisa Business","Supplies","",$74.45,$0.00,$5976.69
"avidia - Lisa Business",,U,,06/03/2014,"USPS","Lisa Business : Office supplies","Lisa Business","Office supplies","",$10.50,$0.00,$5966.19
"avidia - Lisa Business",,U,,06/03/2014,"Home Depot","Lisa Business : Supplies","Lisa Business","Supplies","",$100.00,$0.00,$5866.19
"avidia - Lisa Business",,U,,06/04/2014,"russells garden center","Lisa Business : Cost of Goods Sold","Lisa Business","Cost of Goods Sold","",$7.75,$0.00,$5858.44
"avidia - Lisa Business",,U,,06/04/2014,"Cavichio","Lisa Business : Cost of Goods Sold","Lisa Business","Cost of Goods Sold","",$13.28,$0.00,$5845.16
"avidia - Lisa Business",,U,,06/09/2014,"Home Depot","Lisa Business : Supplies","Lisa Business","Supplies","",$8.46,$0.00,$5836.70
"avidia - Lisa Business",,U,,06/09/2014,"Bigelow Nursery","Lisa Business : Cost of Goods Sold","Lisa Business","Cost of Goods Sold","",$85.06,$0.00,$5751.64
"avidia - Lisa Business",,U,,06/09/2014,"Hardwick Farmers","Lisa Business : Cost of Goods Sold","Lisa Business","Cost of Goods Sold","",$241.78,$0.00,$5509.86
"avidia - Lisa Business",,U,1037,06/09/2014,"Carol klos","Lisa Business : Contract Work","Lisa Business","Contract Work","1037",$375.00,$0.00,$5134.86
"avidia - Lisa Business",,U,,06/13/2014,"Jeds hardware Holding","Lisa Business : Supplies Hardware","Lisa Business","Supplies Hardware","",$50.04,$0.00,$5084.82
"avidia - Lisa Business",,U,,06/16/2014,"Deposit","Income : Available next month","Income","Available next month","",$0.00,$9190.00,$14274.82
"avidia - Lisa Business",,U,1038,06/16/2014,"Carol klos","Lisa Business : Contract Work","Lisa Business","Contract Work","1038",$210.00,$0.00,$14064.82
"avidia - Lisa Business",,U,,06/16/2014,"Organic Mulch Landscape","Lisa Business : Cost of Goods Sold","Lisa Business","Cost of Goods Sold","",$269.75,$0.00,$13795.07
"avidia - Lisa Business",,U,,06/20/2014,"Cavichio","Lisa Business : Cost of Goods Sold","Lisa Business","Cost of Goods Sold","",$77.03,$0.00,$13718.04
"avidia - Lisa Business",,U,,06/23/2014,"russells garden center","Lisa Business : Cost of Goods Sold","Lisa Business","Cost of Goods Sold","",$189.51,$0.00,$13528.53
"avidia - Lisa Business",,U,,06/23/2014,"Cavichio","Lisa Business : Cost of Goods Sold","Lisa Business","Cost of Goods Sold","Shalin",$242.78,$0.00,$13285.75
"avidia - Lisa Business",,U,,06/23/2014,"New England Wildflower Society","Lisa Business : Cost of Goods Sold","Lisa Business","Cost of Goods Sold","",$373.12,$0.00,$12912.63
"avidia - Lisa Business",,U,1042,06/23/2014,"Bigelow Nursery","Lisa Business : Cost of Goods Sold","Lisa Business","Cost of Goods Sold","1043 Shalin",$857.50,$0.00,$12055.13
"avidia - Lisa Business",,U,,06/23/2014,"Transfer : Avidia Checking",,,,"",$2500.00,$0.00,$9555.13
"avidia - Lisa Business",,U,,06/25/2014,"Home Depot","Lisa Business : Supplies","Lisa Business","Supplies","",$43.35,$0.00,$9511.78
"avidia - Lisa Business",,U,,06/27/2014,"Deposit Marlboro","Income : Available this month","Income","Available this month","",$0.00,$2041.28,$11553.06
"avidia - Lisa Business",,U,1039,06/27/2014,"Farm Insurance","Lisa Business : Insurance","Lisa Business","Insurance","1039",$141.00,$0.00,$11412.06
"avidia - Lisa Business",,U,,06/30/2014,"Cornerstone Supply","Lisa Business : Cost of Goods Sold","Lisa Business","Cost of Goods Sold","",$261.25,$0.00,$11150.81
"avidia - Lisa Business",,U,1040,07/01/2014,"MFBF","Lisa Business : Membrships","Lisa Business","Membrships","",$60.00,$0.00,$11090.81
"avidia - Lisa Business",,U,1044,07/01/2014,"Carol klos","Lisa Business : Contract Work","Lisa Business","Contract Work","",$270.00,$0.00,$10820.81
"avidia - Lisa Business",,U,,07/02/2014,"Bigelow Nursery","Lisa Business : Cost of Goods Sold","Lisa Business","Cost of Goods Sold","",$191.25,$0.00,$10629.56
"avidia - Lisa Business",,U,,07/03/2014,"Cavichio","Lisa Business : Cost of Goods Sold","Lisa Business","Cost of Goods Sold","",$39.84,$0.00,$10589.72
"avidia - Lisa Business",,U,,07/04/2014,"Transfer : Avidia Checking",,,,"",$2500.00,$0.00,$8089.72
"avidia - Lisa Business",,U,,07/08/2014,"lowes","Lisa Business : Supplies","Lisa Business","Supplies","",$47.77,$0.00,$8041.95
"avidia - Lisa Business",,U,1043,07/08/2014,"Mouncy","Lisa Business : Cost of Goods Sold","Lisa Business","Cost of Goods Sold","",$106.00,$0.00,$7935.95
"avidia - Lisa Business",,U,1047,07/09/2014,"Farm Insurance","Lisa Business : Insurance","Lisa Business","Insurance","Worker's comp",$211.00,$0.00,$7724.95
"avidia - Lisa Business",,U,1045,07/10/2014,"Farm Insurance","Lisa Business : Insurance","Lisa Business","Insurance","Disability",$61.20,$0.00,$7663.75
"avidia - Lisa Business",,U,,07/11/2014,"Deposit Marlboro","Income : Available this month","Income","Available this month","",$0.00,$1107.50,$8771.25
"avidia - Lisa Business",,U,,07/14/2014,"Home Depot","Lisa Business : Cost of Goods Sold","Lisa Business","Cost of Goods Sold","",$6.67,$0.00,$8764.58
"avidia - Lisa Business",,U,,07/15/2014,"Bigelow Nursery","Lisa Business : Cost of Goods Sold","Lisa Business","Cost of Goods Sold","",$189.13,$0.00,$8575.45
"avidia - Lisa Business",,U,1049,07/15/2014,"United States treasury","Income Tax : Estimated","Hidden Categories","Income Tax ` Estimated","",$2000.00,$0.00,$6575.45
"avidia - Lisa Business",,U,1052,07/16/2014,"MetroWest Irrigation Chris Pacheco","Lisa Business : Services paid for","Lisa Business","Services paid for","Irragation Suli",$5000.00,$0.00,$1575.45
"avidia - Lisa Business",,U,,07/17/2014,"Godaddy","Lisa Business : Advertizing","Lisa Business","Advertizing","",$15.17,$0.00,$1560.28
"avidia - Lisa Business",,U,,07/17/2014,"Cavichio","Lisa Business : Cost of Goods Sold","Lisa Business","Cost of Goods Sold","",$142.19,$0.00,$1418.09
"avidia - Lisa Business",,U,,07/18/2014,"russells garden center","Lisa Business : Cost of Goods Sold","Lisa Business","Cost of Goods Sold","",$34.13,$0.00,$1383.96
"avidia - Lisa Business",,U,,07/21/2014,"lowes","Lisa Business : Supplies","Lisa Business","Supplies","",$0.00,$31.85,$1415.81
"avidia - Lisa Business",,U,,07/23/2014,"Home Depot","Lisa Business : Cost of Goods Sold","Lisa Business","Cost of Goods Sold","",$13.35,$0.00,$1402.46
"avidia - Lisa Business",,U,1051,07/24/2014,"city of marlboro","Lisa Business : Misc","Lisa Business","Misc","",$50.00,$0.00,$1352.46
"avidia - Lisa Business",,U,1050,07/24/2014,"Common Wealth Ma","Income Tax : Estimated","Hidden Categories","Income Tax ` Estimated","",$500.00,$0.00,$852.46
"avidia - Lisa Business",,U,,07/25/2014,"Deposit","Income : Available next month","Income","Available next month","",$0.00,$4186.78,$5039.24
"avidia - Lisa Business",,U,,07/25/2014,"russells garden center","Lisa Business : Cost of Goods Sold","Lisa Business","Cost of Goods Sold","",$35.02,$0.00,$5004.22
"avidia - Lisa Business",,U,1048,07/25/2014,"Mouncy","Lisa Business : Cost of Goods Sold","Lisa Business","Cost of Goods Sold","",$120.00,$0.00,$4884.22
"avidia - Lisa Business",,U,1053,07/25/2014,"Carol klos","Lisa Business : Contract Work","Lisa Business","Contract Work","",$220.00,$0.00,$4664.22
"avidia - Lisa Business",,U,,07/30/2014,"Home Depot","Lisa Business : Cost of Goods Sold","Lisa Business","Cost of Goods Sold","",$13.35,$0.00,$4650.87
"avidia - Lisa Business",,U,,07/30/2014,"Cavichio","Lisa Business : Cost of Goods Sold","Lisa Business","Cost of Goods Sold","",$111.03,$0.00,$4539.84
"avidia - Lisa Business",,U,,07/31/2014,"Deposit","Income : Available next month","Income","Available next month","Deposit from Si line",$0.00,$8750.00,$13289.84
"avidia - Lisa Business",,U,,07/31/2014,"Cavichio","Lisa Business : Cost of Goods Sold","Lisa Business","Cost of Goods Sold","",$22.10,$0.00,$13267.74
"avidia - Lisa Business",,U,,08/01/2014,"Deposit","Income : Available next month","Income","Available next month","",$0.00,$1700.00,$14967.74
"avidia - Lisa Business",,U,1054,08/05/2014,"Sue Bringola","Lisa Business : Contract Work","Lisa Business","Contract Work","",$6515.00,$0.00,$8452.74
"avidia - Lisa Business",,U,,08/11/2014,"French Meadow","Lisa Business : Supplies","Lisa Business","Supplies","",$5.18,$0.00,$8447.56
"avidia - Lisa Business",,U,,08/13/2014,"Transfer : Avidia Checking",,,,"",$4000.00,$0.00,$4447.56
"avidia - Lisa Business",,U,,08/15/2014,"Deposit","Income : Available this month","Income","Available this month","",$0.00,$1047.50,$5495.06
"avidia - Lisa Business",,U,,08/19/2014,"Officemax","Lisa Business : Office supplies","Lisa Business","Office supplies","",$56.30,$0.00,$5438.76
"avidia - Lisa Business",,U,,08/21/2014,"Grow Native","Lisa Business : Fees","Lisa Business","Fees","",$25.00,$0.00,$5413.76
"avidia - Lisa Business",,U,1055,08/25/2014,"Farm Insurance","Lisa Business : Insurance","Lisa Business","Insurance","",$35.70,$0.00,$5378.06
"avidia - Lisa Business",,U,,08/28/2014,"Mahoney s Rocke Le","Lisa Business : Cost of Goods Sold","Lisa Business","Cost of Goods Sold","",$841.97,$0.00,$4536.09
"avidia - Lisa Business",,U,,09/02/2014,"Deposit","Income : Available this month","Income","Available this month","",$0.00,$421.20,$4957.29
"avidia - Lisa Business",,U,,09/02/2014,"Bigelow Nursery","Lisa Business : Cost of Goods Sold","Lisa Business","Cost of Goods Sold","",$167.95,$0.00,$4789.34
"avidia - Lisa Business",,U,,09/02/2014,"Bigelow Nursery","Lisa Business : Cost of Goods Sold","Lisa Business","Cost of Goods Sold","",$173.93,$0.00,$4615.41
"avidia - Lisa Business",,U,,09/04/2014,"Farm Insurance","Lisa Business : Insurance","Lisa Business","Insurance","",$218.50,$0.00,$4396.91
"avidia - Lisa Business",,U,,09/05/2014,"Deposit","Income : Available this month","Income","Available this month","",$0.00,$200.00,$4596.91
"avidia - Lisa Business",,U,,09/05/2014,"Transfer : Avidia Checking",,,,"",$3000.00,$0.00,$1596.91
"avidia - Lisa Business",,U,,09/10/2014,"Family Garden And Market","Food : Restaurants","Food","Restaurants","",$9.56,$0.00,$1587.35
"avidia - Lisa Business",,U,,09/10/2014,"Cavichio","Lisa Business : Cost of Goods Sold","Lisa Business","Cost of Goods Sold","",$112.09,$0.00,$1475.26
"avidia - Lisa Business",,U,,09/12/2014,"Deposit","Income : Available this month","Income","Available this month","",$0.00,$160.00,$1635.26
"avidia - Lisa Business",,U,1056,09/12/2014,"Colonial Garden club","Lisa Business : Fees","Lisa Business","Fees","",$25.00,$0.00,$1610.26
"avidia - Lisa Business",,U,,09/15/2014,"Transfer : Avidia Checking",,,,"",$0.00,$1500.00,$3110.26
"avidia - Lisa Business",,U,1058,09/17/2014,"United States treasury","Income Tax : Estimated","Hidden Categories","Income Tax ` Estimated","",$2000.00,$0.00,$1110.26
"avidia - Lisa Business",,U,,09/19/2014,"russells garden center","Lisa Business : Cost of Goods Sold","Lisa Business","Cost of Goods Sold","",$120.55,$0.00,$989.71
"avidia - Lisa Business",,U,,09/22/2014,"Home Depot","Lisa Business : Cost of Goods Sold","Lisa Business","Cost of Goods Sold","",$14.98,$0.00,$974.73
"avidia - Lisa Business",,U,,09/25/2014,"Cavichio","Lisa Business : Cost of Goods Sold","Lisa Business","Cost of Goods Sold","",$63.22,$0.00,$911.51
"avidia - Lisa Business",,U,,09/26/2014,"Deposit","Income : Available this month","Income","Available this month","",$0.00,$160.00,$1071.51
"avidia - Lisa Business",,U,1057,09/26/2014,"Common Wealth Ma","Income Tax : Estimated","Hidden Categories","Income Tax ` Estimated","",$500.00,$0.00,$571.51
"avidia - Lisa Business",,U,,09/29/2014,"Hyannis country Garden","Lisa Business : Fees","Lisa Business","Fees","",$65.36,$0.00,$506.15
"avidia - Lisa Business",,U,,09/29/2014,"Transfer : Avidia Checking",,,,"",$300.00,$0.00,$206.15
"avidia - Lisa Business",,U,,09/30/2014,"Deposit","Income : Available this month","Income","Available this month","",$0.00,$6441.00,$6647.15
"avidia - Lisa Business",,U,,10/03/2014,"Deposit","Income : Available this month","Income","Available this month","",$0.00,$4466.39,$11113.54
"avidia - Lisa Business",,U,,10/03/2014,"Cavichio","Lisa Business : Cost of Goods Sold","Lisa Business","Cost of Goods Sold","",$113.69,$0.00,$10999.85
"avidia - Lisa Business",,U,,10/06/2014,"Transfer : Avidia Checking",,,,"",$9000.00,$0.00,$1999.85
"avidia - Lisa Business",,U,1059,10/07/2014,"Brianna Asbury","Lisa Business : Contract Work","Lisa Business","Contract Work","",$2558.00,$0.00,-$558.15
"avidia - Lisa Business",,U,,10/08/2014,"bank  fee","Lisa Business : Bank Fees","Lisa Business","Bank Fees","",$30.00,$0.00,-$588.15
"avidia - Lisa Business",,U,,10/09/2014,"Transfer : Avidia Checking",,,,"",$0.00,$3000.00,$2411.85
"avidia - Lisa Business",,U,,10/10/2014,"Deposit","Income : Available this month","Income","Available this month","",$0.00,$804.22,$3216.07
"avidia - Lisa Business",,U,,10/14/2014,"Farm Insurance","Lisa Business : Insurance","Lisa Business","Insurance","",$409.80,$0.00,$2806.27
"avidia - Lisa Business",,U,,10/16/2014,"Engelen Farm","Lisa Business : Business expenses","Lisa Business","Business expenses","",$283.53,$0.00,$2522.74
"avidia - Lisa Business",,U,,10/20/2014,"russells garden center","Lisa Business : Cost of Goods Sold","Lisa Business","Cost of Goods Sold","",$22.31,$0.00,$2500.43
"avidia - Lisa Business",,U,,10/23/2014,"Deposit","Income : Available this month","Income","Available this month","",$0.00,$1157.00,$3657.43
"avidia - Lisa Business",,U,,10/23/2014,"Trombetta","Lisa Business : Supplies","Lisa Business","Supplies","",$26.60,$0.00,$3630.83
"avidia - Lisa Business",,U,,10/23/2014,"russells garden center","Lisa Business : Cost of Goods Sold","Lisa Business","Cost of Goods Sold","",$99.72,$0.00,$3531.11
"avidia - Lisa Business",,U,,10/27/2014,"Deposit","Income : Available this month","Income","Available this month","",$0.00,$100.00,$3631.11
"avidia - Lisa Business",,U,1061,10/30/2014,"Carol klos","Lisa Business : Contract Work","Lisa Business","Contract Work","",$125.00,$0.00,$3506.11
"avidia - Lisa Business",,U,1060,11/03/2014,"Metrowest Irrigation","Lisa Business : Business expenses","Lisa Business","Business expenses","",$85.00,$0.00,$3421.11
"avidia - Lisa Business",,U,,11/03/2014,"Farm Insurance","Lisa Business : Insurance","Lisa Business","Insurance","",$422.00,$0.00,$2999.11
"avidia - Lisa Business",,U,1062,11/05/2014,"Carol klos","Lisa Business : Contract Work","Lisa Business","Contract Work","",$125.00,$0.00,$2874.11
"avidia - Lisa Business",,U,,11/06/2014,"Deposit","Income : Available this month","Income","Available this month","",$0.00,$209.00,$3083.11
"avidia - Lisa Business",,U,,11/06/2014,"Cavichio","Lisa Business : Cost of Goods Sold","Lisa Business","Cost of Goods Sold","",$20.77,$0.00,$3062.34
"avidia - Lisa Business",,U,,11/10/2014,"Home Depot","Lisa Business : Cost of Goods Sold","Lisa Business","Cost of Goods Sold","",$51.79,$0.00,$3010.55
"avidia - Lisa Business",,U,1063,11/13/2014,"Carol klos","Lisa Business : Contract Work","Lisa Business","Contract Work","",$150.00,$0.00,$2860.55
"avidia - Lisa Business",,U,,11/14/2014,"Deposit","Income : Available this month","Income","Available this month","",$0.00,$440.00,$3300.55
"avidia - Lisa Business",,U,,11/18/2014,"lowes","Lisa Business : Business expenses","Lisa Business","Business expenses","",$52.04,$0.00,$3248.51
"avidia - Lisa Business",,U,,11/20/2014,"Cavichio","Lisa Business : Cost of Goods Sold","Lisa Business","Cost of Goods Sold","",$15.09,$0.00,$3233.42
"avidia - Lisa Business",,U,1064,11/24/2014,"Carol klos","Lisa Business : Contract Work","Lisa Business","Contract Work","",$75.00,$0.00,$3158.42
"avidia - Lisa Business",,U,,11/26/2014,"stop & shop","Food : Groceries","Food","Groceries","",$72.81,$0.00,$3085.61
"avidia - Lisa Business",,U,,11/28/2014,"dunkin donuts","Food : Restaurants","Food","Restaurants","",$20.00,$0.00,$3065.61
"avidia - Lisa Business",,U,,11/28/2014,"RIng Brothers Market place","Food : Groceries","Food","Groceries","",$28.99,$0.00,$3036.62
"avidia - Lisa Business",,U,,12/02/2014,"Deposit","Income : Available this month","Income","Available this month","",$0.00,$1643.00,$4679.62
"avidia - Lisa Business",,U,,12/02/2014,"Transfer : Avidia Checking",,,,"",$1500.00,$0.00,$3179.62
"avidia - Lisa Business",,U,,12/03/2014,"Transfer : Avidia Checking",,,,"",$1000.00,$0.00,$2179.62
"avidia - Lisa Business",,U,,12/04/2014,"Cavichio","Lisa Business : Cost of Goods Sold","Lisa Business","Cost of Goods Sold","",$121.55,$0.00,$2058.07
"avidia - Lisa Business",,U,,12/08/2014,"Price Chopper","Lisa Business : Business expenses","Lisa Business","Business expenses","",$21.20,$0.00,$2036.87
"avidia - Lisa Business",,U,,12/15/2014,"Deposit","Income : Available this month","Income","Available this month","",$0.00,$1415.00,$3451.87
"avidia - Lisa Business",,U,,12/24/2014,"Deposit","Income : Available this month","Income","Available this month","",$0.00,$2829.75,$6281.62
"avidia - Lisa Business",,U,,12/24/2014,"Transfer : Avidia Checking",,,,"",$2400.00,$0.00,$3881.62
"avidia - Lisa Business",,U,,12/29/2014,"Transfer : Avidia Checking",,,,"",$3000.00,$0.00,$881.62
"avidia - Lisa Business",,U,,01/08/2015,"Staples","Lisa Business : Business expenses","Lisa Business","Business expenses","",$11.68,$0.00,$869.94
"avidia - Lisa Business",,U,,01/21/2015,"Transfer : Avidia Checking",,,,"",$500.00,$0.00,$369.94
"avidia - Lisa Business",,U,1065,01/23/2015,"Nofa/mass","Lisa Business : Membrships","Lisa Business","Membrships","",$40.00,$0.00,$329.94
"avidia - Lisa Business",,U,,02/06/2015,"city of cambridge","Lisa Business : Parking","Lisa Business","Parking","",$2.00,$0.00,$327.94
"avidia - Lisa Business",,U,,03/02/2015,"go daddy","Lisa Business : Advertizing","Lisa Business","Advertizing","",$34.34,$0.00,$293.60
"avidia - Lisa Business",,U,,04/01/2015,"Cavichio","Lisa Business : Cost of Goods Sold","Lisa Business","Cost of Goods Sold","",$46.75,$0.00,$246.85
"avidia - Lisa Business",,U,,04/02/2015,"Shop at tower hill","Lisa Business : Fees","Lisa Business","Fees","",$43.00,$0.00,$203.85
"avidia - Lisa Business",,U,,04/03/2015,"city of cambridge","Lisa Business : Parking","Lisa Business","Parking","",$0.00,$0.00,$203.85
"avidia - Lisa Business",,U,,04/03/2015,"city of cambridge","Lisa Business : Parking","Lisa Business","Parking","",$2.00,$0.00,$201.85
"avidia - Lisa Business",,U,,04/03/2015,"New England Wildflower Society","Lisa Business : Cost of Goods Sold","Lisa Business","Cost of Goods Sold",,$110.00,$0.00,$91.85
"avidia - Lisa Business",,U,,04/07/2015,"Officemax","Lisa Business : Office supplies","Lisa Business","Office supplies","",$5.31,$0.00,$86.54
"avidia - Lisa Business",,U,,04/10/2015,"Cavichio","Lisa Business : Cost of Goods Sold","Lisa Business","Cost of Goods Sold","",$68.96,$0.00,$17.58
"avidia - Lisa Business",,U,,04/24/2015,"income","Income : Available next month","Income","Available next month","",$0.00,$160.00,$177.58
"avidia - Lisa Business",,U,,04/27/2015,"New England Wildflower Society","Lisa Business : Cost of Goods Sold","Lisa Business","Cost of Goods Sold","",$0.00,$110.00,$287.58
"avidia - Lisa Business",,U,,04/27/2015,"Home Depot","Lisa Business : Supplies","Lisa Business","Supplies","",$28.69,$0.00,$258.89
"avidia - Lisa Business",,U,,04/29/2015,"New England Wildflower Society","Lisa Business : Cost of Goods Sold","Lisa Business","Cost of Goods Sold","",$115.00,$0.00,$143.89
"avidia - Lisa Business",,U,,05/01/2015,"Deposit","Income : Available this month","Income","Available this month","",$0.00,$200.00,$343.89
"avidia - Lisa Business",,U,,05/04/2015,"Deposit","Income : Available this month","Income","Available this month","",$0.00,$956.50,$1300.39
"avidia - Lisa Business",,U,,05/08/2015,"Deposit","Income : Available this month","Income","Available this month","",$0.00,$560.00,$1860.39
"avidia - Lisa Business",,U,,05/08/2015,"city of cambridge","Lisa Business : Parking","Lisa Business","Parking","",$2.00,$0.00,$1858.39
"avidia - Lisa Business",,U,,05/11/2015,"Trombetta","Lisa Business : Cost of Goods Sold","Lisa Business","Cost of Goods Sold","",$31.33,$0.00,$1827.06
"avidia - Lisa Business",,U,1066,05/19/2015,"Grow Native","Lisa Business : Cost of Goods Sold","Lisa Business","Cost of Goods Sold","",$36.00,$0.00,$1791.06
"avidia - Lisa Business",,U,1067,05/19/2015,"Green City","Lisa Business : Cost of Goods Sold","Lisa Business","Cost of Goods Sold","",$54.00,$0.00,$1737.06
"avidia - Lisa Business",,U,1068,05/19/2015,"WFCF","Lisa Business : Business expenses","Lisa Business","Business expenses","",$105.00,$0.00,$1632.06
"avidia - Lisa Business",,U,,05/21/2015,"Deposit","Income : Available this month","Income","Available this month","",$0.00,$580.50,$2212.56
"avidia - Lisa Business",,U,,05/22/2015,"russells garden center","Lisa Business : Cost of Goods Sold","Lisa Business","Cost of Goods Sold","",$144.93,$0.00,$2067.63
"avidia - Lisa Business",,U,,05/26/2015,"russells garden center","Lisa Business : Cost of Goods Sold","Lisa Business","Cost of Goods Sold","",$0.00,$103.84,$2171.47
"avidia - Lisa Business",,U,,05/26/2015,"Amazon","Lisa Business : Business expenses","Lisa Business","Business expenses","",$23.04,$0.00,$2148.43
"avidia - Lisa Business",,U,,05/26/2015,"russells garden center","Lisa Business : Cost of Goods Sold","Lisa Business","Cost of Goods Sold","",$34.17,$0.00,$2114.26
"avidia - Lisa Business",,U,,05/28/2015,"Cavichio","Lisa Business : Cost of Goods Sold","Lisa Business","Cost of Goods Sold","",$82.03,$0.00,$2032.23
"avidia - Lisa Business",,C,,05/29/2015,"Deposit","Income : Available this month","Income","Available this month",,$0.00,$340.00,$2372.23
"avidia - Lisa Business",,C,,05/29/2015,"TROMBETTAS FARM ICE CREA","Lisa Business : Cost of Goods Sold","Lisa Business","Cost of Goods Sold","POS PURCHASE MERCHANT PURCHASE TERMINAL 422899 TROMBETTAS FARM IC E CREAMARLBOROU MA XXXXXXXXXXXX3758 05-27-15",$29.72,$0.00,$2342.51
"avidia - Lisa Business",,C,,06/01/2015,"BIGELOW NURSERIES  INC","Lisa Business : Cost of Goods Sold","Lisa Business","Cost of Goods Sold","POS PURCHASE MERCHANT PURCHASE TERMINAL 425477 BIGELOW NURSERIES INC  NORTHBORO MA                      X XXXXXXXXXXX3758                        0 5-28-15",$93.50,$0.00,$2249.01
"avidia - Lisa Business",,C,,06/01/2015,"CAVICCHIO GREENHOUSES","Lisa Business : Cost of Goods Sold","Lisa Business","Cost of Goods Sold","POS PURCHASE MERCHANT PURCHASE TERMINAL 432300 CAVICCHIO GREENHOU SES   SUDBURY   MA XXXXXXXXXXXX3758 05-28-15",$120.59,$0.00,$2128.42
"avidia - Lisa Business",,C,,06/03/2015,"CAVICCHIO GREENHOUSES","Lisa Business : Cost of Goods Sold","Lisa Business","Cost of Goods Sold","POS PURCHASE MERCHANT PURCHASE TERMINAL 432300 CAVICCHIO GREENHOU SES   SUDBURY   MA XXXXXXXXXXXX3758 06-01-15",$61.63,$0.00,$2066.79
"avidia - Lisa Business",,C,,06/05/2015,"TROMBETTAS FARM ICE CREA","Lisa Business : Cost of Goods Sold","Lisa Business","Cost of Goods Sold","POS PURCHASE MERCHANT PURCHASE TERMINAL 422899 TROMBETTAS FARM IC E CREAMARLBOROU MA XXXXXXXXXXXX3758 06-03-15",$69.00,$0.00,$1997.79
"avidia - Lisa Business",,C,1069,06/11/2015,"Patrick Stenglein","Lisa Business : Business expenses","Lisa Business","Business expenses","",$10.50,$0.00,$1987.29
"avidia - Lisa Business",,C,,06/12/2015,"russells garden center","Lisa Business : Cost of Goods Sold","Lisa Business","Cost of Goods Sold","POS PURCHASE MERCHANT PURCHASE TERMINAL 482824 RUSSELLS GARDEN CE NTER  WAYLAND   MA XXXXXXXXXXXX3758 06-10-15",$38.80,$0.00,$1948.49
"avidia - Lisa Business",,C,,06/15/2015,"CAVICCHIO GREENHOUSES","Lisa Business : Cost of Goods Sold","Lisa Business","Cost of Goods Sold","POS PURCHASE MERCHANT PURCHASE TERMINAL 432300 CAVICCHIO GREENHOU SES   SUDBURY   MA XXXXXXXXXXXX3758 06-13-15",$130.21,$0.00,$1818.28
"avidia - Lisa Business",,C,,06/15/2015,"BIGELOW NURSERIES  INC","Lisa Business : Cost of Goods Sold","Lisa Business","Cost of Goods Sold","POS PURCHASE MERCHANT PURCHASE TERMINAL 425477 BIGELOW NURSERIES INC  NORTHBORO MA                      X XXXXXXXXXXX3758                        0 6-12-15",$133.36,$0.00,$1684.92
"avidia - Lisa Business",,C,,06/16/2015,"Deposit","Income : Available this month","Income","Available this month",,$0.00,$349.00,$2033.92
"avidia - Lisa Business",,C,,06/16/2015,"AMAZON.COM","Lisa Business : Business expenses","Lisa Business","Business expenses","POS PURCHASE POS PURCHASE TERMINAL 00000101 AMAZON.COM SEATTLE   WA                      XXXXXX XXXXXX3758                        06-16- 15  12:05 AM",$46.74,$0.00,$1987.18
"avidia - Lisa Business",,C,,06/17/2015,"FARM FAMILY","Lisa Business : Insurance","Lisa Business","Insurance","PREAUTHORIZED WD FARM FAMILY INS WEBPAY 150617",$148.75,$0.00,$1838.43
"avidia - Lisa Business",,C,,06/19/2015,"russells garden center","Lisa Business : Cost of Goods Sold","Lisa Business","Cost of Goods Sold","POS PURCHASE MERCHANT PURCHASE TERMINAL 482824 RUSSELLS GARDEN CE NTER  WAYLAND   MA XXXXXXXXXXXX3758 06-17-15",$85.79,$0.00,$1752.64
"avidia - Lisa Business",,C,,06/22/2015,"ROBINSON S HARDWAR","Lisa Business : Cost of Goods Sold","Lisa Business","Cost of Goods Sold","POS REFUND MERCHANT REFUND TERMINAL 463269 ROBINSON S HARDWAR E  HUDHUDSON    MA XXXXXXXXXXXX3758 06-20-15  12:00 AM",$0.00,$7.43,$1760.07
"avidia - Lisa Business",,C,,06/22/2015,"ROBINSON S HARDWARE  HUD","Lisa Business : Cost of Goods Sold","Lisa Business","Cost of Goods Sold","POS PURCHASE MERCHANT PURCHASE TERMINAL 463269 ROBINSON S HARDWAR E  HUDHUDSON    MA XXXXXXXXXXXX3758 06-19-15",$7.43,$0.00,$1752.64
"avidia - Lisa Business",,C,,06/22/2015,"ROBINSON S HARDWARE  HUD","Lisa Business : Cost of Goods Sold","Lisa Business","Cost of Goods Sold","POS PURCHASE MERCHANT PURCHASE TERMINAL 463269 ROBINSON S HARDWAR E  HUDHUDSON    MA XXXXXXXXXXXX3758 06-19-15",$7.43,$0.00,$1745.21
"avidia - Lisa Business",,C,,06/22/2015,"ROBINSON S HARDWARE  HUD","Lisa Business : Cost of Goods Sold","Lisa Business","Cost of Goods Sold","POS PURCHASE MERCHANT PURCHASE TERMINAL 463269 ROBINSON S HARDWAR E  HUDHUDSON    MA XXXXXXXXXXXX3758 06-20-15",$8.13,$0.00,$1737.08
"avidia - Lisa Business",,C,,06/25/2015,"GREEN GEEKS","Lisa Business : Advertizing","Lisa Business","Advertizing","POS PURCHASE MERCHANT PURCHASE TERMINAL 425477 GREEN GEEKS 877 32674 CA                      XXXXXX XXXXXX3758                        06-23- 15",$142.56,$0.00,$1594.52
"avidia - Lisa Business",,C,,06/26/2015,"Deposit","Income : Available this month","Income","Available this month",,$0.00,$811.00,$2405.52
"avidia - Lisa Business",,C,,06/29/2015,"Deposit","Income : Available this month","Income","Available this month",,$0.00,$1520.00,$3925.52
"avidia - Lisa Business",,C,,06/30/2015,"FARM FAMILY","Lisa Business : Insurance","Lisa Business","Insurance","PREAUTHORIZED WD FARM FAMILY INS WEBPAY 150630",$211.00,$0.00,$3714.52
"avidia - Lisa Business",,C,,07/02/2015,"CAVICCHIO GREENHOUSES","Lisa Business : Cost of Goods Sold","Lisa Business","Cost of Goods Sold","POS PURCHASE MERCHANT PURCHASE TERMINAL 432300 CAVICCHIO GREENHOU SES   SUDBURY   MA XXXXXXXXXXXX3758 06-30-15",$27.89,$0.00,$3686.63
"avidia - Lisa Business",,C,,07/02/2015,"MASS FARM BUREAU","Lisa Business : Business expenses","Lisa Business","Business expenses","POS PURCHASE MERCHANT PURCHASE TERMINAL 449215 MASS FARM BUREAU 481 481 4 MA                      XXXXXX XXXXXX3758                        07-01- 15",$60.00,$0.00,$3626.63
"avidia - Lisa Business",,C,,07/02/2015,"CTNOFA STORE","Lisa Business : Membrships","Lisa Business","Membrships","POS PURCHASE MERCHANT PURCHASE TERMINAL 449215 CTNOFA STORE CTNOFASTO CT                      XXXXXX XXXXXX3758                        07-01- 15",$100.00,$0.00,$3526.63
"avidia - Lisa Business",,C,,07/03/2015,"Deposit","Income : Available this month","Income","Available this month",,$0.00,$1121.00,$4647.63
"avidia - Lisa Business",,C,,07/03/2015,"BB  NE WILD FLOWER SOC","Lisa Business : Membrships","Lisa Business","Membrships","POS PURCHASE MERCHANT PURCHASE TERMINAL 405523 BB  NE WILD FLOWER SOC  508 877 7 MA                      X XXXXXXXXXXX3758                        0 7-02-15",$40.00,$0.00,$4607.63
"avidia - Lisa Business",,C,,07/06/2015,"THE HOME DEPOT 2669","Lisa Business : Business expenses","Lisa Business","Business expenses","POS PURCHASE MERCHANT PURCHASE TERMINAL 319181 THE HOME DEPOT 266 9     NATICK    MA XXXXXXXXXXXX3758 07-06-15  10:49 AM",$66.91,$0.00,$4540.72
"avidia - Lisa Business",,C,,07/09/2015,"NEW ENGLAND WILD F","Lisa Business : Business expenses","Lisa Business","Business expenses","POS PURCHASE MERCHANT PURCHASE TERMINAL 422443 NEW ENGLAND WILD F FRAMINGHA MA                      XXXXXX XXXXXX3758                        07-08- 15",$9.55,$0.00,$4531.17
"avidia - Lisa Business",,C,,07/10/2015,"Deposit","Income : Available this month","Income","Available this month","",$0.00,$1920.00,$6451.17
"avidia - Lisa Business",,C,,07/10/2015,"DNH GODADDY COM","Lisa Business : Advertizing","Lisa Business","Advertizing","POS PURCHASE MERCHANT PURCHASE TERMINAL 490641 DNH GODADDY COM 480 50588 AZ                      XXXXXX XXXXXX3758                        07-08- 15",$15.17,$0.00,$6436.00
"avidia - Lisa Business",,C,1070,07/15/2015,"city of marlboro","Lisa Business : Business expenses","Lisa Business","Business expenses","dump sticker",$50.00,$0.00,$6386.00
"avidia - Lisa Business",,C,,07/17/2015,"DNH GODADDY COM","Lisa Business : Advertizing","Lisa Business","Advertizing","POS PURCHASE MERCHANT PURCHASE TERMINAL 490641 DNH GODADDY COM 480 50588 AZ                      XXXXXX XXXXXX3758                        07-16- 15",$15.17,$0.00,$6370.83
"avidia - Lisa Business",,C,,07/20/2015,"CAVICCHIO GREENHOUSES","Lisa Business : Cost of Goods Sold","Lisa Business","Cost of Goods Sold","POS PURCHASE MERCHANT PURCHASE TERMINAL 432300 CAVICCHIO GREENHOU SES   SUDBURY   MA XXXXXXXXXXXX3758 07-17-15",$130.16,$0.00,$6240.67
"avidia - Lisa Business",,C,,07/24/2015,"Deposit","Income : Available this month","Income","Available this month",,$0.00,$1401.91,$7642.58
"avidia - Lisa Business",,C,,08/03/2015,"DAVIDIAN BROTHERS FARM","Lisa Business : Cost of Goods Sold","Lisa Business","Cost of Goods Sold","POS PURCHASE MERCHANT PURCHASE TERMINAL 407105 DAVIDIAN BROTHERS FARM  NORTHBORO MA XXXXXXXXXXXX3758 07-30-15",$52.59,$0.00,$7589.99
"avidia - Lisa Business",,C,,08/06/2015,"Deposit","Income : Available this month","Income","Available this month",,$0.00,$1828.16,$9418.15
"avidia - Lisa Business",,C,,08/10/2015,"CAVICCHIO GREENHOUSES","Lisa Business : Cost of Goods Sold","Lisa Business","Cost of Goods Sold","",$25.50,$0.00,$9392.65
"avidia - Lisa Business",,C,,08/10/2015,"Trombetta","Lisa Business : Cost of Goods Sold","Lisa Business","Cost of Goods Sold","",$35.03,$0.00,$9357.62
"avidia - Lisa Business",,C,,08/10/2015,"Transfer : Avidia Checking",,,,"",$7000.00,$0.00,$2357.62
"avidia - Lisa Business",,C,,08/13/2015,"Transfer : Avidia Checking",,,,"",$1300.00,$0.00,$1057.62
"avidia - Lisa Business",,C,,08/14/2015,"Deposit","Income : Available this month","Income","Available this month","",$0.00,$996.94,$2054.56
"avidia - Lisa Business",,C,,08/17/2015,"Ocean State Joblot","Lisa Business : Supplies Hardware","Lisa Business","Supplies Hardware","",$8.22,$0.00,$2046.34
"avidia - Lisa Business",,C,,08/18/2015,"Grow Native","Lisa Business : Cost of Goods Sold","Lisa Business","Cost of Goods Sold","",$25.00,$0.00,$2021.34
"avidia - Lisa Business",,C,,08/18/2015,"Farm Insurance","Lisa Business : Insurance","Lisa Business","Insurance",,$453.75,$0.00,$1567.59
"avidia - Lisa Business",,C,,08/24/2015,"Kittery Trading Post","Lisa Business : Business expenses","Lisa Business","Business expenses","",$26.36,$0.00,$1541.23
"avidia - Lisa Business",,C,,08/25/2015,"Deposit","Income : Available this month","Income","Available this month","",$0.00,$380.00,$1921.23
"avidia - Lisa Business",,C,,09/01/2015,"Farm Insurance","Lisa Business : Insurance","Lisa Business","Insurance","",$218.50,$0.00,$1702.73
"avidia - Lisa Business",,C,,09/03/2015,"Deposit","Income : Available this month","Income","Available this month","",$0.00,$1528.00,$3230.73
"avidia - Lisa Business",,C,1072,09/03/2015,"Carol klos","Lisa Business : Contract Work","Lisa Business","Contract Work","",$200.00,$0.00,$3030.73
"avidia - Lisa Business",,C,,09/09/2015,"Transfer : Avidia Checking",,,,"",$1000.00,$0.00,$2030.73
"avidia - Lisa Business",,U,,09/11/2015,"Deposit","Income : Available this month","Income","Available this month","",$0.00,$1050.00,$3080.73
"avidia - Lisa Business",,U,,09/11/2015,"Rocky's Hardware","Lisa Business : Business expenses","Lisa Business","Business expenses","",$18.02,$0.00,$3062.71
"avidia - Lisa Business",,U,1073,09/11/2015,"Colonial Garden club","Lisa Business : Fees","Lisa Business","Fees","",$25.00,$0.00,$3037.71
"avidia - Lisa Business",,U,,09/14/2015,"Deposit","Income : Available this month","Income","Available this month","",$0.00,$750.00,$3787.71
"avidia - Lisa Business",,U,,09/14/2015,"BIGELOW NURSERIES  INC","Lisa Business : Cost of Goods Sold","Lisa Business","Cost of Goods Sold","",$71.20,$0.00,$3716.51
"avidia - Lisa Business",,U,1075,09/14/2015,"Common Wealth Ma","Income Tax : Estimated","Hidden Categories","Income Tax ` Estimated","",$400.00,$0.00,$3316.51
"avidia - Lisa Business",,U,1074,09/14/2015,"United States treasury","Income Tax : Estimated","Hidden Categories","Income Tax ` Estimated","",$1500.00,$0.00,$1816.51
"avidia - Lisa Business",,U,,09/24/2015,"Deposit","Income : Available this month","Income","Available this month","",$0.00,$302.50,$2119.01
"avidia - Lisa Business",,U,,09/28/2015,"Deposit","Income : Available this month","Income","Available this month","",$0.00,$660.00,$2779.01
"avidia - Lisa Business",,U,,10/01/2015,"BIGELOW NURSERIES  INC","Lisa Business : Cost of Goods Sold","Lisa Business","Cost of Goods Sold","",$170.62,$0.00,$2608.39
"avidia - Lisa Business",,C,,10/01/2015,"Transfer : Avidia Checking",,,,"",$1000.00,$0.00,$1608.39
"avidia - Lisa Business",,U,,10/02/2015,"Deposit","Income : Available this month","Income","Available this month","",$0.00,$240.00,$1848.39
"avidia - Lisa Business",,U,,10/05/2015,"CAVICCHIO GREENHOUSES","Lisa Business : Cost of Goods Sold","Lisa Business","Cost of Goods Sold","",$130.95,$0.00,$1717.44
"avidia - Lisa Business",,U,,10/06/2015,"Deposit","Income : Available this month","Income","Available this month","",$0.00,$800.00,$2517.44
"avidia - Lisa Business",,U,,10/06/2015,"Rocky's Hardware","Lisa Business : Business expenses","Lisa Business","Business expenses","",$38.19,$0.00,$2479.25
"avidia - Lisa Business",,U,,10/09/2015,"Deposit","Income : Available this month","Income","Available this month","",$0.00,$310.00,$2789.25
"avidia - Lisa Business",,U,,10/14/2015,"Officemax","Lisa Business : Office supplies","Lisa Business","Office supplies","",$8.49,$0.00,$2780.76
"avidia - Lisa Business",,U,,10/16/2015,"Deposit","Income : Available this month","Income","Available this month","",$0.00,$702.50,$3483.26
"avidia - Lisa Business",,U,,10/19/2015,"Transfer : Avidia Checking",,,,"",$3000.00,$0.00,$483.26
"avidia - Lisa Business",,U,,10/21/2015,"Grow Native","Lisa Business : Cost of Goods Sold","Lisa Business","Cost of Goods Sold","",$15.00,$0.00,$468.26
"avidia - Lisa Business",,U,,10/21/2015,"CAVICCHIO GREENHOUSES","Lisa Business : Cost of Goods Sold","Lisa Business","Cost of Goods Sold","",$48.34,$0.00,$419.92
"avidia - Lisa Business",,U,,10/27/2015,"russells garden center","Lisa Business : Cost of Goods Sold","Lisa Business","Cost of Goods Sold","",$49.28,$0.00,$370.64
"avidia - Lisa Business",,U,,10/29/2015,"Deposit","Income : Available this month","Income","Available this month","",$0.00,$1360.00,$1730.64
"avidia - Lisa Business",,U,,10/29/2015,"CAVICCHIO GREENHOUSES","Lisa Business : Cost of Goods Sold","Lisa Business","Cost of Goods Sold","",$113.16,$0.00,$1617.48
"avidia - Lisa Business",,U,,10/30/2015,"Deposit","Income : Available this month","Income","Available this month","",$0.00,$200.00,$1817.48
"avidia - Lisa Business",,U,,11/06/2015,"Deposit","Income : Available this month","Income","Available this month","",$0.00,$515.00,$2332.48
"avidia - Lisa Business",,U,,11/09/2015,"Home Depot","Lisa Business : Supplies","Lisa Business","Supplies","",$5.99,$0.00,$2326.49
"avidia - Lisa Business",,U,,11/12/2015,"Home Depot","Lisa Business : Supplies","Lisa Business","Supplies","",$117.83,$0.00,$2208.66
"avidia - Lisa Business",,U,,11/12/2015,"FARM FAMILY","Lisa Business : Insurance","Lisa Business","Insurance","",$342.50,$0.00,$1866.16
"avidia - Lisa Business",,U,,11/13/2015,"Deposit","Income : Available this month","Income","Available this month","",$0.00,$833.00,$2699.16
"avidia - Lisa Business",,U,,11/13/2015,"Grow Native","Lisa Business : Cost of Goods Sold","Lisa Business","Cost of Goods Sold","",$50.00,$0.00,$2649.16
"avidia - Lisa Business",,U,,11/13/2015,"CAVICCHIO GREENHOUSES","Lisa Business : Cost of Goods Sold","Lisa Business","Cost of Goods Sold","",$55.25,$0.00,$2593.91
"avidia - Lisa Business",,U,,11/16/2015,"Lowe's of Hudson","Lisa Business : Business expenses","Lisa Business","Business expenses","",$51.94,$0.00,$2541.97
"avidia - Lisa Business",,U,,11/17/2015,"Home Depot","Lisa Business : Supplies","Lisa Business","Supplies","",$0.00,$83.09,$2625.06
"avidia - Lisa Business",,U,,11/19/2015,"Deposit","Income : Available this month","Income","Available this month","",$0.00,$905.00,$3530.06
"avidia - Lisa Business",,U,,11/23/2015,"Lowe's of Hudson","Lisa Business : Business expenses","Lisa Business","Business expenses","",$0.00,$16.92,$3546.98
"avidia - Lisa Business",,U,,11/23/2015,"Transfer : Avidia Checking",,,,"",$3000.00,$0.00,$546.98
"avidia - Lisa Business",,U,,12/03/2015,"Oriigina Pizza","Food : Restaurants","Food","Restaurants","",$4.80,$0.00,$542.18
"avidia - Lisa Business",,U,,12/04/2015,"Deposit","Income : Available this month","Income","Available this month","",$0.00,$160.00,$702.18
"avidia - Lisa Business",,U,,12/04/2015,"boston cnv","Lisa Business : Business expenses","Lisa Business","Business expenses","",$11.50,$0.00,$690.68
"avidia - Lisa Business",,U,,12/04/2015,"parlking","Transportation : Parking","Transportation","Parking","",$15.00,$0.00,$675.68
"avidia - Lisa Business",,U,,12/07/2015,"walgreens","Lisa Business : Business expenses","Lisa Business","Business expenses","",$25.48,$0.00,$650.20
"avidia - Lisa Business",,U,,12/09/2015,"walgreens","Lisa Business : Business expenses","Lisa Business","Business expenses","",$4.23,$0.00,$645.97
"avidia - Lisa Business",,U,,12/10/2015,"Deposit","Income : Available this month","Income","Available this month","",$0.00,$490.00,$1135.97
"avidia - Lisa Business",,U,,12/11/2015,"Transfer : Avidia-AlyssaAccount",,,,"",$1000.00,$0.00,$135.97
"avidia - Lisa Business",,U,,12/28/2015,"Deposit","Income : Available this month","Income","Available this month","",$0.00,$521.00,$656.97
"avidia - Lisa Business",,U,,01/20/2016,"Transfer : Avidia Checking",,,,"",$500.00,$0.00,$156.97
"avidia - Lisa Business",,U,1076,01/22/2016,"Nofa","Lisa Business : Fees","Lisa Business","Fees","",$40.00,$0.00,$116.97
"avidia - Lisa Business",,U,,01/25/2016,"Home Depot","Lisa Business : Supplies","Lisa Business","Supplies","",$10.50,$0.00,$106.47
"avidia - Lisa Business",,U,,04/08/2016,"city of cambridge","Lisa Business : Parking","Lisa Business","Parking","",$2.00,$0.00,$104.47
"avidia - Lisa Business",,U,,04/11/2016,"FARM FAMILY","Lisa Business : Insurance","Lisa Business","Insurance","",$53.50,$0.00,$50.97
"avidia - Lisa Business",,U,,04/12/2016,"CAVICCHIO GREENHOUSES","Lisa Business : Cost of Goods Sold","Lisa Business","Cost of Goods Sold","",$26.56,$0.00,$24.41
"avidia - Lisa Business",,U,,04/14/2016,"Transfer : Avidia Checking",,,,"",$0.00,$500.00,$524.41
"avidia - Lisa Business",,U,,04/15/2016,"Cornerstone Supply","Lisa Business : Cost of Goods Sold","Lisa Business","Cost of Goods Sold","",$257.62,$0.00,$266.79
"avidia - Lisa Business",,U,,04/18/2016,"Amazon","Lisa Business : Supplies","Lisa Business","Supplies","",$36.69,$0.00,$230.10
"avidia - Lisa Business",,U,,04/20/2016,"Home Depot","Lisa Business : Supplies","Lisa Business","Supplies","",$66.59,$0.00,$163.51
"avidia - Lisa Business",,U,,04/25/2016,"Transfer : Avidia Checking",,,,"",$0.00,$1500.00,$1663.51
"avidia - Lisa Business",,U,,04/25/2016,"ROBINSON S HARDWAR","Lisa Business : Cost of Goods Sold","Lisa Business","Cost of Goods Sold","",$37.67,$0.00,$1625.84
"avidia - Lisa Business",,U,,04/26/2016,"Deposit","Lisa Business : Income","Lisa Business","Income","",$0.00,$120.00,$1745.84
"avidia - Lisa Business",,U,,04/26/2016,"CAVICCHIO GREENHOUSES","Lisa Business : Cost of Goods Sold","Lisa Business","Cost of Goods Sold","",$68.03,$0.00,$1677.81
"avidia - Lisa Business",,U,,04/28/2016,"Trombetta","Lisa Business : Cost of Goods Sold","Lisa Business","Cost of Goods Sold","",$19.10,$0.00,$1658.71
"avidia - Lisa Business",,U,,04/29/2016,"Lowe's of Hudson","Lisa Business : Supplies","Lisa Business","Supplies","",$19.95,$0.00,$1638.76
"avidia - Lisa Business",,U,,04/29/2016,"Panera Bread","Food : Restaurants","Food","Restaurants","",$24.61,$0.00,$1614.15
"avidia - Lisa Business",,U,,05/02/2016,"Amazon","Lisa Business : Supplies","Lisa Business","Supplies","",$28.39,$0.00,$1585.76
"avidia - Lisa Business",,U,,05/03/2016,"Deposit","Lisa Business : Income","Lisa Business","Income","Business Income",$0.00,$483.00,$2068.76
"avidia - Lisa Business",,U,,05/04/2016,"CAVICCHIO GREENHOUSES","Lisa Business : Cost of Goods Sold","Lisa Business","Cost of Goods Sold","",$202.94,$0.00,$1865.82
"avidia - Lisa Business",,U,,05/04/2016,"BIGELOW NURSERIES  INC","Lisa Business : Cost of Goods Sold","Lisa Business","Cost of Goods Sold","",$323.00,$0.00,$1542.82
"avidia - Lisa Business",,U,,05/06/2016,"city of cambridge","Lisa Business : Parking","Lisa Business","Parking","",$2.00,$0.00,$1540.82
"avidia - Lisa Business",,U,,05/06/2016,"CAVICCHIO GREENHOUSES","Lisa Business : Cost of Goods Sold","Lisa Business","Cost of Goods Sold","",$127.50,$0.00,$1413.32
"avidia - Lisa Business",,U,,05/10/2016,"CAVICCHIO GREENHOUSES","Lisa Business : Cost of Goods Sold","Lisa Business","Cost of Goods Sold","",$26.56,$0.00,$1386.76
"avidia - Lisa Business",,U,1082,05/10/2016,"Home Depot","Lisa Business : Supplies","Lisa Business","Supplies","",$138.31,$0.00,$1248.45
"avidia - Lisa Business",,U,,05/10/2016,"CAVICCHIO GREENHOUSES","Lisa Business : Cost of Goods Sold","Lisa Business","Cost of Goods Sold","",$201.72,$0.00,$1046.73
"avidia - Lisa Business",,U,,05/11/2016,"CAVICCHIO GREENHOUSES","Lisa Business : Cost of Goods Sold","Lisa Business","Cost of Goods Sold","",$187.00,$0.00,$859.73
"avidia - Lisa Business",,U,,05/13/2016,"Hopkinton lumber","Lisa Business : Supplies","Lisa Business","Supplies","",$4.87,$0.00,$854.86
"avidia - Lisa Business",,U,,05/13/2016,"Lowe's of Hudson","Lisa Business : Supplies","Lisa Business","Supplies","",$38.17,$0.00,$816.69
"avidia - Lisa Business",,U,,05/13/2016,"CAVICCHIO GREENHOUSES","Lisa Business : Cost of Goods Sold","Lisa Business","Cost of Goods Sold","",$89.25,$0.00,$727.44
"avidia - Lisa Business",,U,,05/17/2016,"CAVICCHIO GREENHOUSES","Lisa Business : Cost of Goods Sold","Lisa Business","Cost of Goods Sold","",$196.30,$0.00,$531.14
"avidia - Lisa Business",,U,1083,05/18/2016,"WFCF","Lisa Business : Cost of Goods Sold","Lisa Business","Cost of Goods Sold","",$95.00,$0.00,$436.14
"avidia - Lisa Business",,U,,05/19/2016,"Deposit","Lisa Business : Income","Lisa Business","Income","",$0.00,$1237.00,$1673.14
"avidia - Lisa Business",,U,,05/24/2016,"CAVICCHIO GREENHOUSES","Lisa Business : Cost of Goods Sold","Lisa Business","Cost of Goods Sold","",$131.75,$0.00,$1541.39
"avidia - Lisa Business",,U,,05/25/2016,"russells garden center","Lisa Business : Cost of Goods Sold","Lisa Business","Cost of Goods Sold","",$36.10,$0.00,$1505.29
"avidia - Lisa Business",,U,,05/26/2016,"CAVICCHIO GREENHOUSES","Lisa Business : Cost of Goods Sold","Lisa Business","Cost of Goods Sold","",$64.28,$0.00,$1441.01
"avidia - Lisa Business",,U,,06/01/2016,"russells garden center","Lisa Business : Cost of Goods Sold","Lisa Business","Cost of Goods Sold",,$70.78,$0.00,$1370.23
"avidia - Lisa Business",,U,,06/03/2016,"Deposit","Lisa Business : Income","Lisa Business","Income","",$0.00,$842.50,$2212.73
"avidia - Lisa Business",,U,,06/03/2016,"Angels Garden Center","Lisa Business : Cost of Goods Sold","Lisa Business","Cost of Goods Sold","",$35.03,$0.00,$2177.70
"avidia - Lisa Business",,U,,06/03/2016,"lamberts flowers","Lisa Business : Cost of Goods Sold","Lisa Business","Cost of Goods Sold","",$38.34,$0.00,$2139.36
"avidia - Lisa Business",,U,,06/03/2016,"Lowe's of Hudson","Lisa Business : Supplies","Lisa Business","Supplies","",$40.16,$0.00,$2099.20
"avidia - Lisa Business",,U,,06/07/2016,"CAVICCHIO GREENHOUSES","Lisa Business : Cost of Goods Sold","Lisa Business","Cost of Goods Sold","",$123.36,$0.00,$1975.84
"avidia - Lisa Business",,U,,06/09/2016,"BIGELOW NURSERIES  INC","Lisa Business : Cost of Goods Sold","Lisa Business","Cost of Goods Sold","",$31.88,$0.00,$1943.96
"avidia - Lisa Business",,U,,06/09/2016,"BIGELOW NURSERIES  INC","Lisa Business : Cost of Goods Sold","Lisa Business","Cost of Goods Sold","",$42.50,$0.00,$1901.46
"avidia - Lisa Business",,U,,06/10/2016,"Deposit","Lisa Business : Income","Lisa Business","Income","",$0.00,$2728.39,$4629.85
"avidia - Lisa Business",,U,,06/14/2016,"MASS FARM BUREAU","Lisa Business : Insurance","Lisa Business","Insurance","",$60.00,$0.00,$4569.85
"avidia - Lisa Business",,U,,06/14/2016,"CAVICCHIO GREENHOUSES","Lisa Business : Cost of Goods Sold","Lisa Business","Cost of Goods Sold","",$118.58,$0.00,$4451.27
"avidia - Lisa Business",,U,,06/14/2016,"Transfer : Avidia Checking",,,,"",$2000.00,$0.00,$2451.27
"avidia - Lisa Business",,U,,06/21/2016,"Deposit","Lisa Business : Income","Lisa Business","Income","",$0.00,$1239.00,$3690.27
"avidia - Lisa Business",,U,,06/21/2016,"CAVICCHIO GREENHOUSES","Lisa Business : Cost of Goods Sold","Lisa Business","Cost of Goods Sold","",$70.13,$0.00,$3620.14
"avidia - Lisa Business",,U,,06/21/2016,"CAVICCHIO GREENHOUSES","Lisa Business : Cost of Goods Sold","Lisa Business","Cost of Goods Sold","",$109.01,$0.00,$3511.13
"avidia - Lisa Business",,U,,06/22/2016,"wd env mass","Lisa Business : Misc","Lisa Business","Misc","",$25.00,$0.00,$3486.13
"avidia - Lisa Business",,U,,06/24/2016,"New England Wildflower Society","Lisa Business : Fees","Lisa Business","Fees","",$40.00,$0.00,$3446.13
"avidia - Lisa Business",,U,,06/24/2016,"Tower hill botanic","Lisa Business : Fees","Lisa Business","Fees","",$55.00,$0.00,$3391.13
"avidia - Lisa Business",,U,,06/27/2016,"FARM FAMILY","Lisa Business : Insurance","Lisa Business","Insurance","",$250.00,$0.00,$3141.13
"avidia - Lisa Business",,U,,06/29/2016,"Mahoney's Gardend Center","Lisa Business : Cost of Goods Sold","Lisa Business","Cost of Goods Sold","",$31.85,$0.00,$3109.28
"avidia - Lisa Business",,U,,07/01/2016,"Deposit","Lisa Business : Income","Lisa Business","Income","",$0.00,$1200.00,$4309.28
"avidia - Lisa Business",,U,,07/01/2016,"FARM FAMILY","Lisa Business : Insurance","Lisa Business","Insurance",,$355.00,$0.00,$3954.28
"avidia - Lisa Business",,U,,07/05/2016,"Deposit","Lisa Business : Income","Lisa Business","Income","",$0.00,$2205.00,$6159.28
"avidia - Lisa Business",,U,,07/05/2016,"ROBINSON S HARDWAR","Lisa Business : Cost of Goods Sold","Lisa Business","Cost of Goods Sold","",$13.23,$0.00,$6146.05
"avidia - Lisa Business",,U,,07/08/2016,"Deposit","Lisa Business : Income","Lisa Business","Income","",$0.00,$1315.00,$7461.05
"avidia - Lisa Business",,U,,07/12/2016,"CAVICCHIO GREENHOUSES","Lisa Business : Cost of Goods Sold","Lisa Business","Cost of Goods Sold","",$18.59,$0.00,$7442.46
"avidia - Lisa Business",,U,1085,07/12/2016,"Carol klos","Lisa Business : Contract Work","Lisa Business","Contract Work",,$275.00,$0.00,$7167.46
"avidia - Lisa Business",,U,1087,07/13/2016,"Neurological Services","Personal : Doctor, Dentist","Personal","Doctor, Dentist","",$35.00,$0.00,$7132.46
"avidia - Lisa Business",,U,1086,07/13/2016,"city of marlboro","Lisa Business : Misc","Lisa Business","Misc","",$50.00,$0.00,$7082.46
"avidia - Lisa Business",,U,,07/13/2016,"CAVICCHIO GREENHOUSES","Lisa Business : Cost of Goods Sold","Lisa Business","Cost of Goods Sold","",$64.55,$0.00,$7017.91
"avidia - Lisa Business",,U,,07/15/2016,"Deposit","Lisa Business : Income","Lisa Business","Income","",$0.00,$1375.00,$8392.91
"avidia - Lisa Business",,U,,07/19/2016,"CAVICCHIO GREENHOUSES","Lisa Business : Cost of Goods Sold","Lisa Business","Cost of Goods Sold","",$131.56,$0.00,$8261.35
"avidia - Lisa Business",,U,,07/20/2016,"Godaddy","Lisa Business : Advertizing","Lisa Business","Advertizing","",$15.17,$0.00,$8246.18
"avidia - Lisa Business",,U,,07/21/2016,"CAVICCHIO GREENHOUSES","Lisa Business : Cost of Goods Sold","Lisa Business","Cost of Goods Sold","",$21.00,$0.00,$8225.18
"avidia - Lisa Business",,U,,07/21/2016,"CAVICCHIO GREENHOUSES","Lisa Business : Cost of Goods Sold","Lisa Business","Cost of Goods Sold","",$29.54,$0.00,$8195.64
"avidia - Lisa Business",,U,,07/22/2016,"Deposit","Lisa Business : Income","Lisa Business","Income","",$0.00,$500.00,$8695.64
"avidia - Lisa Business",,U,,07/26/2016,"CAVICCHIO GREENHOUSES","Lisa Business : Cost of Goods Sold","Lisa Business","Cost of Goods Sold","",$106.04,$0.00,$8589.60
"avidia - Lisa Business",,U,,07/29/2016,"Deposit","Lisa Business : Income","Lisa Business","Income","",$0.00,$220.00,$8809.60
"avidia - Lisa Business",,U,,07/29/2016,"monnick home supplies","Lisa Business : Supplies","Lisa Business","Supplies","",$21.74,$0.00,$8787.86
"avidia - Lisa Business",,U,,08/01/2016,"Transfer : Avidia Checking",,,,"",$3000.00,$0.00,$5787.86
"avidia - Lisa Business",,U,,08/04/2016,"CAVICCHIO GREENHOUSES","Lisa Business : Cost of Goods Sold","Lisa Business","Cost of Goods Sold","",$203.97,$0.00,$5583.89
"avidia - Lisa Business",,U,,08/09/2016,"CAVICCHIO GREENHOUSES","Lisa Business : Cost of Goods Sold","Lisa Business","Cost of Goods Sold","",$54.08,$0.00,$5529.81
"avidia - Lisa Business",,U,,08/11/2016,"Trombetta","Lisa Business : Cost of Goods Sold","Lisa Business","Cost of Goods Sold","",$5.30,$0.00,$5524.51
"avidia - Lisa Business",,U,,08/12/2016,"Deposit","Lisa Business : Income","Lisa Business","Income","",$0.00,$280.00,$5804.51
"avidia - Lisa Business",,U,,08/18/2016,"Transfer : Dcu Checking",,,,"",$5000.00,$0.00,$804.51
"avidia - Lisa Business",,U,,08/23/2016,"CAVICCHIO GREENHOUSES","Lisa Business : Cost of Goods Sold","Lisa Business","Cost of Goods Sold","",$50.89,$0.00,$753.62
"avidia - Lisa Business",,U,,08/26/2016,"income","Lisa Business : Income","Lisa Business","Income","",$0.00,$410.00,$1163.62
"avidia - Lisa Business",,U,1088,08/29/2016,"Carol klos","Lisa Business : Contract Work","Lisa Business","Contract Work",,$300.00,$0.00,$863.62
"avidia - Lisa Business",,U,,09/06/2016,"income","Lisa Business : Income","Lisa Business","Income","",$0.00,$280.00,$1143.62
"avidia - Lisa Business",,U,,09/08/2016,"income","Lisa Business : Income","Lisa Business","Income","",$0.00,$1547.00,$2690.62
"avidia - Lisa Business",,U,,09/12/2016,"income","Lisa Business : Income","Lisa Business","Income","",$0.00,$20.00,$2710.62
"avidia - Lisa Business",,U,,09/13/2016,"CAVICCHIO GREENHOUSES","Lisa Business : Cost of Goods Sold","Lisa Business","Cost of Goods Sold","",$14.77,$0.00,$2695.85
"avidia - Lisa Business",,U,,09/16/2016,"income","Lisa Business : Income","Lisa Business","Income","",$0.00,$948.00,$3643.85
"avidia - Lisa Business",,U,,09/21/2016,"income","Lisa Business : Income","Lisa Business","Income","",$0.00,$630.00,$4273.85
"avidia - Lisa Business",,U,,09/21/2016,"CAVICCHIO GREENHOUSES","Lisa Business : Cost of Goods Sold","Lisa Business","Cost of Goods Sold","",$57.91,$0.00,$4215.94
"avidia - Lisa Business",,U,,09/27/2016,"CAVICCHIO GREENHOUSES","Lisa Business : Cost of Goods Sold","Lisa Business","Cost of Goods Sold","",$168.57,$0.00,$4047.37
"avidia - Lisa Business",,U,,09/27/2016,"CAVICCHIO GREENHOUSES","Lisa Business : Cost of Goods Sold","Lisa Business","Cost of Goods Sold","",$319.81,$0.00,$3727.56
"avidia - Lisa Business",,U,1089,10/04/2016,"Carol klos","Lisa Business : Contract Work","Lisa Business","Contract Work","",$500.00,$0.00,$3227.56
"avidia - Lisa Business",,U,1090,10/06/2016,"Transfer : Dcu Checking",,,,"",$3000.00,$0.00,$227.56
"avidia - Lisa Business",,U,,10/07/2016,"CAVICCHIO GREENHOUSES","Lisa Business : Cost of Goods Sold","Lisa Business","Cost of Goods Sold","",$98.28,$0.00,$129.28
"avidia - Lisa Business",,U,,10/13/2016,"income","Lisa Business : Income","Lisa Business","Income","",$0.00,$2777.13,$2906.41
"avidia - Lisa Business",,U,1091,10/13/2016,"FARM FAMILY","Lisa Business : Insurance","Lisa Business","Insurance","",$18.50,$0.00,$2887.91
"avidia - Lisa Business",,U,,10/20/2016,"income","Lisa Business : Income","Lisa Business","Income","",$0.00,$1602.50,$4490.41
"avidia - Lisa Business",,U,1092,10/20/2016,"Colonial Garden club","Lisa Business : Fees","Lisa Business","Fees","",$25.00,$0.00,$4465.41
"avidia - Lisa Business",,U,,10/26/2016,"russells garden center","Lisa Business : Cost of Goods Sold","Lisa Business","Cost of Goods Sold","",$8.50,$0.00,$4456.91
"avidia - Lisa Business",,U,,10/27/2016,"CAVICCHIO GREENHOUSES","Lisa Business : Cost of Goods Sold","Lisa Business","Cost of Goods Sold","",$59.93,$0.00,$4396.98
"avidia - Lisa Business",,U,,11/02/2016,"Farm Insurance","Lisa Business : Insurance","Lisa Business","Insurance","",$0.00,$651.00,$5047.98
"avidia - Lisa Business",,U,,11/02/2016,"cape cod nursery?","Lisa Business : Cost of Goods Sold","Lisa Business","Cost of Goods Sold","",$12.73,$0.00,$5035.25
"avidia - Lisa Business",,U,,11/08/2016,"income","Lisa Business : Income","Lisa Business","Income","",$0.00,$935.00,$5970.25
"avidia - Lisa Business",,U,,11/14/2016,"Grow Native","Lisa Business : Fees","Lisa Business","Fees","",$25.00,$0.00,$5945.25
"avidia - Lisa Business",,U,1094,11/14/2016,"Kate Pullano","Lisa Business : Contract Work","Lisa Business","Contract Work","",$200.00,$0.00,$5745.25
"avidia - Lisa Business",,U,1095,11/14/2016,"Martha Ludlum","Lisa Business : Contract Work","Lisa Business","Contract Work","",$225.00,$0.00,$5520.25
"avidia - Lisa Business",,U,1098,11/21/2016,"Karina Mattei","Recreation : Vacation","Recreation","Vacation","Room thanksgiving",$80.00,$0.00,$5440.25
"avidia - Lisa Business",,U,1096,11/25/2016,"Anna Mattei","Food : Groceries","Food","Groceries","Food Thanksgiving",$90.00,$0.00,$5350.25
"avidia - Lisa Business",,U,,11/28/2016,"income","Lisa Business : Income","Lisa Business","Income","",$0.00,$1480.00,$6830.25
"avidia - Lisa Business",,U,,11/28/2016,"income","Lisa Business : Income","Lisa Business","Income","",$0.00,$125.00,$6955.25
"avidia - Lisa Business",,U,,11/28/2016,"Transfer : Lisa Cash Account",,,,"",$6955.25,$0.00,$0.00
"Lisa Cash Account",,C,,06/10/2013,"Starting Balance","Income : Available this month","Income","Available this month",,$0.00,$0.00,$0.00
"Lisa Cash Account",,U,,07/05/2013,"Transfer : Avidia Checking",,,,"",$0.00,$50.00,$50.00
"Lisa Cash Account",,U,,07/06/2013,"jb iicks","Food : Restaurants","Food","Restaurants","",$30.00,$0.00,$20.00
"Lisa Cash Account",,U,,07/24/2013,"Transfer : Avidia Checking",,,,"",$0.00,$80.00,$100.00
"Lisa Cash Account",,U,,08/14/2013,"Transfer : Avidia Checking",,,,"",$0.00,$100.00,$200.00
"Lisa Cash Account",,U,,09/16/2013,"Transfer : Avidia Checking",,,,"",$0.00,$50.00,$250.00
"Lisa Cash Account",,U,,09/20/2013,"Transfer : Avidia Checking",,,,"",$0.00,$50.00,$300.00
"Lisa Cash Account",,U,,02/06/2014,"Transfer : Avidia Checking",,,,"",$0.00,$100.00,$400.00
"Lisa Cash Account",,U,,02/20/2014,"Transfer : Avidia Checking",,,,"",$0.00,$50.00,$450.00
"Lisa Cash Account",,U,,02/26/2014,"Transfer : Avidia Checking",,,,"",$0.00,$50.00,$500.00
"Lisa Cash Account",,U,,03/12/2014,"Transfer : Avidia Checking",,,,"",$0.00,$50.00,$550.00
"Lisa Cash Account",,U,,05/20/2014,"Transfer : Avidia Checking",,,,"",$0.00,$100.00,$650.00
"Lisa Cash Account",,U,,06/02/2014,"Transfer : Avidia Checking",,,,"",$0.00,$200.00,$850.00
"Lisa Cash Account",,U,,06/02/2014,"Transfer : Avidia Checking",,,,"",$0.00,$80.00,$930.00
"Lisa Cash Account",,U,,06/16/2014,"Transfer : Avidia Checking",,,,"",$0.00,$50.00,$980.00
"Lisa Cash Account",,U,,06/30/2014,"","Food : Restaurants","Food","Restaurants","",$100.00,$0.00,$880.00
"Lisa Cash Account",,U,,07/30/2014,"","Recreation : Hers","Recreation","Hers","",$100.00,$0.00,$780.00
"Lisa Cash Account",,U,,07/30/2014,"","Food : Restaurants","Food","Restaurants","",$200.00,$0.00,$580.00
"Lisa Cash Account",,U,,07/30/2014,,"Recreation : Alyssa","Recreation","Alyssa","",$200.00,$0.00,$380.00
"Lisa Cash Account",,U,,08/05/2014,"","Food : Restaurants","Food","Restaurants","",$200.00,$0.00,$180.00
"Lisa Cash Account",,U,,08/07/2014,,"Recreation : Entertainment","Recreation","Entertainment","",$180.00,$0.00,$0.00
"Lisa Cash Account",,U,,08/19/2014,"Transfer : Avidia Checking",,,,"",$0.00,$300.00,$300.00
"Lisa Cash Account",,U,,08/20/2014,"Hector","Recreation : Alyssa","Recreation","Alyssa","Mask making",$225.00,$0.00,$75.00
"Lisa Cash Account",,U,,09/09/2014,"Transfer : Avidia Checking",,,,"",$0.00,$100.00,$175.00
"Lisa Cash Account",,U,,09/15/2014,"Transfer : Avidia Checking",,,,"",$0.00,$100.00,$275.00
"Lisa Cash Account",,U,,11/30/2014,"Transfer : Robert Cash Account",,,,"",$0.00,$100.00,$375.00
"Lisa Cash Account",,U,,11/30/2014,"","Food : Restaurants","Food","Restaurants","",$145.00,$0.00,$230.00
"Lisa Cash Account",,U,,11/30/2014,,"Recreation : Hers","Recreation","Hers","",$148.00,$0.00,$82.00
"Lisa Cash Account",,U,,02/10/2015,"Transfer : Avidia Checking",,,,"",$0.00,$100.00,$182.00
"Lisa Cash Account",,U,,03/30/2015,"Transfer : Avidia Checking",,,,"",$0.00,$100.00,$282.00
"Lisa Cash Account",,U,,04/27/2015,"Transfer : Avidia Checking",,,,"",$0.00,$50.00,$332.00
"Lisa Cash Account",,U,,05/06/2015,"Eating out","Food : Restaurants","Food","Restaurants","",$150.00,$0.00,$182.00
"Lisa Cash Account",,U,,06/26/2015,"Transfer : Avidia Checking",,,,"",$0.00,$100.00,$282.00
"Lisa Cash Account",,U,,07/07/2015,,"Recreation : Hers","Recreation","Hers","",$12.00,$0.00,$270.00
"Lisa Cash Account",,U,,07/07/2015,"cloths","Personal : cloths","Personal","cloths","",$120.00,$0.00,$150.00
"Lisa Cash Account",,U,,07/07/2015,"","Food : Restaurants","Food","Restaurants","",$200.00,$0.00,-$50.00
"Lisa Cash Account",,U,,07/10/2015,"Transfer : Avidia Checking",,,,"",$0.00,$100.00,$50.00
"Lisa Cash Account",,U,,07/24/2015,"","Personal : Gifts","Personal","Gifts","",$50.00,$0.00,$0.00
"Lisa Cash Account",,U,,07/24/2015,"","Housing : Supplies","Hidden Categories","Housing ` Supplies","",$100.00,$0.00,-$100.00
"Lisa Cash Account",,U,,07/29/2015,"Transfer : Avidia Checking",,,,"",$0.00,$100.00,$0.00
"Lisa Cash Account",,U,,09/14/2015,"Transfer : Avidia Checking",,,,"",$0.00,$200.00,$200.00
"Lisa Cash Account",,U,,09/15/2015,"Transfer : Avidia Checking",,,,"",$0.00,$100.00,$300.00
"Lisa Cash Account",,U,,11/19/2015,"Transfer : Avidia Checking",,,,"",$0.00,$50.00,$350.00
"Lisa Cash Account",,U,,12/31/2015,"Spend Down Misc Cash","Food : Restaurants","Food","Restaurants","(Split 1/3) ",$100.00,$0.00,$0.00
"Lisa Cash Account",,U,,12/31/2015,"Spend Down Misc Cash","Lisa Business : Supplies","Lisa Business","Supplies","(Split 2/3) ",$100.00,$0.00,$0.00
"Lisa Cash Account",,U,,12/31/2015,"Spend Down Misc Cash","Recreation : Entertainment","Recreation","Entertainment","(Split 3/3) ",$150.00,$0.00,$0.00
"Lisa Cash Account",,U,,05/19/2016,"Transfer : Avidia Checking",,,,"",$0.00,$50.00,$50.00
"Lisa Cash Account",,U,,06/06/2016,"Transfer : Avidia Checking",,,,"",$0.00,$100.00,$150.00
"Lisa Cash Account",,U,,07/05/2016,"Transfer : Avidia Checking",,,,"",$0.00,$50.00,$200.00
"Lisa Cash Account",,U,,07/18/2016,"Transfer : Avidia Checking",,,,"",$0.00,$90.00,$290.00
"Lisa Cash Account",,U,,08/05/2016,"Transfer : Avidia Checking",,,,"",$0.00,$100.00,$390.00
"Lisa Cash Account",,U,,08/12/2016,"Transfer : Avidia Checking",,,,"",$0.00,$100.00,$490.00
"Lisa Cash Account",,U,,09/06/2016,"Transfer : Avidia Checking",,,,"",$0.00,$50.00,$540.00
"Lisa Cash Account",,U,,11/16/2016,"Transfer : Dcu Checking",,,,"",$6200.00,$0.00,-$5660.00
"Lisa Cash Account",,U,,11/21/2016,"Transfer : Avidia Checking",,,,"",$0.00,$500.00,-$5160.00
"Lisa Cash Account",,U,,11/28/2016,"Transfer : avidia - Lisa Business",,,,"",$0.00,$6955.25,$1795.25
"Lisa Cash Account",,U,,11/29/2016,"Transfer : Avidia Checking",,,,"",$0.00,$50.00,$1845.25
"Lisa Cash Account",,U,,12/06/2016,"Transfer : Avidia Checking",,,,"",$0.00,$2463.05,$4308.30
"Lisa Cash Account",,U,,12/09/2016,"Transfer : Dcu Checking",,,,"",$2000.00,$0.00,$2308.30
"Lisa Cash Account",,U,,12/16/2016,"Transfer : Dcu Checking",,,,"",$0.00,$200.00,$2508.30
"Lisa Cash Account",,U,,12/23/2016,"Transfer : Dcu Checking",,,,"",$0.00,$200.00,$2708.30
"Lisa Cash Account",,U,,12/30/2016,"Misc cash Spending","Food : Restaurants","Food","Restaurants","(Split 1/2) ",$2000.00,$0.00,$8.30
"Lisa Cash Account",,U,,12/30/2016,"Misc cash Spending","Recreation : Entertainment","Recreation","Entertainment","(Split 2/2) ",$700.00,$0.00,$8.30
"Lisa Cash Account",,U,,12/31/2016,"Transfer : Dcu Checking",,,,"",$0.00,$200.00,$208.30
"Lisa Cash Account",,U,,01/17/2017,"Transfer : Dcu Checking",,,,"",$0.00,$200.00,$408.30
"Lisa Cash Account",,U,,01/30/2017,"Misc  Cash Spending","Food : Restaurants","Food","Restaurants","(Split 1/2) ",$200.00,$0.00,$108.30
"Lisa Cash Account",,U,,01/30/2017,"Misc  Cash Spending","Recreation : Entertainment","Recreation","Entertainment","(Split 2/2) ",$100.00,$0.00,$108.30
"Lisa Cash Account",,U,,02/06/2017,"Transfer : Dcu Checking",,,,"",$0.00,$80.00,$188.30
"Lisa Cash Account",,U,,02/18/2017,"Transfer : Dcu Checking",,,,"",$0.00,$100.00,$288.30
"Lisa Cash Account",,U,,02/28/2017,"Misc  Cash Spending","Food : Restaurants","Food","Restaurants","(Split 1/3) ",$100.00,$0.00,$38.30
"Lisa Cash Account",,U,,02/28/2017,"Misc  Cash Spending","Recreation : Entertainment","Recreation","Entertainment","(Split 2/3) ",$100.00,$0.00,$38.30
"Lisa Cash Account",,U,,02/28/2017,"Misc  Cash Spending","Personal : Gifts","Personal","Gifts","(Split 3/3) ",$50.00,$0.00,$38.30
"Lisa Cash Account",,U,,03/04/2017,"Transfer : Dcu Checking",,,,"",$0.00,$100.00,$138.30
"Lisa Cash Account",,U,,03/14/2017,"Transfer : Dcu Checking",,,,"",$0.00,$100.00,$238.30
"Lisa Cash Account",,U,,03/22/2017,"Transfer : Dcu Checking",,,,"",$0.00,$100.00,$338.30
"Lisa Cash Account",,U,,03/30/2017,"Misc  Cash Spending","Food : Restaurants","Food","Restaurants","(Split 1/3) ",$100.00,$0.00,$8.30
"Lisa Cash Account",,U,,03/30/2017,"Misc  Cash Spending","Personal : BankCredit","Personal","BankCredit","(Split 2/3) ",$100.00,$0.00,$8.30
"Lisa Cash Account",,U,,03/30/2017,"Misc  Cash Spending","Recreation : Entertainment","Recreation","Entertainment","(Split 3/3) ",$130.00,$0.00,$8.30
"Lisa Cash Account",,U,,04/03/2017,"Transfer : Dcu Checking",,,,"",$0.00,$100.00,$108.30
"Lisa Cash Account",,U,,04/11/2017,"restaurants","Food : Restaurants","Food","Restaurants","",$103.30,$0.00,$5.00
"Lisa Cash Account",,U,,04/24/2017,"Transfer : Dcu Checking",,,,"",$0.00,$200.00,$205.00
"Lisa Cash Account",,U,,04/25/2017,"Misc  Cash Spending","Food : Restaurants","Food","Restaurants","",$150.00,$0.00,$55.00
"Lisa Cash Account",,U,,05/11/2017,"food","Food : Restaurants","Food","Restaurants","",$100.00,$0.00,-$45.00
"Lisa Cash Account",,U,,05/24/2017,"Transfer : Dcu Checking",,,,"",$0.00,$60.00,$15.00
"Lisa Cash Account",,U,,05/30/2017,"Transfer : Dcu Checking",,,,"",$0.00,$100.00,$115.00
"Lisa Cash Account",,U,,05/30/2017,"firewood","RV : Equipment/Supplies","RV","Equipment/Supplies","",$15.00,$0.00,$100.00
"Lisa Cash Account",,U,,06/04/2017,"Mexican food","Food : Restaurants","Food","Restaurants","With Rachel, Luke and Jim",$60.00,$0.00,$40.00
"Lisa Cash Account",,U,,06/05/2017,"Transfer : Dcu Checking",,,,"",$0.00,$60.00,$100.00
"Lisa Cash Account",,U,,06/11/2017,"","Food : Restaurants","Food","Restaurants","",$100.00,$0.00,$0.00
"Lisa Cash Account",,U,,06/12/2017,"Transfer : Dcu Checking",,,,"",$0.00,$60.00,$60.00
"Lisa Cash Account",,U,,06/29/2017,"Poco Piatti","Food : Restaurants","Food","Restaurants","Antonia and Marshal - we left tip",$20.00,$0.00,$40.00
"Lisa Cash Account",,U,,07/12/2017,"Transfer : Dcu Checking",,,,"",$0.00,$60.00,$100.00
"Lisa Cash Account",,U,,07/13/2017,"homeless","Charity : Other","Charity","Other","Guy on street in Madison",$4.00,$0.00,$96.00
"Lisa Cash Account",,U,,07/13/2017,"Olbrich","Recreation : Entertainment","Recreation","Entertainment","Donation whe",$5.00,$0.00,$91.00
"Lisa Cash Account",,U,,07/14/2017,"casjh jar","Recreation : Entertainment","Recreation","Entertainment","cash jar for Dan and Faith concert",$20.00,$0.00,$71.00
"Lisa Cash Account",,U,,07/15/2017,"Transfer : Dcu Checking",,,,"",$0.00,$100.00,$171.00
"Lisa Cash Account",,U,,07/15/2017,"Taco Truck","Food : Restaurants","Food","Restaurants","",$14.00,$0.00,$157.00
"Lisa Cash Account",,U,,07/15/2017,"Madison Farmers Marekt","Food : Groceries","Food","Groceries","",$25.00,$0.00,$132.00
"Lisa Cash Account",,U,,07/17/2017,"random food","Food : Restaurants","Food","Restaurants","",$100.00,$0.00,$32.00
"Lisa Cash Account",,U,,07/24/2017,"Transfer : Dcu Checking",,,,"",$0.00,$80.00,$112.00
"Lisa Cash Account",,U,,07/25/2017,"random entertinament","Recreation : Entertainment","Recreation","Entertainment","",$0.00,$55.00,$167.00
"Lisa Cash Account",,U,,07/27/2017,"gasstation medora","Transportation : Gas","Transportation","Gas","",$15.75,$0.00,$151.25
"Lisa Cash Account",,U,,07/27/2017,"mis food","Food : Restaurants","Food","Restaurants","",$80.00,$0.00,$71.25
"Lisa Cash Account",,U,,07/31/2017,"mis food","Food : Restaurants","Food","Restaurants","",$50.00,$0.00,$21.25
"Lisa Cash Account",,U,,08/07/2017,"misfood","Food : Restaurants","Food","Restaurants","",$21.25,$0.00,$0.00
"Lisa Cash Account",,U,,08/10/2017,"Transfer : Dcu Checking",,,,"",$0.00,$80.00,$80.00
"Lisa Cash Account",,U,,08/22/2017,"restaurants","Food : Restaurants","Food","Restaurants","",$20.00,$0.00,$60.00
"Lisa Cash Account",,U,,08/23/2017,"restaurants","Food : Restaurants","Food","Restaurants","",$40.00,$0.00,$20.00
"Lisa Cash Account",,U,,09/01/2017,"laundry","RV : Laundry","RV","Laundry","",$20.00,$0.00,$0.00
"Lisa Cash Account",,U,,09/02/2017,"Transfer : Dcu Checking",,,,"",$0.00,$100.00,$100.00
"Lisa Cash Account",,U,,09/02/2017,"","Food : Groceries","Food","Groceries","Farmers Market",$25.00,$0.00,$75.00
"Lisa Cash Account",,U,,09/04/2017,,"Food : Restaurants","Food","Restaurants","Pigout - spokane",$20.00,$0.00,$55.00
"Lisa Cash Account",,U,,09/11/2017,"Transfer : Dcu Checking",,,,"",$0.00,$100.00,$155.00
"Lisa Cash Account",,U,,09/15/2017,"shady firs","RV : Campgrounds","RV","Campgrounds","",$80.00,$0.00,$75.00
"Lisa Cash Account",,U,,09/18/2017,"Transfer : Dcu Checking",,,,"",$0.00,$200.00,$275.00
"Lisa Cash Account",,U,,09/23/2017,"supplies","RV : Equipment/Supplies","RV","Equipment/Supplies","",$10.00,$0.00,$265.00
"Lisa Cash Account",,U,,09/23/2017,"restaurants","Food : Restaurants","Food","Restaurants","",$100.00,$0.00,$165.00
"Lisa Cash Account",,U,,09/23/2017,"restaurants","Food : Restaurants","Food","Restaurants","",$100.00,$0.00,$65.00
"Lisa Cash Account",,U,,10/17/2017,"Transfer : Dcu Checking",,,,"",$0.00,$60.00,$125.00
"Lisa Cash Account",,U,,10/25/2017,"Uconn","Education : College","Education","College","",$0.00,$194.88,$319.88
"Lisa Cash Account",,U,,10/25/2017,"income","Income : Available next month","Income","Available next month","gift",$0.00,$50.00,$369.88
"Lisa Cash Account",,U,,10/25/2017,"","RV : Laundry","RV","Laundry","",$20.00,$0.00,$349.88
"Lisa Cash Account",,U,,10/25/2017,"","Food : Restaurants","Food","Restaurants","",$100.00,$0.00,$249.88
"Lisa Cash Account",,U,,10/27/2017,"Transfer : Dcu Checking",,,,"",$0.00,$50.00,$299.88
"Lisa Cash Account",,U,,11/15/2017,"food","Food : Restaurants","Food","Restaurants","",$150.00,$0.00,$149.88
"Lisa Cash Account",,U,,12/11/2017,"Transfer : Dcu Checking",,,,"",$0.00,$100.00,$249.88
"Lisa Cash Account",,U,,12/11/2017,,"RV : Laundry","RV","Laundry","",$20.00,$0.00,$229.88
"Lisa Cash Account",,U,,12/11/2017,"","Food : Restaurants","Food","Restaurants","Approximate",$80.00,$0.00,$149.88
"Lisa Cash Account",,U,,12/29/2017,"Transfer : Dcu Checking",,,,"",$0.00,$400.00,$549.88
"Lisa Cash Account",,U,,01/01/2018,,"Transportation : Air/train/bus/etc","Transportation","Air/train/bus/etc","tips",$30.00,$0.00,$519.88
"Lisa Cash Account",,U,,01/01/2018,"gifts","Personal : Gifts","Personal","Gifts","",$100.00,$0.00,$419.88
"Lisa Cash Account",,U,,01/01/2018,"restaurants","Food : Restaurants","Food","Restaurants","",$100.00,$0.00,$319.88
"Lisa Cash Account",,U,,01/01/2018,"","Food : Restaurants","Food","Restaurants","",$120.00,$0.00,$199.88
"Lisa Cash Account",,U,,01/03/2018,"Transfer : Dcu Checking",,,,"",$0.00,$200.00,$399.88
"Lisa Cash Account",,U,,01/14/2018,"Bob","Lisa Business : Income","Lisa Business","Income","BoB birthdya gifts Nancy Deniss carole brad",$0.00,$100.00,$499.88
"Lisa Cash Account",,U,,01/17/2018,"street folks","Charity : Other","Charity","Other","",$10.00,$0.00,$489.88
"Lisa Cash Account",,U,,01/17/2018,"laundry","RV : Laundry","RV","Laundry","",$15.00,$0.00,$474.88
"Lisa Cash Account",,U,,01/29/2018,"Kelly Matteri","Personal : Gifts","Personal","Gifts","",$100.00,$0.00,$374.88
"Lisa Cash Account",,U,,01/29/2018,"Micheals","Personal : Gifts","Personal","Gifts","",$100.00,$0.00,$274.88
"Lisa Cash Account",,U,,01/29/2018,"stephen matter","Personal : Gifts","Personal","Gifts","",$100.00,$0.00,$174.88
"Lisa Cash Account",,U,,02/10/2018,"Transfer : Dcu Checking",,,,"",$0.00,$100.00,$274.88
"Lisa Cash Account",,U,,02/14/2018,"","Recreation : Entertainment","Recreation","Entertainment","",$75.00,$0.00,$199.88
"Lisa Cash Account",,U,,02/14/2018,"food","Food : Restaurants","Food","Restaurants","",$174.88,$0.00,$25.00
"Lisa Cash Account",,U,,03/03/2018,"Transfer : Dcu Checking",,,,"",$0.00,$80.00,$105.00
"Lisa Cash Account",,U,,03/10/2018,"","Food : Restaurants","Food","Restaurants","MIsc ice cream etc",$100.00,$0.00,$5.00
"Lisa Cash Account",,U,,03/12/2018,"Transfer : Dcu Checking",,,,"",$0.00,$100.00,$105.00
"Lisa Cash Account",,U,,03/22/2018,"Transfer : Dcu Checking",,,,"",$0.00,$300.00,$405.00
"Lisa Cash Account",,U,,03/22/2018,,"Transportation : Air/train/bus/etc","Transportation","Air/train/bus/etc","to pay alyssa friend for airport pickup",$50.00,$0.00,$355.00
"Lisa Cash Account",,U,,03/22/2018,"food","Food : Restaurants","Food","Restaurants","",$50.00,$0.00,$305.00
"Lisa Cash Account",,U,,03/22/2018,"food","Food : Groceries","Food","Groceries","for Alyssa while at Marys",$150.00,$0.00,$155.00
"Lisa Cash Account",,U,,03/27/2018,,"Recreation : Entertainment","Recreation","Entertainment","",$60.00,$0.00,$95.00
"Lisa Cash Account",,U,,03/27/2018,"food","Food : Restaurants","Food","Restaurants","",$90.00,$0.00,$5.00
"Lisa Cash Account",,U,,04/02/2018,"Transfer : Dcu Checking",,,,"",$0.00,$100.00,$105.00
"Lisa Cash Account",,U,,04/23/2018,"Transfer : Dcu Checking",,,,"",$0.00,$100.00,$205.00
"Lisa Cash Account",,U,,04/23/2018,"laundry","RV : Laundry","RV","Laundry","",$10.00,$0.00,$195.00
"Lisa Cash Account",,U,,04/23/2018,"","Personal : Gifts","Personal","Gifts","",$25.00,$0.00,$170.00
"Lisa Cash Account",,U,,04/23/2018,"","Food : Restaurants","Food","Restaurants","",$100.00,$0.00,$70.00
"Lisa Cash Account",,U,,04/29/2018,"Tent Rocks","Charity : Other","Charity","Other","",$20.00,$0.00,$50.00
"Lisa Cash Account",,U,,04/30/2018,"Mary Mattei","Personal : Miscellaneous","Personal","Miscellaneous","",$0.00,$200.00,$250.00
"Lisa Cash Account",,U,,05/09/2018,"Slide rock state park","Recreation : Entertainment","Recreation","Entertainment","",$20.00,$0.00,$230.00
"Lisa Cash Account",,U,,05/09/2018,"Luke","Personal : Gifts","Personal","Gifts","",$30.00,$0.00,$200.00
"Lisa Cash Account",,U,,05/11/2018,"cold stone","Food : Restaurants","Food","Restaurants","",$14.50,$0.00,$185.50
"Lisa Cash Account",,U,,05/11/2018,"sprouts","Food : Groceries","Food","Groceries","",$63.64,$0.00,$121.86
"Lisa Cash Account",,U,,05/14/2018,"gasoline","RV : gasoline","RV","gasoline","",$85.00,$0.00,$36.86
"Lisa Cash Account",,U,,05/17/2018,"Transfer : Dcu Checking",,,,"",$0.00,$120.00,$156.86
"Lisa Cash Account",,U,,05/18/2018,"Lees Ferry","RV : Campgrounds","RV","Campgrounds","",$60.00,$0.00,$96.86
"Lisa Cash Account",,U,,05/25/2018,"Pink Sands","Recreation : Entertainment","Recreation","Entertainment","",$8.00,$0.00,$88.86
"Lisa Cash Account",,U,,05/25/2018,"Ice Cream Bar","Food : Restaurants","Food","Restaurants","",$11.00,$0.00,$77.86
"Lisa Cash Account",,U,,05/25/2018,"Tip Gus","Food : Restaurants","Food","Restaurants","",$20.00,$0.00,$57.86
"Lisa Cash Account",,U,,05/28/2018,"ice cream","Food : Restaurants","Food","Restaurants","",$4.25,$0.00,$53.61
"Lisa Cash Account",,U,,05/31/2018,"","Food : Restaurants","Food","Restaurants","(Split 1/2) ",$30.00,$0.00,$0.00
"Lisa Cash Account",,U,,05/31/2018,"","Recreation : Entertainment","Recreation","Entertainment","(Split 2/2) ",$23.61,$0.00,$0.00
"Lisa Cash Account",,U,,06/01/2018,"Transfer : Dcu Checking",,,,"",$0.00,$100.00,$100.00
"Lisa Cash Account",,U,,06/02/2018,"Yogurt","Food : Restaurants","Food","Restaurants","",$2.00,$0.00,$98.00
"Lisa Cash Account",,U,,06/02/2018,"ice cream","Food : Restaurants","Food","Restaurants","",$7.00,$0.00,$91.00
"Lisa Cash Account",,U,,06/02/2018,"Coffee","Food : Groceries","Food","Groceries","Farmers Market",$8.00,$0.00,$83.00
"Lisa Cash Account",,U,,06/02/2018,,"Food : Restaurants","Food","Restaurants","",$13.00,$0.00,$70.00
"Lisa Cash Account",,U,,06/07/2018,"La Mesa RV`","RV : Campgrounds","RV","Campgrounds","Two Nights",$50.00,$0.00,$20.00
"Lisa Cash Account",,U,,06/08/2018,"Transfer : Dcu Checking",,,,"",$0.00,$200.00,$220.00
"Lisa Cash Account",,U,,06/08/2018,"La Mesa RV`","RV : Campgrounds","RV","Campgrounds","another night - Small Park - Cortez FHU - Big COW - Strip mall with a lot of out of business Places.",$25.00,$0.00,$195.00
"Lisa Cash Account",,U,,06/08/2018,"","Recreation : Entertainment","Recreation","Entertainment","Four corners",$42.00,$0.00,$153.00
"Lisa Cash Account",,U,,06/13/2018,"Movies","Recreation : Entertainment","Recreation","Entertainment","Super cheap 1.75 a piece",$5.25,$0.00,$147.75
"Lisa Cash Account",,U,,06/14/2018,"standly Recreation area","RV : Campgrounds","RV","Campgrounds","near Denver - dry camp 3 nights",$66.00,$0.00,$81.75
"Lisa Cash Account",,U,,06/15/2018,"Transfer : Dcu Checking",,,,"",$0.00,$201.00,$282.75
"Lisa Cash Account",,U,,06/15/2018,"","Food : Restaurants","Food","Restaurants","TIP - areeya and Ed treated",$20.00,$0.00,$262.75
"Lisa Cash Account",,U,,06/18/2018,"standly Recreation area","RV : Campgrounds","RV","Campgrounds","$ nights total in county park in Arvada CO.",$22.00,$0.00,$240.75
"Lisa Cash Account",,U,,06/22/2018,"restaurants","Food : Restaurants","Food","Restaurants","Various who knows where the money goes",$100.00,$0.00,$140.75
"Lisa Cash Account",,U,,07/18/2018,"ice cream","Food : Restaurants","Food","Restaurants","",$2.00,$0.00,$138.75
"Lisa Cash Account",,U,,07/18/2018,"Musician","Recreation : Entertainment","Recreation","Entertainment","Grand OLE RV REsort Musicaion",$5.00,$0.00,$133.75
"Lisa Cash Account",,U,,07/18/2018,"KVS hartsell AL","RV : Campgrounds","RV","Campgrounds","",$20.00,$0.00,$113.75
"Lisa Cash Account",,U,,07/18/2018,"","Food : Restaurants","Food","Restaurants","",$40.00,$0.00,$73.75
"Lisa Cash Account",,U,,07/20/2018,"Transfer : Dcu Checking",,,,"",$0.00,$100.00,$173.75
"Lisa Cash Account",,U,,07/21/2018,"tips muscians","Recreation : Entertainment","Recreation","Entertainment","",$10.00,$0.00,$163.75
"Lisa Cash Account",,U,,07/21/2018,"misc food","Food : Restaurants","Food","Restaurants","",$35.00,$0.00,$128.75
"Lisa Cash Account",,U,,07/21/2018,"singing hills rv park","RV : Campgrounds","RV","Campgrounds","",$35.00,$0.00,$93.75
"Lisa Cash Account",,U,,08/07/2018,"Transfer : Dcu Checking",,,,"",$0.00,$200.00,$293.75
"Lisa Cash Account",,U,,08/17/2018,"Transfer : Dcu Checking",,,,"",$0.00,$100.00,$393.75
"Lisa Cash Account",,U,,08/28/2018,"","RV : Laundry","RV","Laundry","",$20.00,$0.00,$373.75
"Lisa Cash Account",,U,,08/28/2018,,"Food : Restaurants","Food","Restaurants","",$100.00,$0.00,$273.75
"Lisa Cash Account",,U,,08/28/2018,"random food","Food : Restaurants","Food","Restaurants","",$150.00,$0.00,$123.75
"Lisa Cash Account",,U,,09/01/2018,"Mom and dad","Transportation : Air/train/bus/etc","Transportation","Air/train/bus/etc","Money from Mom and Dad for hotel etc  in Ohio",$0.00,$600.00,$723.75
"Lisa Cash Account",,U,,09/01/2018,"Yard sale","Financial Help : Alyssa","Financial Help","Alyssa","Stuff for Alyssa Apartment",$50.00,$0.00,$673.75
"Lisa Cash Account",,U,,09/01/2018,"random food","Food : Restaurants","Food","Restaurants","",$100.00,$0.00,$573.75
"Lisa Cash Account",,U,,09/01/2018,"Yard sale","Recreation : Entertainment","Recreation","Entertainment","Bike for Bob",$100.00,$0.00,$473.75
"Lisa Cash Account",,U,,09/18/2018,"Tjs","Food : Restaurants","Food","Restaurants","Renee Kelly",$65.00,$0.00,$408.75
"Lisa Cash Account",,U,,09/22/2018,"random entertinament","Recreation : Entertainment","Recreation","Entertainment","",$60.00,$0.00,$348.75
"Lisa Cash Account",,U,,09/22/2018,"Enterprice care rental","Personal : Miscellaneous","Personal","Miscellaneous","",$100.00,$0.00,$248.75
"Lisa Cash Account",,U,,09/22/2018,"random food","Food : Restaurants","Food","Restaurants","",$200.00,$0.00,$48.75
"Lisa Cash Account",,U,,09/24/2018,"Transfer : Dcu Checking",,,,"",$0.00,$80.00,$128.75
"Lisa Cash Account",,U,,10/15/2018,"Transfer : Dcu Checking",,,,"Ettlingen Withdrawal",$0.00,$348.29,$477.04
"Lisa Cash Account",,U,,10/20/2018,"Misc  Cash Spending","Food : Restaurants","Food","Restaurants",,$0.00,$0.00,$477.04
"Lisa Cash Account",,U,,10/20/2018,"misc entertainment Germany","Recreation : Entertainment","Recreation","Entertainment","",$340.00,$0.00,$137.04
"Lisa Cash Account",,U,,10/22/2018,"Transfer : Dcu Checking",,,,"Ettlingen",$0.00,$345.42,$482.46
"Lisa Cash Account",,U,,10/23/2018,"Misc Food Germany","Food : Restaurants","Food","Restaurants","",$360.00,$0.00,$122.46
"Lisa Cash Account",,U,,11/20/2018,"","Food : Restaurants","Food","Restaurants","",$100.00,$0.00,$22.46
"Lisa Cash Account",,U,,11/24/2018,"","Recreation : Entertainment","Recreation","Entertainment","",$50.00,$0.00,-$27.54
"Lisa Cash Account",,U,,11/24/2018,"","Food : Restaurants","Food","Restaurants","",$100.00,$0.00,-$127.54
"Lisa Cash Account",,U,,11/30/2018,"Transfer : Dcu Checking",,,,"",$0.00,$100.00,-$27.54
"Lisa Cash Account",,U,,12/10/2018,"Transfer : Dcu Checking",,,,"",$0.00,$100.00,$72.46
"Lisa Cash Account",,U,,12/17/2018,"Transfer : Dcu Checking",,,,"",$0.00,$100.00,$172.46
"Lisa Cash Account",,U,,12/17/2018,,"RV : Campgrounds","RV","Campgrounds","",$30.00,$0.00,$142.46
"Lisa Cash Account",,U,,12/17/2018,,"RV : Laundry","RV","Laundry","",$40.00,$0.00,$102.46
"Lisa Cash Account",,U,,12/17/2018,,"Food : Restaurants","Food","Restaurants","",$50.00,$0.00,$52.46
"Lisa Cash Account",,U,,12/22/2018,"Transfer : Dcu Checking",,,,"",$0.00,$100.00,$152.46
"Lisa Cash Account",,U,,12/26/2018,,"Food : Restaurants","Food","Restaurants","",$75.00,$0.00,$77.46
"Lisa Cash Account",,U,,12/31/2018,"Transfer : Dcu Checking",,,,"",$0.00,$100.00,$177.46
"Lisa Cash Account",,U,,01/06/2019,,"Food : Restaurants","Food","Restaurants","",$100.00,$0.00,$77.46
"Lisa Cash Account",,U,,01/08/2019,"Transfer : Dcu Checking",,,,"",$0.00,$100.00,$177.46
"Lisa Cash Account",,U,,01/22/2019,"Transfer : Dcu Checking",,,,"",$0.00,$100.00,$277.46
"Lisa Cash Account",,U,,01/22/2019,,"Food : Restaurants","Food","Restaurants","",$80.00,$0.00,$197.46
"Lisa Cash Account",,U,,01/22/2019,,"Recreation : Entertainment","Recreation","Entertainment","",$80.00,$0.00,$117.46
"Lisa Cash Account",,U,,01/28/2019,,"Food : Restaurants","Food","Restaurants","",$40.00,$0.00,$77.46
"Lisa Cash Account",,U,,01/28/2019,,"Recreation : Entertainment","Recreation","Entertainment","",$40.00,$0.00,$37.46
"Lisa Cash Account",,U,,02/13/2019,"Transfer : Dcu Checking",,,,"",$0.00,$100.00,$137.46
"Lisa Cash Account",,U,,02/21/2019,"food","Food : Restaurants","Food","Restaurants","",$50.00,$0.00,$87.46
"Lisa Cash Account",,U,,02/21/2019,"Misc  Cash Spending","Recreation : Entertainment","Recreation","Entertainment","",$50.00,$0.00,$37.46
"Lisa Cash Account",,U,,02/24/2019,"Carranco and some","Transportation : Repairs & Maintenance","Transportation","Repairs & Maintenance","",$40.00,$0.00,-$2.54
"Lisa Cash Account",,U,,02/25/2019,"Serinity Massage","Personal : Miscellaneous","Personal","Miscellaneous","",$10.00,$0.00,-$12.54
"Lisa Cash Account",,U,,02/28/2019,"Transfer : Dcu Checking",,,,"",$0.00,$100.00,$87.46
"Lisa Cash Account",,U,,03/01/2019,"food","Food : Restaurants","Food","Restaurants","",$55.00,$0.00,$32.46
"Lisa Cash Account",,U,,03/15/2019,"Transfer : Dcu Checking",,,,"",$0.00,$100.00,$132.46
"Lisa Cash Account",,U,,03/22/2019,"laundry","RV : Laundry","RV","Laundry","",$10.00,$0.00,$122.46
"Lisa Cash Account",,U,,03/22/2019,"restaurants","Food : Restaurants","Food","Restaurants","",$50.00,$0.00,$72.46
"Lisa Cash Account",,U,,04/19/2019,"Transfer : Dcu Checking",,,,"",$0.00,$200.00,$272.46
"Lisa Cash Account",,U,,04/22/2019,"Ace hardware","RV : Equipment/Supplies","RV","Equipment/Supplies","Attempting to fix shade",$15.00,$0.00,$257.46
"Lisa Cash Account",,U,,04/22/2019,,"Food : Restaurants","Food","Restaurants","",$50.00,$0.00,$207.46
"Lisa Cash Account",,U,,04/24/2019,"","Food : Restaurants","Food","Restaurants","",$100.00,$0.00,$107.46
"Lisa Cash Account",,U,,04/27/2019,"","Food : Restaurants","Food","Restaurants","Money from Karina for Pizza",$0.00,$60.00,$167.46
"Lisa Cash Account",,U,,05/10/2019,"misc restaurants","Food : Restaurants","Food","Restaurants","",$100.00,$0.00,$67.46
"Lisa Cash Account",,U,,05/20/2019,"misc gifts","Personal : Gifts","Personal","Gifts","",$50.00,$0.00,$17.46
"Lisa Cash Account",,U,,06/03/2019,"Transfer : Dcu Checking",,,,"",$0.00,$200.00,$217.46
"Lisa Cash Account",,U,,06/03/2019,"misc entertainment","Recreation : Entertainment","Recreation","Entertainment","",$30.00,$0.00,$187.46
"Lisa Cash Account",,U,,06/10/2019,"misc restaurants","Food : Restaurants","Food","Restaurants","",$100.00,$0.00,$87.46
"Lisa Cash Account",,U,,06/14/2019,"Transfer : Dcu Checking",,,,"",$0.00,$200.00,$287.46
"Lisa Cash Account",,U,,06/16/2019,"","RV : Laundry","RV","Laundry","",$20.00,$0.00,$267.46
"Lisa Cash Account",,U,,06/16/2019,,"Personal : Gifts","Personal","Gifts","",$40.00,$0.00,$227.46
"Lisa Cash Account",,U,,06/16/2019,,"Food : Restaurants","Food","Restaurants","",$150.00,$0.00,$77.46
"Lisa Cash Account",,U,,06/20/2019,"Transfer : Dcu Checking",,,,"",$0.00,$150.00,$227.46
"Lisa Cash Account",,U,,06/24/2019,"restaurants","Food : Restaurants","Food","Restaurants","AT Normandy farms",$30.00,$0.00,$197.46
"Lisa Cash Account",,U,,07/05/2019,"laundry","RV : Laundry","RV","Laundry","",$35.00,$0.00,$162.46
"Lisa Cash Account",,U,,07/08/2019,"restaurants","Food : Restaurants","Food","Restaurants","",$35.00,$0.00,$127.46
"Lisa Cash Account",,U,,07/15/2019,"Transfer : Dcu Checking",,,,"",$0.00,$200.00,$327.46
"Lisa Cash Account",,U,,07/22/2019,"laundry","RV : Laundry","RV","Laundry","",$20.00,$0.00,$307.46
"Lisa Cash Account",,U,,07/22/2019,"Enterprice care rental","Personal : Miscellaneous","Personal","Miscellaneous","",$40.00,$0.00,$267.46
"Lisa Cash Account",,U,,07/22/2019,"restaurants","Food : Restaurants","Food","Restaurants","",$140.00,$0.00,$127.46
"Lisa Cash Account",,U,,07/26/2019,,"Food : Restaurants","Food","Restaurants","",$25.00,$0.00,$102.46
"Lisa Cash Account",,U,,08/09/2019,"entertainment","Recreation : Entertainment","Recreation","Entertainment","",$45.00,$0.00,$57.46
"Lisa Cash Account",,U,,08/09/2019,"restaurants","Food : Restaurants","Food","Restaurants","",$45.00,$0.00,$12.46
"Lisa Cash Account",,U,,08/12/2019,"Transfer : Dcu Checking",,,,"",$0.00,$100.00,$112.46
"Lisa Cash Account",,U,,08/12/2019,"restaurants","Food : Restaurants","Food","Restaurants","",$45.00,$0.00,$67.46
"Lisa Cash Account",,U,,08/24/2019,"Transfer : Dcu Checking",,,,"",$0.00,$100.00,$167.46
"Lisa Cash Account",,U,,08/26/2019,,"Food : Restaurants","Food","Restaurants","",$50.00,$0.00,$117.46
"Lisa Cash Account",,U,,09/05/2019,"Transfer : Dcu Checking",,,,"",$0.00,$200.00,$317.46
"Lisa Cash Account",,U,,09/09/2019,"Transfer : Dcu Checking",,,,"",$0.00,$100.00,$417.46
"Lisa Cash Account",,U,,09/09/2019,"laundry","RV : Laundry","RV","Laundry","",$35.00,$0.00,$382.46
"Lisa Cash Account",,U,,09/09/2019,"Enterprice care rental","Personal : Miscellaneous","Personal","Miscellaneous","",$100.00,$0.00,$282.46
"Lisa Cash Account",,U,,09/09/2019,"","Food : Restaurants","Food","Restaurants","",$200.00,$0.00,$82.46
"Lisa Cash Account",,U,,09/20/2019,"Karina","Food : Restaurants","Food","Restaurants","MOney for delphinos",$0.00,$200.00,$282.46
"Lisa Cash Account",,U,,10/09/2019,"Transfer : Dcu Checking",,,,"",$0.00,$80.00,$362.46
"Lisa Cash Account",,U,,10/22/2019,"Transfer : Dcu Checking",,,,"",$0.00,$100.00,$462.46
"Lisa Cash Account",,U,,10/28/2019,"Enterprice care rental","Personal : Miscellaneous","Personal","Miscellaneous","",$120.00,$0.00,$342.46
"Lisa Cash Account",,U,,10/28/2019,"restaurants","Food : Restaurants","Food","Restaurants","",$240.00,$0.00,$102.46
"Lisa Cash Account",,U,,11/10/2019,"sparky","Food : Restaurants","Food","Restaurants","Red Bay Fish Fry and Bake with HUSH Puppies",$30.00,$0.00,$72.46
"Lisa Cash Account",,U,,11/14/2019,"Transfer : Dcu Checking",,,,"",$0.00,$202.50,$274.96
"Lisa Cash Account",,U,,11/24/2019,"","Charity : Other","Charity","Other","Pan Handler",$20.00,$0.00,$254.96
"Lisa Cash Account",,U,,11/24/2019,,"RV : Equipment/Supplies","RV","Equipment/Supplies","",$25.00,$0.00,$229.96
"Lisa Cash Account",,U,,11/24/2019,"","Recreation : Entertainment","Recreation","Entertainment","",$50.00,$0.00,$179.96
"Lisa Cash Account",,U,,11/24/2019,,"Food : Restaurants","Food","Restaurants","60",$60.00,$0.00,$119.96
"Lisa Cash Account",,U,,11/30/2019,"","Food : Restaurants","Food","Restaurants","",$45.00,$0.00,$74.96
"Lisa Cash Account",,U,,12/01/2019,"","Recreation : Entertainment","Recreation","Entertainment","",$55.00,$0.00,$19.96
"Lisa Cash Account",,U,,12/06/2019,"Transfer : Dcu Checking",,,,"",$0.00,$120.00,$139.96
"Lisa Cash Account",,U,,12/12/2019,,"Food : Groceries","Food","Groceries","Farmers Market",$40.00,$0.00,$99.96
"Lisa Cash Account",,U,,12/14/2019,,"Food : Restaurants","Food","Restaurants","biking breakfasts",$40.00,$0.00,$59.96
"Lisa Cash Account",,U,,12/16/2019,"Transfer : Dcu Checking",,,,"",$0.00,$200.00,$259.96
"Lisa Cash Account",,U,,12/20/2019,,"Food : Restaurants","Food","Restaurants","",$200.00,$0.00,$59.96
"Lisa Cash Account",,U,,01/13/2020,"Transfer : Dcu Checking",,,,"",$0.00,$200.00,$259.96
"Lisa Cash Account",,U,,01/28/2020,"Transfer : Dcu Checking",,,,"",$0.00,$100.00,$359.96
"Lisa Cash Account",,U,,01/30/2020,,"RV : Laundry","RV","Laundry","",$20.00,$0.00,$339.96
"Lisa Cash Account",,U,,01/30/2020,"","Recreation : Entertainment","Recreation","Entertainment","",$50.00,$0.00,$289.96
"Lisa Cash Account",,U,,01/30/2020,"","Food : Restaurants","Food","Restaurants","",$150.00,$0.00,$139.96
"Lisa Cash Account",,U,,02/05/2020,"Transfer : Dcu Checking",,,,"",$0.00,$80.00,$219.96
"Lisa Cash Account",,U,,02/07/2020,"Transfer : Dcu Checking",,,,"",$0.00,$120.00,$339.96
"Lisa Cash Account",,U,,02/11/2020,"Transfer : Dcu Checking",,,,"",$0.00,$80.00,$419.96
"Lisa Cash Account",,U,,02/11/2020,"","RV : Laundry","RV","Laundry","",$20.00,$0.00,$399.96
"Lisa Cash Account",,U,,02/11/2020,,"Personal : Gifts","Personal","Gifts","",$50.00,$0.00,$349.96
"Lisa Cash Account",,U,,02/11/2020,,"RV : MISC","RV","MISC","",$50.00,$0.00,$299.96
"Lisa Cash Account",,U,,02/11/2020,,"Recreation : Entertainment","Recreation","Entertainment","",$100.00,$0.00,$199.96
"Lisa Cash Account",,U,,02/11/2020,,"Food : Restaurants","Food","Restaurants","",$150.00,$0.00,$49.96
"Lisa Cash Account",,U,,03/07/2020,"Transfer : Dcu Checking",,,,"",$0.00,$100.00,$149.96
"Lisa Cash Account",,U,,03/15/2020,"","Recreation : Entertainment","Recreation","Entertainment","State Parks",$20.00,$0.00,$129.96
"Lisa Cash Account",,U,,03/16/2020,"Transfer : Dcu Checking",,,,"",$0.00,$80.00,$209.96
"Lisa Cash Account",,U,,03/16/2020,,"Food : Groceries","Food","Groceries","",$25.00,$0.00,$184.96
"Lisa Cash Account",,U,,05/02/2020,,"RV : Laundry","RV","Laundry","",$40.00,$0.00,$144.96
"Lisa Cash Account",,U,,05/06/2020,"Ohio Rest Area","RV : Campgrounds","RV","Campgrounds","Oho Rest area - RV spot with ELectric",$20.00,$0.00,$124.96
"Lisa Cash Account",,U,,06/08/2020,"Transfer : Dcu Checking",,,,"",$0.00,$100.00,$224.96
"Lisa Cash Account",,U,,06/16/2020,"gifts","Personal : Gifts","Personal","Gifts","",$20.00,$0.00,$204.96
"Lisa Cash Account",,U,,06/16/2020,"laundry","RV : Laundry","RV","Laundry","",$20.00,$0.00,$184.96
"Lisa Cash Account",,U,,06/16/2020,"","RV : Equipment/Supplies","RV","Equipment/Supplies","",$40.00,$0.00,$144.96
"Lisa Cash Account",,U,,06/16/2020,"restaurants","Food : Restaurants","Food","Restaurants","",$80.00,$0.00,$64.96
"Lisa Cash Account",,U,,06/29/2020,,"Food : Groceries","Food","Groceries","Money From Mom and dad for groceries",$0.00,$85.00,$149.96
"Lisa Cash Account",,U,,06/29/2020,"income","Income : Available next month","Income","Available next month","gardening",$0.00,$65.00,$214.96
"Lisa Cash Account",,U,,06/29/2020,"","Food : Restaurants","Food","Restaurants","",$0.00,$35.00,$249.96
"Lisa Cash Account",,U,,06/29/2020,"","RV : Laundry","RV","Laundry","",$10.00,$0.00,$239.96
"Lisa Cash Account",,U,,06/29/2020,,"Personal : Gifts","Personal","Gifts","",$20.00,$0.00,$219.96
"Lisa Cash Account",,U,,06/29/2020,,"Recreation : Entertainment","Recreation","Entertainment","",$20.00,$0.00,$199.96
"Lisa Cash Account",,U,,06/29/2020,,"Food : Restaurants","Food","Restaurants","",$30.00,$0.00,$169.96
"Lisa Cash Account",,U,,07/09/2020,,"Food : Groceries","Food","Groceries","Money Back From Mom",$0.00,$80.00,$249.96
"Lisa Cash Account",,U,,07/20/2020,"","Recreation : Entertainment","Recreation","Entertainment","",$10.00,$0.00,$239.96
"Lisa Cash Account",,U,,07/20/2020,,"Food : Restaurants","Food","Restaurants","",$20.00,$0.00,$219.96
"Lisa Cash Account",,U,,07/20/2020,,"Personal : Gifts","Personal","Gifts","",$20.00,$0.00,$199.96
"Lisa Cash Account",,U,,07/20/2020,"laundry","RV : Laundry","RV","Laundry","",$25.00,$0.00,$174.96
"Lisa Cash Account",,U,,07/28/2020,,"Food : Groceries","Food","Groceries","Mom and Dad groceries payback",$0.00,$90.00,$264.96
"Lisa Cash Account",,U,,07/28/2020,,"Food : Restaurants","Food","Restaurants","Lisa Ice Cream",$30.00,$0.00,$234.96
"Lisa Cash Account",,U,,07/29/2020,"star laundry","RV : Laundry","RV","Laundry","",$5.00,$0.00,$229.96
"Lisa Cash Account",,U,,08/09/2020,,"Food : Groceries","Food","Groceries","",$0.00,$75.00,$304.96
"Lisa Cash Account",,U,,08/09/2020,"wayne Used bike","Recreation : Entertainment","Recreation","Entertainment","Used bike",$150.00,$0.00,$154.96
"Lisa Cash Account",,U,,08/15/2020,"Sweetwater  Pay","Income : Available this month","Income","Available this month","",$0.00,$250.00,$404.96
"Lisa Cash Account",,U,,08/15/2020,"Bike alyssa","Personal : Gifts","Personal","Gifts","",$130.00,$0.00,$274.96
"Lisa Cash Account",,U,,08/15/2020,"bike bob","Recreation : Entertainment","Recreation","Entertainment","",$150.00,$0.00,$124.96
"Lisa Cash Account",,U,,08/22/2020,"Fare and Just kitchen","Food : Restaurants","Food","Restaurants","",$30.00,$0.00,$94.96
"Lisa Cash Account",,U,,08/26/2020,"Mom and dad","Food : Groceries","Food","Groceries","Payment for groceries",$0.00,$80.00,$174.96
"Lisa Cash Account",,U,,09/01/2020,"Money for moving trunk","Financial Help : Alyssa","Financial Help","Alyssa","",$60.00,$0.00,$114.96
"Lisa Cash Account",,U,,09/15/2020,,"RV : Laundry","RV","Laundry","",$5.00,$0.00,$109.96
"Lisa Cash Account",,U,,09/16/2020,"mom and dad payback","Food : Groceries","Food","Groceries","",$0.00,$70.00,$179.96
"Lisa Cash Account",,U,,10/12/2020,"Sweetwater  Pay","Income : Available this month","Income","Available this month",,$0.00,$300.00,$479.96
"Lisa Cash Account",,U,,10/12/2020,"star laundry","RV : Laundry","RV","Laundry","",$15.00,$0.00,$464.96
"Lisa Cash Account",,U,,10/12/2020,,"Personal : Gifts","Personal","Gifts","",$60.00,$0.00,$404.96
"Lisa Cash Account",,U,,10/12/2020,,"Food : Restaurants","Food","Restaurants","",$100.00,$0.00,$304.96
"Lisa Cash Account",,U,,10/17/2020,"Fish","Food : Groceries","Food","Groceries","Doug Linda Fish Market",$56.00,$0.00,$248.96
"Lisa Cash Account",,U,,11/18/2020,"restaurants","Food : Restaurants","Food","Restaurants","Random Lisa Spending",$100.00,$0.00,$148.96
"Lisa Cash Account",,U,,12/01/2020,"","Personal : Gifts","Personal","Gifts","Payback gifts for Kim",$0.00,$140.00,$288.96
"Lisa Cash Account",,U,,01/11/2021,,"Food : Restaurants","Food","Restaurants","",$100.00,$0.00,$188.96
"Lisa Cash Account",,U,,08/13/2021,"Transfer : Dcu Checking",,,,"",$0.00,$200.00,$388.96
"Lisa Cash Account",,U,,09/13/2021,"Transfer : Dcu Checking",,,,"",$0.00,$80.00,$468.96
"Robert Cash Account",,C,,06/10/2013,"Starting Balance","Income : Available this month","Income","Available this month",,$0.00,$0.00,$0.00
"Robert Cash Account",,U,,07/30/2013,"Sandrinos","Food : Restaurants","Food","Restaurants","",$9.00,$0.00,-$9.00
"Robert Cash Account",,U,,07/31/2013,"Flat bread Pizzza","Food : Restaurants","Food","Restaurants","",$13.00,$0.00,-$22.00
"Robert Cash Account",,U,,08/12/2013,"Transfer : Avidia Checking",,,,"",$0.00,$100.00,$78.00
"Robert Cash Account",,U,,08/14/2013,"Transfer : Dcu Checking",,,,"Open Account",$40.00,$0.00,$38.00
"Robert Cash Account",,U,,04/21/2014,"Transfer : Avidia Checking",,,,"",$0.00,$100.00,$138.00
"Robert Cash Account",,U,,07/10/2014,"Transfer : Avidia Checking",,,,"",$0.00,$200.00,$338.00
"Robert Cash Account",,U,,08/14/2014,,"Food : Restaurants","Food","Restaurants","",$338.00,$0.00,$0.00
"Robert Cash Account",,U,,10/20/2014,"Karina","Income : Available next month","Income","Available next month","",$0.00,$1000.00,$1000.00
"Robert Cash Account",,U,,10/20/2014,"Seeking Alpha","Income : Available next month","Income","Available next month","",$0.00,$597.00,$1597.00
"Robert Cash Account",,U,,10/21/2014,"Transfer : DCU Home Equity Credit line",,,,"",$597.40,$0.00,$999.60
"Robert Cash Account",,U,,10/24/2014,"Transfer : DCU Home Equity Credit line",,,,"",$900.00,$0.00,$99.60
"Robert Cash Account",,U,,11/30/2014,"FutureAdvisor","Income : Available next month","Income","Available next month","",$0.00,$200.00,$299.60
"Robert Cash Account",,U,,11/30/2014,,"Food : Restaurants","Food","Restaurants","Guesswork - Balance account with waller",$49.00,$0.00,$250.60
"Robert Cash Account",,U,,11/30/2014,,"Personal : Miscellaneous","Personal","Miscellaneous","Guesswork - Balance account with Wallet",$50.00,$0.00,$200.60
"Robert Cash Account",,U,,11/30/2014,"Transfer : Lisa Cash Account",,,,"",$100.00,$0.00,$100.60
"Robert Cash Account",,U,,05/06/2015,"food","Food : Restaurants","Food","Restaurants","",$80.00,$0.00,$20.60
"Robert Cash Account",,U,,05/22/2015,"Transfer : Dcu Checking",,,,"",$0.00,$671.01,$691.61
"Robert Cash Account",,U,,07/21/2015,"Transfer : Dcu Checking",,,,"",$0.00,$515.22,$1206.83
"Robert Cash Account",,U,,09/15/2015,"Transfer : Avidia Checking",,,,"",$0.00,$100.00,$1306.83
"Robert Cash Account",,U,,09/16/2015,"Transfer : Avidia Checking",,,,"",$0.00,$309.74,$1616.57
"Robert Cash Account",,U,,09/16/2015,"Transfer : Avidia Checking",,,,"",$0.00,$60.00,$1676.57
"Robert Cash Account",,U,,12/04/2015,"Transfer : Avidia Checking",,,,"",$0.00,$100.00,$1776.57
"Robert Cash Account",,U,,12/31/2015,"Misc cash Spending","Recreation : Entertainment","Recreation","Entertainment","(Split 1/5) ",$323.01,$0.00,$0.00
"Robert Cash Account",,U,,12/31/2015,"Misc cash Spending","Housing : Supplies","Hidden Categories","Housing ` Supplies","(Split 2/5) ",$323.01,$0.00,$0.00
"Robert Cash Account",,U,,12/31/2015,"Misc cash Spending","Personal : cloths","Personal","cloths","(Split 3/5) ",$53.84,$0.00,$0.00
"Robert Cash Account",,U,,12/31/2015,"Misc cash Spending","Food : Restaurants","Food","Restaurants","(Split 4/5) ",$538.36,$0.00,$0.00
"Robert Cash Account",,U,,12/31/2015,"Misc cash Spending","Personal : Miscellaneous","Personal","Miscellaneous","(Split 5/5) ",$538.35,$0.00,$0.00
"Robert Cash Account",,U,,02/16/2016,"Transfer : Avidia Checking",,,,"",$0.00,$100.00,$100.00
"Robert Cash Account",,U,,03/01/2016,"Who knows","Personal : Miscellaneous","Personal","Miscellaneous","",$100.00,$0.00,$0.00
"Robert Cash Account",,U,,10/24/2016,"Transfer : DCU Home Equity Credit line",,,,"",$38000.00,$0.00,-$38000.00
"Robert Cash Account",,U,,11/24/2016,"income","Income : Available next month","Income","Available next month","Mom and house money  - To balance account",$0.00,$60845.00,$22845.00
"Robert Cash Account",,U,,12/06/2016,"Transfer : DCU Home Equity Credit line",,,,"",$10005.26,$0.00,$12839.74
"Robert Cash Account",,U,,12/12/2016,"Transfer : DCU Home Equity Credit line",,,,"",$12839.74,$0.00,$0.00
"Discover",,C,,06/13/2013,"Starting Balance","Pre-YNAB Debt : Discover","Hidden Categories","Pre-YNAB Debt ` Discover","",$4437.74,$0.00,-$4437.74
"Discover",,C,,06/14/2013,"Ny Times","Recreation : His","Recreation","His","NY TIMES",$15.00,$0.00,-$4452.74
"Discover",,C,,06/14/2013,"Shell","Transportation : Gas","Transportation","Gas","",$50.20,$0.00,-$4502.94
"Discover",,C,,06/14/2013,"MRKT BSKT","Food : Groceries","Food","Groceries","",$119.11,$0.00,-$4622.05
"Discover",,C,,06/15/2013,"Verill Farm","Food : Groceries","Food","Groceries","",$7.86,$0.00,-$4629.91
"Discover",,C,,06/15/2013,"Price Chopper","Food : Groceries","Food","Groceries","",$18.33,$0.00,-$4648.24
"Discover",,C,,06/15/2013,"Hess","Transportation : Gas","Transportation","Gas","",$32.52,$0.00,-$4680.76
"Discover",,C,,06/15/2013,"MRKT BSKT","Food : Groceries","Food","Groceries","",$50.00,$0.00,-$4730.76
"Discover",,C,,06/15/2013,"target","Recreation : His","Recreation","His","IPAD MINI",$363.35,$0.00,-$5094.11
"Discover",,C,,06/18/2013,"Cambidge Eye Doctors","Personal : Miscellaneous","Personal","Miscellaneous","Eye Glass case",$9.51,$0.00,-$5103.62
"Discover",,C,,06/18/2013,"Planet Fitness","Recreation : His","Recreation","His","",$10.00,$0.00,-$5113.62
"Discover",,C,,06/18/2013,"EO NOODLE","Food : Restaurants","Food","Restaurants","",$42.40,$0.00,-$5156.02
"Discover",,C,,06/19/2013,"Market bskt","Food : Groceries","Food","Groceries","",$11.20,$0.00,-$5167.22
"Discover",,C,,06/20/2013,"smilebox","Personal : Gifts","Personal","Gifts","",$5.99,$0.00,-$5173.21
"Discover",,C,,06/20/2013,"netflix","Recreation : Entertainment","Recreation","Entertainment","",$16.48,$0.00,-$5189.69
"Discover",,C,,06/20/2013,"Fish","Food : Restaurants","Food","Restaurants","",$42.60,$0.00,-$5232.29
"Discover",,C,,06/21/2013,"Shell","Transportation : Gas","Transportation","Gas","",$47.57,$0.00,-$5279.86
"Discover",,C,,06/22/2013,"Adam Gas","Transportation : Gas","Transportation","Gas","",$33.00,$0.00,-$5312.86
"Discover",,C,,06/23/2013,"Amazon","Recreation : Entertainment","Recreation","Entertainment","Biz Book",$9.99,$0.00,-$5322.85
"Discover",,C,,06/23/2013,"Thai Time","Food : Restaurants","Food","Restaurants","",$24.00,$0.00,-$5346.85
"Discover",,C,,06/23/2013,"Bancroft Schoole","Education : bancroft","Education","bancroft","",$75.00,$0.00,-$5421.85
"Discover",,C,,06/24/2013,"dunkin donuts","Food : Restaurants","Food","Restaurants","",$5.40,$0.00,-$5427.25
"Discover",,C,,06/24/2013,"Market bskt","Food : Groceries","Food","Groceries","",$19.87,$0.00,-$5447.12
"Discover",,C,,06/24/2013,"kraft tire & auot","Transportation : Repairs & Maintenance","Transportation","Repairs & Maintenance","OIL CHANGE",$47.82,$0.00,-$5494.94
"Discover",,C,,06/25/2013,"hannaford","Food : Groceries","Food","Groceries","",$27.67,$0.00,-$5522.61
"Discover",,C,,06/27/2013,"Market bskt","Food : Groceries","Food","Groceries","",$93.54,$0.00,-$5616.15
"Discover",,C,,06/27/2013,"Fish","Food : Restaurants","Food","Restaurants","",$136.22,$0.00,-$5752.37
"Discover",,C,,06/28/2013,"dennis public market","Food : Groceries","Food","Groceries","",$23.94,$0.00,-$5776.31
"Discover",,C,,06/28/2013,"Shell","Transportation : Gas","Transportation","Gas","",$30.54,$0.00,-$5806.85
"Discover",,C,,06/28/2013,"Christmas Tree Shop","Food : Groceries","Food","Groceries","",$30.66,$0.00,-$5837.51
"Discover",,C,,06/28/2013,"Shell","Transportation : Gas","Transportation","Gas","",$49.02,$0.00,-$5886.53
"Discover",,C,,06/28/2013,"wicked thrift","Personal : cloths","Personal","cloths","",$71.00,$0.00,-$5957.53
"Discover",,C,,06/30/2013,"Oliver Ormans","Food : Restaurants","Food","Restaurants","",$25.00,$0.00,-$5982.53
"Discover",,C,,06/30/2013,"Market bskt","Food : Groceries","Food","Groceries","",$86.33,$0.00,-$6068.86
"Discover",,C,,07/01/2013,"gulf mart","Transportation : Gas","Transportation","Gas","",$18.40,$0.00,-$6087.26
"Discover",,C,,07/03/2013,"Transfer : Avidia Checking",,,,"",$0.00,$4437.74,-$1649.52
"Discover",,C,,07/03/2013,"sears","Recreation : Alyssa Horse","Recreation","Alyssa Horse","Riding shirts",$27.96,$0.00,-$1677.48
"Discover",,C,,07/04/2013,"dunkin donuts","Personal : Gifts","Personal","Gifts","Alexi",$20.00,$0.00,-$1697.48
"Discover",,C,,07/04/2013,"Shell","Transportation : Gas","Transportation","Gas","",$33.50,$0.00,-$1730.98
"Discover",,C,,07/04/2013,"target","Personal : Prescriptions, Medicine","Personal","Prescriptions, Medicine","(Split 1/2) ",$30.00,$0.00,-$1784.77
"Discover",,C,,07/04/2013,"target","Food : Groceries","Food","Groceries","(Split 2/2) ",$23.79,$0.00,-$1784.77
"Discover",,C,,07/05/2013,"masspike","Transportation : tolls","Transportation","tolls","",$46.20,$0.00,-$1830.97
"Discover",,C,,07/05/2013,"Shell","Transportation : Gas","Transportation","Gas","",$46.31,$0.00,-$1877.28
"Discover",,C,,07/05/2013,"Market bskt","Food : Groceries","Food","Groceries","",$87.82,$0.00,-$1965.10
"Discover",,C,,07/06/2013,"Market bskt","Food : Groceries","Food","Groceries","",$7.16,$0.00,-$1972.26
"Discover",,C,,07/06/2013,"lowes","Housing : Supplies","Hidden Categories","Housing ` Supplies","",$40.94,$0.00,-$2013.20
"Discover",,C,,07/09/2013,"Chipotle","Food : Restaurants","Food","Restaurants","Bob Lunch",$8.61,$0.00,-$2021.81
"Discover",,C,,07/09/2013,"Sutton North","Transportation : Gas","Transportation","Gas","",$30.96,$0.00,-$2052.77
"Discover",,C,,07/09/2013,"hannaford","Food : Groceries","Food","Groceries","",$69.85,$0.00,-$2122.62
"Discover",,C,,07/10/2013,"Ny Times","Recreation : His","Recreation","His","",$15.00,$0.00,-$2137.62
"Discover",,C,,07/14/2013,"Market bskt","Food : Groceries","Food","Groceries","",$7.74,$0.00,-$2145.36
"Discover",,C,,07/14/2013,"Officemax","Recreation : His","Recreation","His","ear buds",$10.61,$0.00,-$2155.97
"Discover",,C,,07/14/2013,"walgreens","Personal : Gifts","Personal","Gifts","",$17.09,$0.00,-$2173.06
"Discover",,C,,07/14/2013,"Shell","Transportation : Gas","Transportation","Gas","",$35.36,$0.00,-$2208.42
"Discover",,C,,07/14/2013,"Exxon mobile","Transportation : Gas","Transportation","Gas","",$44.70,$0.00,-$2253.12
"Discover",,C,,07/14/2013,"Market bskt","Food : Groceries","Food","Groceries","",$91.38,$0.00,-$2344.50
"Discover",,C,,07/15/2013,"hannaford","Food : Groceries","Food","Groceries","",$11.36,$0.00,-$2355.86
"Discover",,C,,07/16/2013,"Sunoco","Transportation : Gas","Transportation","Gas","",$50.69,$0.00,-$2406.55
"Discover",,C,,07/17/2013,"Planet Fitness","Recreation : His","Recreation","His","",$10.00,$0.00,-$2416.55
"Discover",,C,,07/17/2013,"Horse shoe pub","Food : Restaurants","Food","Restaurants","Nick and Nick Night",$20.00,$0.00,-$2436.55
"Discover",,C,,07/17/2013,"Horse shoe pub","Food : Restaurants","Food","Restaurants","",$45.67,$0.00,-$2482.22
"Discover",,C,,07/19/2013,"Strand theatre","Recreation : Entertainment","Recreation","Entertainment","",$22.00,$0.00,-$2504.22
"Discover",,C,,07/19/2013,"Shell","Transportation : Gas","Transportation","Gas","",$34.96,$0.00,-$2539.18
"Discover",,C,,07/19/2013,"Strand theatre","Food : Restaurants","Food","Restaurants","",$50.00,$0.00,-$2589.18
"Discover",,C,,07/20/2013,"netflix","Recreation : Entertainment","Recreation","Entertainment","",$16.48,$0.00,-$2605.66
"Discover",,C,,07/20/2013,"mexicali grill","Food : Restaurants","Food","Restaurants","",$38.63,$0.00,-$2644.29
"Discover",,C,,07/22/2013,"smilebox","Personal : Gifts","Personal","Gifts","",$5.99,$0.00,-$2650.28
"Discover",,C,,07/22/2013,"Shell","Transportation : Gas","Transportation","Gas","",$51.88,$0.00,-$2702.16
"Discover",,C,,07/24/2013,"Hess","Transportation : Gas","Transportation","Gas","34.68",$34.68,$0.00,-$2736.84
"Discover",,C,,07/24/2013,"stop & shop","Food : Groceries","Food","Groceries","",$38.39,$0.00,-$2775.23
"Discover",,C,,07/26/2013,"spicepepepr garden","Food : Restaurants","Food","Restaurants","",$45.52,$0.00,-$2820.75
"Discover",,C,,07/27/2013,"Shell","Transportation : Gas","Transportation","Gas","",$33.29,$0.00,-$2854.04
"Discover",,C,,07/28/2013,"Marshall's","Personal : cloths","Personal","cloths","",$11.67,$0.00,-$2865.71
"Discover",,C,,07/29/2013,"bolton st gas","Transportation : Gas","Transportation","Gas","",$34.05,$0.00,-$2899.76
"Discover",,C,,07/29/2013,"larrys nG's Auto","Transportation : Gas","Transportation","Gas","",$52.14,$0.00,-$2951.90
"Discover",,C,,07/30/2013,"Shell","Transportation : Gas","Transportation","Gas","",$11.97,$0.00,-$2963.87
"Discover",,C,,07/30/2013,"rue21","Personal : cloths","Personal","cloths","",$68.94,$0.00,-$3032.81
"Discover",,C,,07/31/2013,"rue21","Personal : cloths","Personal","cloths","",$18.98,$0.00,-$3051.79
"Discover",,C,,08/01/2013,"Sunoco","Transportation : Gas","Transportation","Gas","",$32.90,$0.00,-$3084.69
"Discover",,C,,08/01/2013,"RMV","Transportation : Repairs & Maintenance","Transportation","Repairs & Maintenance","Car registrations",$50.00,$0.00,-$3134.69
"Discover",,U,,08/03/2013,"Shell","Transportation : Gas","Transportation","Gas","",$30.42,$0.00,-$3165.11
"Discover",,C,,08/03/2013,"hanaford","Food : Groceries","Food","Groceries","",$72.67,$0.00,-$3237.78
"Discover",,C,,08/05/2013,"Transfer : Avidia Checking",,,,"",$0.00,$2137.62,-$1100.16
"Discover",,C,,08/06/2013,"cape code melody tent","Recreation : Entertainment","Recreation","Entertainment","",$12.00,$0.00,-$1112.16
"Discover",,C,,08/06/2013,"jamestown wine and spirits","Recreation : Vacation","Recreation","Vacation","",$21.38,$0.00,-$1133.54
"Discover",,C,,08/06/2013,"Shell","Transportation : Gas","Transportation","Gas","",$34.17,$0.00,-$1167.71
"Discover",,C,,08/06/2013,"cape code melody tent","Recreation : Entertainment","Recreation","Entertainment","",$50.00,$0.00,-$1217.71
"Discover",,C,,08/07/2013,"dennis public market","Food : Groceries","Food","Groceries","",$10.28,$0.00,-$1227.99
"Discover",,C,,08/07/2013,"new york times","Recreation : Entertainment","Recreation","Entertainment","",$15.00,$0.00,-$1242.99
"Discover",,C,,08/07/2013,"Exxon mobile","Transportation : Gas","Transportation","Gas","",$49.65,$0.00,-$1292.64
"Discover",,C,,08/07/2013,"Price Chopper","Food : Groceries","Food","Groceries","",$72.32,$0.00,-$1364.96
"Discover",,C,,08/08/2013,"verc enterprise","Transportation : Gas","Transportation","Gas","",$32.17,$0.00,-$1397.13
"Discover",,C,,08/09/2013,"hanaford","Food : Groceries","Food","Groceries","",$74.40,$0.00,-$1471.53
"Discover",,C,,08/10/2013,"Hess","Transportation : Gas","Transportation","Gas","",$3.27,$0.00,-$1474.80
"Discover",,C,,08/10/2013,"Hess","Transportation : Gas","Transportation","Gas","",$35.48,$0.00,-$1510.28
"Discover",,C,,08/11/2013,"Market bskt","Food : Groceries","Food","Groceries","",$69.13,$0.00,-$1579.41
"Discover",,C,,08/12/2013,"Officemax","Recreation : Entertainment","Recreation","Entertainment","head phones",$8.49,$0.00,-$1587.90
"Discover",,C,,08/13/2013,"Meat again","Food : Restaurants","Food","Restaurants","",$1.25,$0.00,-$1589.15
"Discover",,C,,08/13/2013,"Market bskt","Food : Groceries","Food","Groceries","",$2.12,$0.00,-$1591.27
"Discover",,C,,08/13/2013,"walgreens","Personal : Miscellaneous","Personal","Miscellaneous","",$3.71,$0.00,-$1594.98
"Discover",,C,,08/16/2013,"Chipotle","Food : Restaurants","Food","Restaurants","",$8.61,$0.00,-$1603.59
"Discover",,C,,08/16/2013,"consumer reports","Recreation : Entertainment","Recreation","Entertainment","",$30.00,$0.00,-$1633.59
"Discover",,C,,08/16/2013,"Shell","Transportation : Gas","Transportation","Gas","",$52.30,$0.00,-$1685.89
"Discover",,C,,08/17/2013,"Planet Fitness","Recreation : His","Recreation","His","",$10.00,$0.00,-$1695.89
"Discover",,C,,08/17/2013,"Shell","Transportation : Gas","Transportation","Gas","",$34.14,$0.00,-$1730.03
"Discover",,C,,08/17/2013,"hanaford","Food : Groceries","Food","Groceries","",$40.47,$0.00,-$1770.50
"Discover",,C,,08/18/2013,"Mile Marker cafe gloucester","Recreation : Entertainment","Recreation","Entertainment","Drinks",$65.00,$0.00,-$1835.50
"Discover",,C,,08/19/2013,"Chipotle","Food : Restaurants","Food","Restaurants","",$6.85,$0.00,-$1842.35
"Discover",,C,,08/19/2013,"Chipotle","Food : Restaurants","Food","Restaurants","",$18.62,$0.00,-$1860.97
"Discover",,C,,08/19/2013,"chili basil","Food : Restaurants","Food","Restaurants","",$61.20,$0.00,-$1922.17
"Discover",,C,,08/20/2013,"netflix","Recreation : Entertainment","Recreation","Entertainment","",$16.48,$0.00,-$1938.65
"Discover",,C,,08/20/2013,"Bedbath and Beyond","Education : College","Education","College","",$100.29,$0.00,-$2038.94
"Discover",,C,,08/20/2013,"Smartpak Equine","Recreation : Alyssa Horse","Recreation","Alyssa Horse","",$134.89,$0.00,-$2173.83
"Discover",,C,,08/22/2013,"smilebox","Personal : Gifts","Personal","Gifts","",$5.99,$0.00,-$2179.82
"Discover",,C,,08/22/2013,"Meat again","Food : Restaurants","Food","Restaurants","Bob Lunch",$7.12,$0.00,-$2186.94
"Discover",,C,,08/22/2013,"Strand theatre","Recreation : Entertainment","Recreation","Entertainment","",$16.50,$0.00,-$2203.44
"Discover",,C,,08/22/2013,"Strand theatre","Food : Restaurants","Food","Restaurants","",$39.95,$0.00,-$2243.39
"Discover",,C,,08/22/2013,"Shell","Transportation : Gas","Transportation","Gas","",$51.30,$0.00,-$2294.69
"Discover",,C,,08/23/2013,"Chipotle","Food : Restaurants","Food","Restaurants","Bob Lunch",$10.75,$0.00,-$2305.44
"Discover",,C,,08/23/2013,"Shell","Transportation : Gas","Transportation","Gas","",$35.00,$0.00,-$2340.44
"Discover",,C,,08/23/2013,"Roche Brothers","Food : Groceries","Food","Groceries","For Karina's house anita and chris",$69.25,$0.00,-$2409.69
"Discover",,C,,08/24/2013,"Newport Polo","Recreation : Vacation","Recreation","Vacation","Polo Match - Great night lot's of fun - funny british annoucer",$38.35,$0.00,-$2448.04
"Discover",,C,,08/24/2013,"Retail Protobase","Personal : cloths","Personal","cloths","",$43.50,$0.00,-$2491.54
"Discover",,C,,08/24/2013,"Extended Staty","Recreation : Vacation","Recreation","Vacation","Hotel saturday warwich RI",$107.34,$0.00,-$2598.88
"Discover",,C,,08/24/2013,"Sardella''s","Recreation : Vacation","Recreation","Vacation","Dinner vacation",$113.56,$0.00,-$2712.44
"Discover",,C,,08/25/2013,"Georges Of Gallilee Narragannsett ri","Food : Restaurants","Food","Restaurants","",$50.00,$0.00,-$2762.44
"Discover",,C,,08/25/2013,"Hess","Transportation : Gas","Transportation","Gas","",$50.53,$0.00,-$2812.97
"Discover",,C,,08/25/2013,"Island Moped","Recreation : Vacation","Recreation","Vacation","Bike rental",$66.20,$0.00,-$2879.17
"Discover",,C,,08/25/2013,"block island ferry","Recreation : Vacation","Recreation","Vacation","",$107.55,$0.00,-$2986.72
"Discover",,C,,08/26/2013,"Barnes and Noble","Education : College","Education","College","(Split 1/2) ",$33.00,$0.00,-$3035.54
"Discover",,C,,08/26/2013,"Barnes and Noble","Recreation : Entertainment","Recreation","Entertainment","(Split 2/2) ",$15.82,$0.00,-$3035.54
"Discover",,C,,08/26/2013,"target","Food : Groceries","Food","Groceries","(Split 1/2) 55",$55.00,$0.00,-$3246.90
"Discover",,C,,08/26/2013,"target","Personal : cloths","Personal","cloths","(Split 2/2) 166.36",$156.36,$0.00,-$3246.90
"Discover",,C,,08/27/2013,"Hudson Dairy Jou Hudson Ma","Food : Restaurants","Food","Restaurants","",$51.65,$0.00,-$3298.55
"Discover",,C,,08/29/2013,"Market bskt","Food : Groceries","Food","Groceries","",$142.22,$0.00,-$3440.77
"Discover",,C,,08/30/2013,"Godaddy","business (bob) : Internet","Hidden Categories","business (bob) ` Internet","",$51.85,$0.00,-$3492.62
"Discover",,C,,08/31/2013,"USPS","Housing : Supplies","Hidden Categories","Housing ` Supplies","",$10.35,$0.00,-$3502.97
"Discover",,C,,08/31/2013,"gulf mart","Transportation : Gas","Transportation","Gas","",$52.26,$0.00,-$3555.23
"Discover",,C,,08/31/2013,"hanaford","Food : Groceries","Food","Groceries","",$104.17,$0.00,-$3659.40
"Discover",,C,,08/31/2013,"Cambidge Eye Doctors","Personal : Prescriptions, Medicine","Personal","Prescriptions, Medicine","Glasses",$163.94,$0.00,-$3823.34
"Discover",,C,,09/03/2013,"Transfer : Avidia Checking",,,,"",$0.00,$1579.41,-$2243.93
"Discover",,C,,09/03/2013,"MRKT BSKT","Food : Groceries","Food","Groceries","",$6.25,$0.00,-$2250.18
"Discover",,C,,09/03/2013,"Price Chopper","Food : Groceries","Food","Groceries","",$71.18,$0.00,-$2321.36
"Discover",,C,,09/04/2013,"Hess","Transportation : Gas","Transportation","Gas","",$33.84,$0.00,-$2355.20
"Discover",,C,,09/06/2013,"Paul's diner","Food : Restaurants","Food","Restaurants","",$11.17,$0.00,-$2366.37
"Discover",,C,,09/06/2013,"Indian Head Farm","Food : Groceries","Food","Groceries","",$18.50,$0.00,-$2384.87
"Discover",,C,,09/06/2013,"Amazon","Education : College","Education","College","",$22.18,$0.00,-$2407.05
"Discover",,C,,09/06/2013,"Amazon","Education : College","Education","College","",$22.37,$0.00,-$2429.42
"Discover",,C,,09/06/2013,"Amazon","Education : College","Education","College","",$29.46,$0.00,-$2458.88
"Discover",,C,,09/06/2013,"Amazon","Education : College","Education","College","books",$72.94,$0.00,-$2531.82
"Discover",,C,,09/07/2013,"Groupon","Food : Restaurants","Food","Restaurants","",$29.73,$0.00,-$2561.55
"Discover",,C,,09/07/2013,"U A Foundation Albany","Charity : Other","Charity","Other","",$75.00,$0.00,-$2636.55
"Discover",,C,,09/08/2013,"Shell","Transportation : Gas","Transportation","Gas","",$51.67,$0.00,-$2688.22
"Discover",,C,,09/08/2013,"Market bskt","Food : Groceries","Food","Groceries","",$75.89,$0.00,-$2764.11
"Discover",,C,,09/10/2013,"Ocean State Joblot","Food : Groceries","Food","Groceries","",$52.15,$0.00,-$2816.26
"Discover",,C,,09/10/2013,"hanaford","Food : Groceries","Food","Groceries","",$57.15,$0.00,-$2873.41
"Discover",,C,,09/11/2013,"Market bskt","Food : Restaurants","Food","Restaurants","",$3.94,$0.00,-$2877.35
"Discover",,C,,09/11/2013,"shutter fly","Recreation : Entertainment","Recreation","Entertainment","",$21.78,$0.00,-$2899.13
"Discover",,C,,09/11/2013,"Shell","Transportation : Gas","Transportation","Gas","",$33.43,$0.00,-$2932.56
"Discover",,C,,09/12/2013,"dunkin donuts","Food : Restaurants","Food","Restaurants","",$5.30,$0.00,-$2937.86
"Discover",,C,,09/12/2013,"dunkin donuts","Food : Restaurants","Food","Restaurants","",$11.01,$0.00,-$2948.87
"Discover",,C,,09/13/2013,"Meat again","Food : Restaurants","Food","Restaurants","",$7.33,$0.00,-$2956.20
"Discover",,C,,09/13/2013,"Shell","Transportation : Gas","Transportation","Gas","",$30.02,$0.00,-$2986.22
"Discover",,C,,09/15/2013,"Marshall's","Personal : cloths","Personal","cloths","",$5.30,$0.00,-$2991.52
"Discover",,C,,09/15/2013,"Ocean State Joblot","Food : Groceries","Food","Groceries","",$12.73,$0.00,-$3004.25
"Discover",,C,,09/15/2013,"Exxon mobile","Transportation : Gas","Transportation","Gas","",$20.68,$0.00,-$3024.93
"Discover",,C,,09/17/2013,"Ocean State Joblot","Food : Groceries","Food","Groceries","",$0.00,$18.48,-$3006.45
"Discover",,C,,09/17/2013,"Ocean State Joblot","Food : Groceries","Food","Groceries","",$8.97,$0.00,-$3015.42
"Discover",,C,,09/17/2013,"Planet Fitness","Recreation : His","Recreation","His","",$10.00,$0.00,-$3025.42
"Discover",,C,,09/18/2013,"Family Garden And Market","Food : Restaurants","Food","Restaurants","",$9.63,$0.00,-$3035.05
"Discover",,C,,09/18/2013,"Market bskt","Food : Groceries","Food","Groceries","",$71.92,$0.00,-$3106.97
"Discover",,C,,09/20/2013,"shutter fly","Recreation : Entertainment","Recreation","Entertainment","",$6.03,$0.00,-$3113.00
"Discover",,C,,09/20/2013,"netflix","Recreation : Entertainment","Recreation","Entertainment","",$16.48,$0.00,-$3129.48
"Discover",,C,,09/20/2013,"Shell","Transportation : Gas","Transportation","Gas","",$32.74,$0.00,-$3162.22
"Discover",,C,,09/22/2013,"smilebox","Personal : Gifts","Personal","Gifts","",$5.99,$0.00,-$3168.21
"Discover",,C,,09/22/2013,"Cape Cod Gas","Transportation : Gas","Transportation","Gas","",$42.00,$0.00,-$3210.21
"Discover",,C,,09/23/2013,"walgreens","Personal : Miscellaneous","Personal","Miscellaneous","",$8.74,$0.00,-$3218.95
"Discover",,C,,09/24/2013,"shutter fly","Recreation : Entertainment","Recreation","Entertainment","",$6.11,$0.00,-$3225.06
"Discover",,C,,09/24/2013,"hanaford","Food : Groceries","Food","Groceries","",$71.79,$0.00,-$3296.85
"Discover",,C,,09/24/2013,"Marlboro Animal Hospital","Housing : Dog","Hidden Categories","Housing ` Dog","",$512.03,$0.00,-$3808.88
"Discover",,C,,09/26/2013,"walgreens","Personal : Miscellaneous","Personal","Miscellaneous","",$13.23,$0.00,-$3822.11
"Discover",,C,,09/26/2013,"Exxon mobile","Transportation : Gas","Transportation","Gas","",$35.11,$0.00,-$3857.22
"Discover",,C,,09/27/2013,"AC MOORE","Recreation : Alyssa","Recreation","Alyssa","",$8.48,$0.00,-$3865.70
"Discover",,C,,09/27/2013,"Chipotle","Food : Restaurants","Food","Restaurants","",$17.90,$0.00,-$3883.60
"Discover",,C,,09/27/2013,"Japon One","Food : Restaurants","Food","Restaurants","",$22.26,$0.00,-$3905.86
"Discover",,C,,09/28/2013,"hanaford","Food : Groceries","Food","Groceries","",$8.56,$0.00,-$3914.42
"Discover",,C,,09/28/2013,"stop & shop","Food : Groceries","Food","Groceries","",$22.07,$0.00,-$3936.49
"Discover",,C,,09/28/2013,"stop & shop","Transportation : Gas","Transportation","Gas","",$31.67,$0.00,-$3968.16
"Discover",,C,,09/29/2013,"star market","Food : Groceries","Food","Groceries","",$4.27,$0.00,-$3972.43
"Discover",,C,,09/29/2013,"subway","Food : Restaurants","Food","Restaurants","",$12.86,$0.00,-$3985.29
"Discover",,C,,09/29/2013,"hang tail restaurant","Food : Restaurants","Food","Restaurants","",$33.52,$0.00,-$4018.81
"Discover",,C,,10/01/2013,"Ocean State Joblot","Food : Groceries","Food","Groceries","",$8.84,$0.00,-$4027.65
"Discover",,C,,10/01/2013,"Groupon","Personal : Miscellaneous","Personal","Miscellaneous","",$15.00,$0.00,-$4042.65
"Discover",,C,,10/01/2013,"Planet Fitness","Recreation : His","Recreation","His","",$20.00,$0.00,-$4062.65
"Discover",,C,,10/02/2013,"wbur","Charity : Other","Charity","Other","",$8.00,$0.00,-$4070.65
"Discover",,C,,10/02/2013,"Marlboro dental","Personal : Doctor, Dentist","Personal","Doctor, Dentist","",$599.00,$0.00,-$4669.65
"Discover",,C,,10/03/2013,"Transfer : Avidia Checking",,,,"",$0.00,$2948.87,-$1720.78
"Discover",,C,,10/03/2013,"Exxon mobile","Transportation : Gas","Transportation","Gas","",$28.41,$0.00,-$1749.19
"Discover",,C,,10/04/2013,"Shell","Transportation : Gas","Transportation","Gas","",$32.16,$0.00,-$1781.35
"Discover",,C,,10/04/2013,"Market bskt","Food : Groceries","Food","Groceries","",$110.27,$0.00,-$1891.62
"Discover",,C,,10/06/2013,"shutter fly","Recreation : Entertainment","Recreation","Entertainment","",$10.33,$0.00,-$1901.95
"Discover",,C,,10/06/2013,"reg of motor vehicles","Transportation : Registration","Transportation","Registration","",$50.00,$0.00,-$1951.95
"Discover",,C,,10/06/2013,"aegean restaurant","Food : Restaurants","Food","Restaurants","Mary B-DAY",$216.09,$0.00,-$2168.04
"Discover",,C,,10/11/2013,"Sunoco","Transportation : Gas","Transportation","Gas","",$43.58,$0.00,-$2211.62
"Discover",,C,,10/12/2013,"Hess","Transportation : Gas","Transportation","Gas","",$29.93,$0.00,-$2241.55
"Discover",,C,,10/14/2013,"Railscast","business (bob) : Memberships","Hidden Categories","business (bob) ` Memberships","",$9.00,$0.00,-$2250.55
"Discover",,C,,10/14/2013,"hannaford","Food : Groceries","Food","Groceries","",$126.15,$0.00,-$2376.70
"Discover",,C,,10/15/2013,"USPS","Housing : Supplies","Hidden Categories","Housing ` Supplies","",$2.07,$0.00,-$2378.77
"Discover",,C,,10/15/2013,"shutter fly","Recreation : Entertainment","Recreation","Entertainment","",$6.03,$0.00,-$2384.80
"Discover",,C,,10/15/2013,"Cumberland Farms","Transportation : Gas","Transportation","Gas","",$40.06,$0.00,-$2424.86
"Discover",,C,,10/16/2013,"Five Guys","Food : Restaurants","Food","Restaurants","",$6.74,$0.00,-$2431.60
"Discover",,C,,10/17/2013,"Planet Fitness","Recreation : His","Recreation","His","",$10.00,$0.00,-$2441.60
"Discover",,C,,10/17/2013,"Chipotle","Food : Restaurants","Food","Restaurants","",$10.70,$0.00,-$2452.30
"Discover",,C,,10/17/2013,"stop & shop","Food : Groceries","Food","Groceries","",$10.97,$0.00,-$2463.27
"Discover",,U,,10/18/2013,"Shell","Transportation : Gas","Transportation","Gas","",$29.56,$0.00,-$2492.83
"Discover",,C,,10/19/2013,"Raos Coffee","Food : Restaurants","Food","Restaurants","",$5.41,$0.00,-$2498.24
"Discover",,C,,10/19/2013,"Big Y","Food : Groceries","Food","Groceries","",$9.51,$0.00,-$2507.75
"Discover",,C,,10/19/2013,"Frontera Grill","Food : Restaurants","Food","Restaurants","",$54.18,$0.00,-$2561.93
"Discover",,C,,10/20/2013,"Hot Topic","Recreation : Alyssa","Recreation","Alyssa","",$10.36,$0.00,-$2572.29
"Discover",,C,,10/20/2013,"netflix","Recreation : Entertainment","Recreation","Entertainment","",$16.48,$0.00,-$2588.77
"Discover",,C,,10/21/2013,"shutter fly","Recreation : Entertainment","Recreation","Entertainment","",$5.09,$0.00,-$2593.86
"Discover",,C,,10/21/2013,"USPS","Housing : Supplies","Hidden Categories","Housing ` Supplies","",$6.60,$0.00,-$2600.46
"Discover",,C,,10/21/2013,"Paul's diner","Food : Restaurants","Food","Restaurants","",$12.91,$0.00,-$2613.37
"Discover",,C,,10/21/2013,"Shell","Transportation : Gas","Transportation","Gas","",$44.32,$0.00,-$2657.69
"Discover",,C,,10/21/2013,"reg of motor vehicles","Transportation : Registration","Transportation","Registration","",$50.00,$0.00,-$2707.69
"Discover",,C,,10/22/2013,"haiku","Food : Restaurants","Food","Restaurants","",$34.17,$0.00,-$2741.86
"Discover",,C,,10/22/2013,"hanaford","Food : Groceries","Food","Groceries","",$39.04,$0.00,-$2780.90
"Discover",,C,,10/23/2013,"smilebox","Personal : Gifts","Personal","Gifts","",$6.99,$0.00,-$2787.89
"Discover",,C,,10/23/2013,"Price Chopper","Food : Groceries","Food","Groceries","",$40.94,$0.00,-$2828.83
"Discover",,C,,10/24/2013,"verc enterprise","Transportation : Gas","Transportation","Gas","",$29.11,$0.00,-$2857.94
"Discover",,C,,10/25/2013,"USPS","Housing : Supplies","Hidden Categories","Housing ` Supplies","",$9.20,$0.00,-$2867.14
"Discover",,C,,10/26/2013,"Market bskt","Food : Groceries","Food","Groceries","",$58.45,$0.00,-$2925.59
"Discover",,C,,10/31/2013,"monnick home supplies","Recreation : Alyssa","Recreation","Alyssa","",$8.01,$0.00,-$2933.60
"Discover",,C,,10/31/2013,"albren inc","Transportation : Gas","Transportation","Gas","",$31.17,$0.00,-$2964.77
"Discover",,C,,10/31/2013,"Price Chopper","Food : Groceries","Food","Groceries","",$85.23,$0.00,-$3050.00
"Discover",,C,,11/01/2013,"AC MOORE","Recreation : Alyssa","Recreation","Alyssa","",$29.23,$0.00,-$3079.23
"Discover",,C,,11/01/2013,"Shell","Transportation : Gas","Transportation","Gas","",$46.05,$0.00,-$3125.28
"Discover",,C,,11/01/2013,"hannaford","Food : Groceries","Food","Groceries","",$65.21,$0.00,-$3190.49
"Discover",,C,,11/01/2013,"Rosalina's Kitchen Worcester","Food : Restaurants","Food","Restaurants","",$106.80,$0.00,-$3297.29
"Discover",,C,,11/02/2013,"sperry liquor","Food : Groceries","Food","Groceries","",$12.99,$0.00,-$3310.28
"Discover",,C,,11/02/2013,"masspike","Transportation : tolls","Transportation","tolls","",$45.10,$0.00,-$3355.38
"Discover",,C,,11/04/2013,"Transfer : Avidia Checking",,,,"",$0.00,$2211.62,-$1143.76
"Discover",,C,,11/04/2013,"linguines","Food : Restaurants","Food","Restaurants","",$9.51,$0.00,-$1153.27
"Discover",,C,,11/05/2013,"Price Chopper","Food : Groceries","Food","Groceries","",$3.51,$0.00,-$1156.78
"Discover",,C,,11/06/2013,"LL Bean","Personal : Gifts","Personal","Gifts","",$59.00,$0.00,-$1215.78
"Discover",,C,,11/10/2013,"hannaford","Food : Groceries","Food","Groceries","",$38.56,$0.00,-$1254.34
"Discover",,C,,11/10/2013,"Hess","Transportation : Gas","Transportation","Gas","",$44.92,$0.00,-$1299.26
"Discover",,C,,11/10/2013,"Diva Indian Bistro","Food : Restaurants","Food","Restaurants","",$91.40,$0.00,-$1390.66
"Discover",,C,,11/11/2013,"Amazon","Recreation : Entertainment","Recreation","Entertainment","",$9.99,$0.00,-$1400.65
"Discover",,C,,11/11/2013,"citigo","Housing : Gas","Hidden Categories","Housing ` Gas","",$13.90,$0.00,-$1414.55
"Discover",,C,,11/12/2013,"town of brookline","Transportation : Parking","Transportation","Parking","",$3.00,$0.00,-$1417.55
"Discover",,C,,11/12/2013,"MBTA","Transportation : Public transportation","Transportation","Public transportation","",$5.00,$0.00,-$1422.55
"Discover",,C,,11/12/2013,"wbur","Charity : Other","Charity","Other","",$8.00,$0.00,-$1430.55
"Discover",,C,,11/12/2013,"The vault","Food : Restaurants","Food","Restaurants","",$45.00,$0.00,-$1475.55
"Discover",,C,,11/13/2013,"somba steak","Food : Restaurants","Food","Restaurants","",$23.74,$0.00,-$1499.29
"Discover",,C,,11/14/2013,"A1 auto","Transportation : Repairs & Maintenance","Transportation","Repairs & Maintenance","",$35.35,$0.00,-$1534.64
"Discover",,C,,11/15/2013,"Pride station","Transportation : Gas","Transportation","Gas","",$2.78,$0.00,-$1537.42
"Discover",,C,,11/15/2013,"Groupon","Personal : Miscellaneous","Personal","Miscellaneous","",$29.00,$0.00,-$1566.42
"Discover",,C,,11/15/2013,"Zitis","Food : Restaurants","Food","Restaurants","",$73.90,$0.00,-$1640.32
"Discover",,C,,11/17/2013,"Planet Fitness","Recreation : His","Recreation","His","",$10.00,$0.00,-$1650.32
"Discover",,C,,11/17/2013,"Amazon","Personal : Gifts","Personal","Gifts","",$17.00,$0.00,-$1667.32
"Discover",,C,,11/17/2013,"Amazon","Personal : Gifts","Personal","Gifts","",$34.64,$0.00,-$1701.96
"Discover",,C,,11/17/2013,"Amazon","Personal : Gifts","Personal","Gifts","",$38.87,$0.00,-$1740.83
"Discover",,C,,11/17/2013,"Amazon","Personal : Gifts","Personal","Gifts","",$42.95,$0.00,-$1783.78
"Discover",,C,,11/18/2013,"squishable","Personal : Gifts","Personal","Gifts","",$11.98,$0.00,-$1795.76
"Discover",,C,,11/18/2013,"Amazon","business (bob) : Equipment","Hidden Categories","business (bob) ` Equipment","(Split 1/2) DVI Mini caple",$24.00,$0.00,-$1839.99
"Discover",,C,,11/18/2013,"Amazon","Personal : Miscellaneous","Personal","Miscellaneous","(Split 2/2) ",$20.23,$0.00,-$1839.99
"Discover",,C,,11/20/2013,"netflix","Recreation : Entertainment","Recreation","Entertainment","",$16.48,$0.00,-$1856.47
"Discover",,C,,11/22/2013,"Shell","Food : Restaurants","Food","Restaurants","",$1.99,$0.00,-$1858.46
"Discover",,C,,11/22/2013,"Verill Farm","Food : Groceries","Food","Groceries","",$5.35,$0.00,-$1863.81
"Discover",,C,,11/22/2013,"hannaford","Food : Groceries","Food","Groceries","",$11.48,$0.00,-$1875.29
"Discover",,C,,11/22/2013,"Shell","Transportation : Gas","Transportation","Gas","",$21.81,$0.00,-$1897.10
"Discover",,C,,11/22/2013,"hannaford","Food : Groceries","Food","Groceries","",$107.76,$0.00,-$2004.86
"Discover",,C,,11/23/2013,"smilebox","Personal : Gifts","Personal","Gifts","",$6.99,$0.00,-$2011.85
"Discover",,C,,11/23/2013,"Paypal SOPHIATOLMA","Personal : Gifts","Personal","Gifts","",$23.95,$0.00,-$2035.80
"Discover",,C,,11/23/2013,"Hang Tai too Restaurant Medway Ma","Food : Restaurants","Food","Restaurants","",$28.33,$0.00,-$2064.13
"Discover",,C,,11/24/2013,"Shell","Transportation : Gas","Transportation","Gas","",$45.35,$0.00,-$2109.48
"Discover",,C,,11/25/2013,"verc enterprise","Transportation : Gas","Transportation","Gas","",$31.53,$0.00,-$2141.01
"Discover",,C,,11/26/2013,"Panera Bread","Food : Restaurants","Food","Restaurants","",$4.40,$0.00,-$2145.41
"Discover",,C,,11/26/2013,"Chipotle","Food : Restaurants","Food","Restaurants","",$24.07,$0.00,-$2169.48
"Discover",,C,,11/27/2013,"hannaford","Food : Groceries","Food","Groceries","",$23.78,$0.00,-$2193.26
"Discover",,C,,11/27/2013,"Price Chopper","Food : Groceries","Food","Groceries","",$86.00,$0.00,-$2279.26
"Discover",,C,,11/29/2013,"shoe dpt encore","Personal : cloths","Personal","cloths","",$19.98,$0.00,-$2299.24
"Discover",,C,,11/29/2013,"jcpenney","Personal : cloths","Personal","cloths","",$32.73,$0.00,-$2331.97
"Discover",,C,,11/29/2013,"sears","Personal : cloths","Personal","cloths","",$43.97,$0.00,-$2375.94
"Discover",,C,,11/29/2013,"sears","Personal : cloths","Personal","cloths","",$63.99,$0.00,-$2439.93
"Discover",,C,,11/29/2013,"hannaford","Food : Groceries","Food","Groceries","",$79.67,$0.00,-$2519.60
"Discover",,C,,11/30/2013,"hannaford","Food : Groceries","Food","Groceries","",$7.28,$0.00,-$2526.88
"Discover",,C,,11/30/2013,"hannaford","Food : Groceries","Food","Groceries","",$13.22,$0.00,-$2540.10
"Discover",,C,,12/01/2013,"Shell","Transportation : Gas","Transportation","Gas","",$39.14,$0.00,-$2579.24
"Discover",,C,,12/01/2013,"bella Costa","Food : Restaurants","Food","Restaurants","",$189.41,$0.00,-$2768.65
"Discover",,C,,12/02/2013,"paypal ebay","Personal : Gifts","Personal","Gifts","",$10.65,$0.00,-$2779.30
"Discover",,C,,12/02/2013,"Exxon mobile","Transportation : Gas","Transportation","Gas","",$32.13,$0.00,-$2811.43
"Discover",,C,,12/03/2013,"Transfer : Avidia Checking",,,,"",$0.00,$1384.99,-$1426.44
"Discover",,C,,12/03/2013,"Stan Winston School","Education : College","Education","College","",$32.49,$0.00,-$1458.93
"Discover",,C,,12/03/2013,"Mueng Thai Restaurant Marlboro","Food : Restaurants","Food","Restaurants","",$38.10,$0.00,-$1497.03
"Discover",,C,,12/03/2013,"jcpenney","Housing : Maintenance & Repairs","Hidden Categories","Housing ` Maintenance & Repairs","Blinds For Sun Room",$252.69,$0.00,-$1749.72
"Discover",,C,,12/04/2013,"Bigdogbout","Housing : Dog","Hidden Categories","Housing ` Dog","",$29.90,$0.00,-$1779.62
"Discover",,C,,12/04/2013,"Aidaon Pub","Food : Restaurants","Food","Restaurants","",$35.00,$0.00,-$1814.62
"Discover",,C,,12/04/2013,"verc enterprise","Transportation : Gas","Transportation","Gas","",$45.41,$0.00,-$1860.03
"Discover",,C,,12/04/2013,"target","Personal : Gifts","Personal","Gifts","",$67.88,$0.00,-$1927.91
"Discover",,C,,12/04/2013,"Amazon","Personal : Gifts","Personal","Gifts","",$69.77,$0.00,-$1997.68
"Discover",,C,,12/04/2013,"bella Costa","Food : Restaurants","Food","Restaurants","",$82.99,$0.00,-$2080.67
"Discover",,C,,12/07/2013,"target","Personal : Gifts","Personal","Gifts","",$85.39,$0.00,-$2166.06
"Discover",,C,,12/09/2013,"Ocean State Joblot","Food : Groceries","Food","Groceries","",$21.20,$0.00,-$2187.26
"Discover",,C,,12/09/2013,"Price Chopper","Food : Groceries","Food","Groceries","",$38.35,$0.00,-$2225.61
"Discover",,C,,12/10/2013,"Price Chopper","Food : Groceries","Food","Groceries","",$0.00,$2.99,-$2222.62
"Discover",,C,,12/10/2013,"Price Chopper","Food : Groceries","Food","Groceries","",$2.50,$0.00,-$2225.12
"Discover",,C,,12/14/2013,"Papa Gino's","Food : Restaurants","Food","Restaurants","",$13.89,$0.00,-$2239.01
"Discover",,C,,12/14/2013,"Pride station","Transportation : Gas","Transportation","Gas","",$43.57,$0.00,-$2282.58
"Discover",,C,,12/14/2013,"Girtcards.com","Personal : Gifts","Personal","Gifts","",$63.90,$0.00,-$2346.48
"Discover",,C,,12/14/2013,"hannford","Food : Groceries","Food","Groceries","",$100.31,$0.00,-$2446.79
"Discover",,C,,12/16/2013,"wbur","Charity : Other","Charity","Other","",$8.00,$0.00,-$2454.79
"Discover",,C,,12/16/2013,"Chipotle","Food : Restaurants","Food","Restaurants","",$24.76,$0.00,-$2479.55
"Discover",,C,,12/17/2013,"Planet Fitness","Recreation : His","Recreation","His","",$10.00,$0.00,-$2489.55
"Discover",,C,,12/17/2013,"Apple Tunes","Personal : Gifts","Personal","Gifts","",$25.00,$0.00,-$2514.55
"Discover",,C,,12/18/2013,"hannaford","Food : Groceries","Food","Groceries","",$75.93,$0.00,-$2590.48
"Discover",,C,,12/19/2013,"China Taste","Food : Restaurants","Food","Restaurants","",$41.60,$0.00,-$2632.08
"Discover",,C,,12/19/2013,"Shell","Transportation : Gas","Transportation","Gas","",$41.67,$0.00,-$2673.75
"Discover",,C,,12/20/2013,"netflix","Recreation : Entertainment","Recreation","Entertainment","",$16.48,$0.00,-$2690.23
"Discover",,C,,12/20/2013,"reg of motor vehicles","Transportation : Registration","Transportation","Registration","",$52.00,$0.00,-$2742.23
"Discover",,C,,12/20/2013,"hannaford","Food : Groceries","Food","Groceries","",$70.76,$0.00,-$2812.99
"Discover",,C,,12/21/2013,"target","Personal : Gifts","Personal","Gifts","",$0.00,$14.00,-$2798.99
"Discover",,C,,12/23/2013,"smilebox","Personal : Gifts","Personal","Gifts","",$6.99,$0.00,-$2805.98
"Discover",,C,,12/24/2013,"stop & shop","Food : Groceries","Food","Groceries","",$9.48,$0.00,-$2815.46
"Discover",,C,,12/24/2013,"Shell","Transportation : Gas","Transportation","Gas","",$32.27,$0.00,-$2847.73
"Discover",,C,,12/24/2013,"Shell","Transportation : Gas","Transportation","Gas",,$33.84,$0.00,-$2881.57
"Discover",,C,,12/29/2013,"shaw's Market","Food : Groceries","Food","Groceries","",$16.93,$0.00,-$2898.50
"Discover",,C,,12/29/2013,"Gulf express","Transportation : Gas","Transportation","Gas","",$29.66,$0.00,-$2928.16
"Discover",,C,,12/30/2013,"USPS","Housing : Supplies","Hidden Categories","Housing ` Supplies","",$18.40,$0.00,-$2946.56
"Discover",,C,,12/31/2013,"walgreens","Personal : Miscellaneous","Personal","Miscellaneous","",$14.22,$0.00,-$2960.78
"Discover",,C,,12/31/2013,"hannaford","Food : Groceries","Food","Groceries","",$15.48,$0.00,-$2976.26
"Discover",,C,,12/31/2013,"AAA MARLBOROUGH","Transportation : Repairs & Maintenance","Transportation","Repairs & Maintenance","",$41.50,$0.00,-$3017.76
"Discover",,C,,12/31/2013,"hannaford","Food : Groceries","Food","Groceries","",$215.59,$0.00,-$3233.35
"Discover",,C,,01/03/2014,"Transfer : Avidia Checking",,,,"",$0.00,$2225.12,-$1008.23
"Discover",,C,,01/03/2014,"hannaford","Food : Groceries","Food","Groceries","",$38.38,$0.00,-$1046.61
"Discover",,C,,01/04/2014,"Amazon","Recreation : Entertainment","Recreation","Entertainment","",$5.99,$0.00,-$1052.60
"Discover",,C,,01/04/2014,"Shell","Transportation : Gas","Transportation","Gas","",$48.07,$0.00,-$1100.67
"Discover",,C,,01/05/2014,"Kays","Food : Restaurants","Food","Restaurants","",$48.05,$0.00,-$1148.72
"Discover",,C,,01/06/2014,"AAII","Education : Investing","Education","Investing","",$29.00,$0.00,-$1177.72
"Discover",,C,,01/07/2014,"Brookline Mass","Transportation : Parking","Transportation","Parking","",$7.00,$0.00,-$1184.72
"Discover",,C,,01/08/2014,"walgreens","Personal : Miscellaneous","Personal","Miscellaneous","",$14.85,$0.00,-$1199.57
"Discover",,C,,01/08/2014,"Barnes and Noble","Recreation : Entertainment","Recreation","Entertainment","",$21.24,$0.00,-$1220.81
"Discover",,C,,01/08/2014,"masspike","Transportation : tolls","Transportation","tolls","",$47.55,$0.00,-$1268.36
"Discover",,C,,01/08/2014,"trader Joes","Food : Groceries","Food","Groceries","",$75.56,$0.00,-$1343.92
"Discover",,C,,01/09/2014,"SQ Angelina's Bristol","Food : Restaurants","Food","Restaurants","coffee with Karina",$5.40,$0.00,-$1349.32
"Discover",,C,,01/09/2014,"Shell","Transportation : Gas","Transportation","Gas","",$27.42,$0.00,-$1376.74
"Discover",,C,,01/11/2014,"Berlin Liquor","Food : Groceries","Food","Groceries","Wine",$11.99,$0.00,-$1388.73
"Discover",,C,,01/11/2014,"hannaford","Food : Groceries","Food","Groceries","",$58.57,$0.00,-$1447.30
"Discover",,C,,01/12/2014,"Shell","Transportation : Gas","Transportation","Gas","",$45.41,$0.00,-$1492.71
"Discover",,C,,01/12/2014,"Southwest Airlines","Recreation : Vacation","Recreation","Vacation","Flight to Florida to see mom",$228.00,$0.00,-$1720.71
"Discover",,C,,01/13/2014,"Bertucci","Food : Restaurants","Food","Restaurants","",$22.82,$0.00,-$1743.53
"Discover",,C,,01/13/2014,"Barnes and Noble","Personal : Gifts","Personal","Gifts","",$42.87,$0.00,-$1786.40
"Discover",,C,,01/14/2014,"Hoyt Solomon pond mall","Personal : Gifts","Personal","Gifts","",$39.00,$0.00,-$1825.40
"Discover",,C,,01/14/2014,"welcome India","Food : Restaurants","Food","Restaurants","",$77.15,$0.00,-$1902.55
"Discover",,C,,01/15/2014,"Horseman's exchange","Personal : cloths","Personal","cloths","",$0.00,$31.88,-$1870.67
"Discover",,C,,01/15/2014,"PR Running","Personal : cloths","Personal","cloths","",$119.99,$0.00,-$1990.66
"Discover",,C,,01/16/2014,"Brookline Mass","Personal : Miscellaneous","Personal","Miscellaneous","",$19.85,$0.00,-$2010.51
"Discover",,C,,01/17/2014,"Amazon","Recreation : Entertainment","Recreation","Entertainment","",$5.99,$0.00,-$2016.50
"Discover",,C,,01/17/2014,"wbur","Charity : Other","Charity","Other","",$8.00,$0.00,-$2024.50
"Discover",,C,,01/17/2014,"Planet Fitness","Recreation : His","Recreation","His","",$10.00,$0.00,-$2034.50
"Discover",,C,,01/17/2014,"Price Chopper","Food : Groceries","Food","Groceries","",$80.77,$0.00,-$2115.27
"Discover",,C,,01/18/2014,"Shell","Transportation : Gas","Transportation","Gas","",$30.59,$0.00,-$2145.86
"Discover",,C,,01/19/2014,"Amazon","Recreation : Entertainment","Recreation","Entertainment","",$4.99,$0.00,-$2150.85
"Discover",,C,,01/19/2014,"Chipotle","Food : Restaurants","Food","Restaurants","",$24.33,$0.00,-$2175.18
"Discover",,C,,01/20/2014,"netflix","Recreation : Entertainment","Recreation","Entertainment","",$16.48,$0.00,-$2191.66
"Discover",,C,,01/21/2014,"hannaford","Food : Groceries","Food","Groceries","",$33.85,$0.00,-$2225.51
"Discover",,C,,01/24/2014,"Worcester Art Museum","Recreation : Entertainment","Recreation","Entertainment","",$18.00,$0.00,-$2243.51
"Discover",,C,,01/24/2014,"wild horsefeathers","Personal : Gifts","Personal","Gifts","",$20.90,$0.00,-$2264.41
"Discover",,C,,01/26/2014,"Barnes and Noble","Personal : Gifts","Personal","Gifts","",$0.00,$29.11,-$2235.30
"Discover",,C,,01/26/2014,"Barnes and Noble","Personal : Gifts","Personal","Gifts","",$0.00,$21.24,-$2214.06
"Discover",,C,,01/26/2014,"hannaford","Food : Groceries","Food","Groceries","",$53.09,$0.00,-$2267.15
"Discover",,C,,01/26/2014,"jcpenney","Housing : Maintenance & Repairs","Hidden Categories","Housing ` Maintenance & Repairs","",$55.74,$0.00,-$2322.89
"Discover",,C,,01/27/2014,"Sim u Text Course Mate","Education : College","Education","College","books?",$25.00,$0.00,-$2347.89
"Discover",,C,,01/29/2014,"College Board","Education : College","Education","College","??",$22.50,$0.00,-$2370.39
"Discover",,C,,01/29/2014,"hannaford","Food : Groceries","Food","Groceries","",$72.97,$0.00,-$2443.36
"Discover",,C,,01/30/2014,"Shell","Transportation : Gas","Transportation","Gas","",$47.76,$0.00,-$2491.12
"Discover",,C,,01/30/2014,"Breathe Wellness","Recreation : Entertainment","Recreation","Entertainment","",$120.00,$0.00,-$2611.12
"Discover",,C,,01/31/2014,"Backdoor vacuum shope","Housing : Supplies","Hidden Categories","Housing ` Supplies","??",$23.85,$0.00,-$2634.97
"Discover",,C,,01/31/2014,"sassy fox","Personal : cloths","Personal","cloths","",$26.07,$0.00,-$2661.04
"Discover",,C,,01/31/2014,"Intuit Turbo tax","Personal : Miscellaneous","Personal","Miscellaneous","",$84.99,$0.00,-$2746.03
"Discover",,C,,02/01/2014,"slideroom.com","Education : College","Education","College","",$18.00,$0.00,-$2764.03
"Discover",,C,,02/03/2014,"Sunoco","Transportation : Gas","Transportation","Gas","",$29.31,$0.00,-$2793.34
"Discover",,C,,02/04/2014,"Transfer : Avidia Checking",,,,"",$0.00,$1447.30,-$1346.04
"Discover",,C,,02/04/2014,"hannaford","Food : Groceries","Food","Groceries","",$10.06,$0.00,-$1356.10
"Discover",,C,,02/08/2014,"Brookline Mass","Transportation : Parking","Transportation","Parking","",$0.50,$0.00,-$1356.60
"Discover",,C,,02/08/2014,"Sunset Cantina","Food : Restaurants","Food","Restaurants","",$44.49,$0.00,-$1401.09
"Discover",,C,,02/09/2014,"Chipotle","Food : Restaurants","Food","Restaurants","",$24.76,$0.00,-$1425.85
"Discover",,C,,02/09/2014,"Shell","Transportation : Gas","Transportation","Gas","",$42.28,$0.00,-$1468.13
"Discover",,C,,02/10/2014,"Sunoco","Transportation : Gas","Transportation","Gas","",$32.28,$0.00,-$1500.41
"Discover",,C,,02/10/2014,"hannaford","Food : Groceries","Food","Groceries","",$50.62,$0.00,-$1551.03
"Discover",,C,,02/11/2014,"Price Chopper","Food : Groceries","Food","Groceries","",$2.99,$0.00,-$1554.02
"Discover",,C,,02/11/2014,"USPS","Housing : Supplies","Hidden Categories","Housing ` Supplies","",$6.50,$0.00,-$1560.52
"Discover",,C,,02/12/2014,"publix","Food : Groceries","Food","Groceries","",$40.44,$0.00,-$1600.96
"Discover",,C,,02/14/2014,"etsy","Personal : Gifts","Personal","Gifts","",$25.00,$0.00,-$1625.96
"Discover",,C,,02/14/2014,"rite aid","Personal : Prescriptions, Medicine","Personal","Prescriptions, Medicine","",$59.95,$0.00,-$1685.91
"Discover",,C,,02/15/2014,"wbur","Charity : Other","Charity","Other","",$8.00,$0.00,-$1693.91
"Discover",,C,,02/16/2014,"Intuit Turbo tax","Personal : Miscellaneous","Personal","Miscellaneous","",$19.99,$0.00,-$1713.90
"Discover",,C,,02/16/2014,"Cumberland Farms","Transportation : Gas","Transportation","Gas","",$26.64,$0.00,-$1740.54
"Discover",,C,,02/17/2014,"save a lot","Food : Groceries","Food","Groceries","",$7.86,$0.00,-$1748.40
"Discover",,C,,02/17/2014,"Planet Fitness","Recreation : His","Recreation","His","",$10.00,$0.00,-$1758.40
"Discover",,C,,02/18/2014,"publix","Food : Groceries","Food","Groceries","",$15.81,$0.00,-$1774.21
"Discover",,C,,02/20/2014,"netflix","Recreation : Entertainment","Recreation","Entertainment","",$16.48,$0.00,-$1790.69
"Discover",,C,,02/20/2014,"publix","Food : Groceries","Food","Groceries","",$41.92,$0.00,-$1832.61
"Discover",,C,,02/21/2014,"subway","Food : Restaurants","Food","Restaurants","",$14.74,$0.00,-$1847.35
"Discover",,C,,02/21/2014,"public America","Transportation : Gas","Transportation","Gas","",$34.19,$0.00,-$1881.54
"Discover",,C,,02/21/2014,"American Scientific","Recreation : Entertainment","Recreation","Entertainment","",$34.97,$0.00,-$1916.51
"Discover",,C,,02/22/2014,"Chipotle","Food : Restaurants","Food","Restaurants","",$14.13,$0.00,-$1930.64
"Discover",,C,,02/22/2014,"verc enterprise","Transportation : Gas","Transportation","Gas","",$26.17,$0.00,-$1956.81
"Discover",,C,,02/24/2014,"save a lot","Food : Groceries","Food","Groceries","",$4.48,$0.00,-$1961.29
"Discover",,C,,02/25/2014,"verc enterprise","Transportation : Gas","Transportation","Gas","",$32.33,$0.00,-$1993.62
"Discover",,C,,02/26/2014,"stop & shop","Food : Groceries","Food","Groceries","",$95.78,$0.00,-$2089.40
"Discover",,C,,02/27/2014,"Officemax","Lisa Business : Business expenses","Lisa Business","Business expenses","INK",$28.68,$0.00,-$2118.08
"Discover",,C,,02/27/2014,"aegean restaurant","Food : Restaurants","Food","Restaurants","",$60.83,$0.00,-$2178.91
"Discover",,C,,02/28/2014,"Strand theatre","Food : Restaurants","Food","Restaurants","",$25.93,$0.00,-$2204.84
"Discover",,C,,03/02/2014,"slideroom.com","Personal : Gifts","Personal","Gifts","",$10.00,$0.00,-$2214.84
"Discover",,C,,03/02/2014,"Exxon mobile","Transportation : Gas","Transportation","Gas","",$29.51,$0.00,-$2244.35
"Discover",,C,,03/03/2014,"USPS","Housing : Supplies","Hidden Categories","Housing ` Supplies","",$3.93,$0.00,-$2248.28
"Discover",,C,,03/03/2014,"Basha","Food : Groceries","Food","Groceries","",$48.95,$0.00,-$2297.23
"Discover",,C,,03/03/2014,"hannaford","Food : Groceries","Food","Groceries","",$64.57,$0.00,-$2361.80
"Discover",,C,,03/04/2014,"Amazon","Recreation : Entertainment","Recreation","Entertainment","",$39.00,$0.00,-$2400.80
"Discover",,C,,03/05/2014,"Gulf express","Transportation : Gas","Transportation","Gas","",$30.07,$0.00,-$2430.87
"Discover",,C,,03/06/2014,"Transfer : Dcu Checking",,,,"",$0.00,$1560.52,-$870.35
"Discover",,C,,03/06/2014,"beehive Bristol","Food : Restaurants","Food","Restaurants","",$18.08,$0.00,-$888.43
"Discover",,C,,03/07/2014,"hanaford","Food : Groceries","Food","Groceries","",$28.95,$0.00,-$917.38
"Discover",,C,,03/08/2014,"Tailgate Picnic","Food : Restaurants","Food","Restaurants","",$5.05,$0.00,-$922.43
"Discover",,C,,03/08/2014,"Shell","Transportation : Gas","Transportation","Gas","",$47.32,$0.00,-$969.75
"Discover",,C,,03/08/2014,"La Casita Aztec","Food : Restaurants","Food","Restaurants","",$86.33,$0.00,-$1056.08
"Discover",,C,,03/08/2014,"Market bskt","Food : Groceries","Food","Groceries","",$115.69,$0.00,-$1171.77
"Discover",,C,,03/11/2014,"wbur","Charity : Other","Charity","Other","",$8.00,$0.00,-$1179.77
"Discover",,C,,03/14/2014,"USPS","Housing : Supplies","Hidden Categories","Housing ` Supplies","",$2.32,$0.00,-$1182.09
"Discover",,C,,03/14/2014,"Ocean State Joblot","Food : Groceries","Food","Groceries","",$21.47,$0.00,-$1203.56
"Discover",,C,,03/14/2014,"College Board","Education : College","Education","College","",$73.00,$0.00,-$1276.56
"Discover",,C,,03/16/2014,"New England Sports","Recreation : Alyssa","Recreation","Alyssa","Skate sharpening",$12.00,$0.00,-$1288.56
"Discover",,C,,03/17/2014,"Planet Fitness","Recreation : His","Recreation","His","",$10.00,$0.00,-$1298.56
"Discover",,C,,03/17/2014,"verc enterprise","Transportation : Gas","Transportation","Gas","",$32.70,$0.00,-$1331.26
"Discover",,C,,03/18/2014,"Shell","Transportation : Gas","Transportation","Gas","",$47.87,$0.00,-$1379.13
"Discover",,C,,03/19/2014,"Price Chopper","Food : Groceries","Food","Groceries","",$12.44,$0.00,-$1391.57
"Discover",,C,,03/19/2014,"Price Chopper","Food : Groceries","Food","Groceries","",$55.04,$0.00,-$1446.61
"Discover",,C,,03/19/2014,"hannaford","Food : Groceries","Food","Groceries","",$79.64,$0.00,-$1526.25
"Discover",,C,,03/20/2014,"netflix","Recreation : Entertainment","Recreation","Entertainment","",$16.48,$0.00,-$1542.73
"Discover",,C,,03/20/2014,"A1 auto","Transportation : Repairs & Maintenance","Transportation","Repairs & Maintenance","",$36.85,$0.00,-$1579.58
"Discover",,C,,03/20/2014,"Collegeboard","Education : College","Education","College","",$56.25,$0.00,-$1635.83
"Discover",,C,,03/21/2014,"hanaford","Food : Groceries","Food","Groceries","",$25.74,$0.00,-$1661.57
"Discover",,C,,03/21/2014,"Alfred University","Education : College","Education","College","",$50.00,$0.00,-$1711.57
"Discover",,C,,03/21/2014,"Clark university","Education : College","Education","College","",$60.00,$0.00,-$1771.57
"Discover",,C,,03/21/2014,"Umass Dartmouth","Education : College","Education","College","",$60.00,$0.00,-$1831.57
"Discover",,C,,03/21/2014,"Uconn","Education : College","Education","College","",$70.00,$0.00,-$1901.57
"Discover",,C,,03/21/2014,"North Eastern University","Education : College","Education","College","",$75.00,$0.00,-$1976.57
"Discover",,C,,03/22/2014,"USPS","Housing : Supplies","Hidden Categories","Housing ` Supplies","",$2.50,$0.00,-$1979.07
"Discover",,C,,03/22/2014,"hannaford","Food : Groceries","Food","Groceries","",$3.99,$0.00,-$1983.06
"Discover",,C,,03/22/2014,"Price Chopper","Food : Groceries","Food","Groceries","",$8.09,$0.00,-$1991.15
"Discover",,C,,03/22/2014,"Chipotle","Food : Restaurants","Food","Restaurants","",$8.18,$0.00,-$1999.33
"Discover",,C,,03/22/2014,"Post Rd Art","Recreation : His","Recreation","His","Paint supplies",$12.86,$0.00,-$2012.19
"Discover",,C,,03/22/2014,"Ocean State Joblot","Recreation : His","Recreation","His","Paint canvases",$13.05,$0.00,-$2025.24
"Discover",,C,,03/22/2014,"gulf mart","Transportation : Gas","Transportation","Gas","",$28.41,$0.00,-$2053.65
"Discover",,C,,03/23/2014,"slideroom.com","Education : College","Education","College","",$12.00,$0.00,-$2065.65
"Discover",,C,,03/23/2014,"Cumberland Farms","Transportation : Gas","Transportation","Gas","",$44.81,$0.00,-$2110.46
"Discover",,C,,03/24/2014,"USPS","Housing : Supplies","Hidden Categories","Housing ` Supplies","",$7.35,$0.00,-$2117.81
"Discover",,C,,03/24/2014,"walgreens","Personal : Miscellaneous","Personal","Miscellaneous","",$14.22,$0.00,-$2132.03
"Discover",,C,,03/24/2014,"Hess","Transportation : Gas","Transportation","Gas","",$27.44,$0.00,-$2159.47
"Discover",,C,,03/27/2014,"Country Butcher","Food : Groceries","Food","Groceries","",$18.87,$0.00,-$2178.34
"Discover",,C,,03/27/2014,"Littlleton Agway","Housing : Garden","Hidden Categories","Housing ` Garden","",$24.28,$0.00,-$2202.62
"Discover",,C,,03/28/2014,"Cts Store Shrewsbury","Housing : Supplies","Hidden Categories","Housing ` Supplies","",$30.92,$0.00,-$2233.54
"Discover",,C,,03/30/2014,"Cape Cod Gas","Transportation : Gas","Transportation","Gas","",$47.75,$0.00,-$2281.29
"Discover",,C,,03/30/2014,"CTS Store Hyannis ma","Lisa Business : Business expenses","Lisa Business","Business expenses","",$79.77,$0.00,-$2361.06
"Discover",,C,,03/31/2014,"Home Depot","Lisa Business : Supplies","Lisa Business","Supplies","",$44.14,$0.00,-$2405.20
"Discover",,C,,04/01/2014,"Shell","Transportation : Gas","Transportation","Gas","",$32.17,$0.00,-$2437.37
"Discover",,C,,04/01/2014,"Market bskt","Food : Groceries","Food","Groceries","",$98.74,$0.00,-$2536.11
"Discover",,C,,04/02/2014,"Chipotle","Food : Restaurants","Food","Restaurants","",$10.00,$0.00,-$2546.11
"Discover",,C,,04/03/2014,"USPS","Housing : Supplies","Hidden Categories","Housing ` Supplies","",$3.22,$0.00,-$2549.33
"Discover",,C,,04/03/2014,"hannaford","Food : Groceries","Food","Groceries","",$9.34,$0.00,-$2558.67
"Discover",,C,,04/04/2014,"Shell","Transportation : Gas","Transportation","Gas","",$46.70,$0.00,-$2605.37
"Discover",,C,,04/04/2014,"Yama Zakura","Food : Restaurants","Food","Restaurants","",$92.51,$0.00,-$2697.88
"Discover",,C,,04/07/2014,"Transfer : Dcu Checking",,,,"",$0.00,$1179.77,-$1518.11
"Discover",,C,,04/07/2014,"shutter fly","Recreation : Entertainment","Recreation","Entertainment","",$6.10,$0.00,-$1524.21
"Discover",,C,,04/08/2014,"Groupon","Personal : Miscellaneous","Personal","Miscellaneous","",$20.00,$0.00,-$1544.21
"Discover",,C,,04/08/2014,"hannaford","Food : Groceries","Food","Groceries","",$82.45,$0.00,-$1626.66
"Discover",,C,,04/08/2014,"Groupon","business (bob) : Real Estate","Hidden Categories","business (bob) ` Real Estate","Groupon for RE class",$175.00,$0.00,-$1801.66
"Discover",,C,,04/09/2014,"McDonalds","Food : Restaurants","Food","Restaurants","",$1.61,$0.00,-$1803.27
"Discover",,C,,04/09/2014,"Moe's","Food : Restaurants","Food","Restaurants","",$11.00,$0.00,-$1814.27
"Discover",,C,,04/11/2014,"wbur","Charity : Other","Charity","Other","",$8.00,$0.00,-$1822.27
"Discover",,C,,04/14/2014,"McDonalds","Food : Restaurants","Food","Restaurants","",$7.99,$0.00,-$1830.26
"Discover",,C,,04/14/2014,"Chipotle","Food : Restaurants","Food","Restaurants","",$24.50,$0.00,-$1854.76
"Discover",,C,,04/14/2014,"Ward's Florist and Green Berverly","Housing : Garden","Hidden Categories","Housing ` Garden","",$27.98,$0.00,-$1882.74
"Discover",,C,,04/14/2014,"Berverly Gas","Transportation : Gas","Transportation","Gas","",$44.05,$0.00,-$1926.79
"Discover",,C,,04/14/2014,"hannaford","Food : Groceries","Food","Groceries","",$125.66,$0.00,-$2052.45
"Discover",,C,,04/15/2014,"Shell","Transportation : Gas","Transportation","Gas","",$33.98,$0.00,-$2086.43
"Discover",,C,,04/15/2014,"trader Joes","Food : Groceries","Food","Groceries","",$111.34,$0.00,-$2197.77
"Discover",,C,,04/16/2014,"McDonalds","Food : Restaurants","Food","Restaurants","",$1.07,$0.00,-$2198.84
"Discover",,C,,04/16/2014,"Anna's Pizza","Food : Restaurants","Food","Restaurants","",$5.77,$0.00,-$2204.61
"Discover",,C,,04/17/2014,"Planet Fitness","Recreation : His","Recreation","His","",$10.00,$0.00,-$2214.61
"Discover",,C,,04/17/2014,"lowes","Lisa Business : Supplies","Lisa Business","Supplies","",$50.68,$0.00,-$2265.29
"Discover",,C,,04/19/2014,"stop & shop","Food : Groceries","Food","Groceries","",$26.67,$0.00,-$2291.96
"Discover",,C,,04/19/2014,"Shell","Transportation : Gas","Transportation","Gas","",$48.93,$0.00,-$2340.89
"Discover",,C,,04/20/2014,"netflix","Recreation : Entertainment","Recreation","Entertainment","",$16.48,$0.00,-$2357.37
"Discover",,C,,04/20/2014,"Price Chopper","Food : Groceries","Food","Groceries","",$41.10,$0.00,-$2398.47
"Discover",,C,,04/21/2014,"masspike","Transportation : tolls","Transportation","tolls","",$45.80,$0.00,-$2444.27
"Discover",,C,,04/23/2014,"hannaford","Food : Groceries","Food","Groceries","",$63.81,$0.00,-$2508.08
"Discover",,C,,04/24/2014,"Brookline Mass","Transportation : Parking","Transportation","Parking","",$3.00,$0.00,-$2511.08
"Discover",,C,,04/24/2014,"Brookline Mass","Transportation : Parking","Transportation","Parking","",$3.00,$0.00,-$2514.08
"Discover",,C,,04/25/2014,"hanaford","Food : Groceries","Food","Groceries","",$37.02,$0.00,-$2551.10
"Discover",,C,,04/25/2014,"Shell","Transportation : Gas","Transportation","Gas","",$49.75,$0.00,-$2600.85
"Discover",,C,,04/27/2014,"Exxon mobile","Transportation : Gas","Transportation","Gas","",$34.08,$0.00,-$2634.93
"Discover",,C,,04/29/2014,"Pet Source","Housing : Dog","Hidden Categories","Housing ` Dog","",$5.17,$0.00,-$2640.10
"Discover",,C,,04/30/2014,"Uconn","Education : College","Education","College","",$153.75,$0.00,-$2793.85
"Discover",,C,,05/04/2014,"hannaford","Food : Groceries","Food","Groceries","",$75.03,$0.00,-$2868.88
"Discover",,C,,05/05/2014,"Pride station","Transportation : Gas","Transportation","Gas","",$27.43,$0.00,-$2896.31
"Discover",,C,,05/05/2014,"IYA Sushi and Noodle S. Hadley","Food : Restaurants","Food","Restaurants","",$52.24,$0.00,-$2948.55
"Discover",,C,,05/06/2014,"Transfer : Dcu Checking",,,,"",$0.00,$1822.27,-$1126.28
"Discover",,C,,05/06/2014,"hanaford","Food : Groceries","Food","Groceries","",$18.70,$0.00,-$1144.98
"Discover",,C,,05/06/2014,"Shell","Transportation : Gas","Transportation","Gas","",$41.11,$0.00,-$1186.09
"Discover",,C,,05/07/2014,"Chipotle","Food : Restaurants","Food","Restaurants","",$10.00,$0.00,-$1196.09
"Discover",,C,,05/07/2014,"Qdoba","Food : Restaurants","Food","Restaurants","",$21.19,$0.00,-$1217.28
"Discover",,C,,05/08/2014,"Chipotle","Food : Restaurants","Food","Restaurants","",$21.56,$0.00,-$1238.84
"Discover",,C,,05/08/2014,"Marlborough Super Buffet","Food : Restaurants","Food","Restaurants","",$48.76,$0.00,-$1287.60
"Discover",,C,,05/09/2014,"Cumberland Farms","Transportation : Gas","Transportation","Gas","",$32.00,$0.00,-$1319.60
"Discover",,C,,05/09/2014,"hannaford","Food : Groceries","Food","Groceries","",$82.61,$0.00,-$1402.21
"Discover",,C,,05/11/2014,"hannaford","Food : Groceries","Food","Groceries","",$87.91,$0.00,-$1490.12
"Discover",,C,,05/13/2014,"wbur","Charity : Other","Charity","Other","",$8.00,$0.00,-$1498.12
"Discover",,C,,05/13/2014,"Southwest Airlines","Recreation : Vacation","Recreation","Vacation","",$99.00,$0.00,-$1597.12
"Discover",,C,,05/13/2014,"Southwest Airlines","Recreation : Vacation","Recreation","Vacation","",$198.00,$0.00,-$1795.12
"Discover",,C,,05/14/2014,"Honey Dew","Food : Restaurants","Food","Restaurants","",$1.50,$0.00,-$1796.62
"Discover",,C,,05/14/2014,"Honey Dew","Food : Groceries","Food","Groceries","",$4.92,$0.00,-$1801.54
"Discover",,C,,05/15/2014,"hannaford","Food : Groceries","Food","Groceries","",$8.04,$0.00,-$1809.58
"Discover",,C,,05/16/2014,"Shell","Transportation : Gas","Transportation","Gas","",$35.24,$0.00,-$1844.82
"Discover",,C,,05/16/2014,"Shell","Transportation : Gas","Transportation","Gas","",$53.87,$0.00,-$1898.69
"Discover",,C,,05/16/2014,"hannaford","Food : Groceries","Food","Groceries","",$55.40,$0.00,-$1954.09
"Discover",,C,,05/17/2014,"Planet Fitness","Recreation : His","Recreation","His","",$10.00,$0.00,-$1964.09
"Discover",,C,,05/17/2014,"hanaford","Food : Groceries","Food","Groceries","",$129.74,$0.00,-$2093.83
"Discover",,C,,05/18/2014,"sperry liquor","Food : Groceries","Food","Groceries","",$27.98,$0.00,-$2121.81
"Discover",,C,,05/20/2014,"netflix","Recreation : Entertainment","Recreation","Entertainment","",$16.48,$0.00,-$2138.29
"Discover",,C,,05/21/2014,"Uconn co-op","Education : College","Education","College","",$10.58,$0.00,-$2148.87
"Discover",,C,,05/21/2014,"Moe's","Food : Restaurants","Food","Restaurants","",$22.29,$0.00,-$2171.16
"Discover",,C,,05/22/2014,"Apple Store","business (bob) : Equipment","Hidden Categories","business (bob) ` Equipment","",$30.81,$0.00,-$2201.97
"Discover",,C,,05/22/2014,"A1 auto","Transportation : Repairs & Maintenance","Transportation","Repairs & Maintenance","",$34.35,$0.00,-$2236.32
"Discover",,C,,05/22/2014,"trader Joes","Food : Groceries","Food","Groceries","",$77.67,$0.00,-$2313.99
"Discover",,C,,05/24/2014,"Stop & Shop Fuel","Transportation : Gas","Transportation","Gas","",$31.71,$0.00,-$2345.70
"Discover",,C,,05/24/2014,"walgreens","Personal : Miscellaneous","Personal","Miscellaneous","",$37.16,$0.00,-$2382.86
"Discover",,C,,05/24/2014,"hannaford","Food : Groceries","Food","Groceries","",$89.14,$0.00,-$2472.00
"Discover",,C,,05/25/2014,"McDonalds","Food : Restaurants","Food","Restaurants","",$6.28,$0.00,-$2478.28
"Discover",,C,,05/26/2014,"Market bskt","Food : Groceries","Food","Groceries","",$87.11,$0.00,-$2565.39
"Discover",,C,,05/28/2014,"A1 auto","Transportation : Repairs & Maintenance","Transportation","Repairs & Maintenance","",$46.91,$0.00,-$2612.30
"Discover",,C,,05/29/2014,"Super Shuttle","Recreation : His","Recreation","His","",$39.00,$0.00,-$2651.30
"Discover",,C,,05/30/2014,"hannaford","Food : Groceries","Food","Groceries","",$28.42,$0.00,-$2679.72
"Discover",,C,,05/30/2014,"verc enterprise","Transportation : Gas","Transportation","Gas","",$35.21,$0.00,-$2714.93
"Discover",,C,,05/30/2014,"Shell","Transportation : Gas","Transportation","Gas","",$48.19,$0.00,-$2763.12
"Discover",,C,,06/01/2014,"hannaford","Food : Groceries","Food","Groceries","",$13.68,$0.00,-$2776.80
"Discover",,C,,06/02/2014,"save--lot","Food : Groceries","Food","Groceries","",$6.93,$0.00,-$2783.73
"Discover",,C,,06/03/2014,"Kings Point","Recreation : His","Recreation","His","",$13.00,$0.00,-$2796.73
"Discover",,C,,06/03/2014,"Lincoln Street Gulf","Transportation : Gas","Transportation","Gas","",$30.53,$0.00,-$2827.26
"Discover",,C,,06/03/2014,"russells garden center","Housing : Supplies","Hidden Categories","Housing ` Supplies","plants?",$38.20,$0.00,-$2865.46
"Discover",,C,,06/05/2014,"walgreens","Personal : Miscellaneous","Personal","Miscellaneous","",$95.97,$0.00,-$2961.43
"Discover",,C,,06/06/2014,"Transfer : Dcu Checking",,,,"",$0.00,$1490.12,-$1471.31
"Discover",,C,,06/06/2014,"samba steak & Sushi","Food : Restaurants","Food","Restaurants","",$56.41,$0.00,-$1527.72
"Discover",,C,,06/06/2014,"hannaford","Food : Groceries","Food","Groceries","",$91.59,$0.00,-$1619.31
"Discover",,C,,06/07/2014,"Publix Super market","Food : Groceries","Food","Groceries","",$24.54,$0.00,-$1643.85
"Discover",,C,,06/07/2014,"verc enterprise","Transportation : Gas","Transportation","Gas","",$31.20,$0.00,-$1675.05
"Discover",,C,,06/08/2014,"winn-dixie","Food : Groceries","Food","Groceries","",$5.48,$0.00,-$1680.53
"Discover",,C,,06/08/2014,"save a lot","Food : Groceries","Food","Groceries","",$27.42,$0.00,-$1707.95
"Discover",,C,,06/09/2014,"Boston Market","Food : Restaurants","Food","Restaurants","",$15.28,$0.00,-$1723.23
"Discover",,C,,06/10/2014,"Boston Market","Food : Restaurants","Food","Restaurants","",$0.00,$3.00,-$1720.23
"Discover",,C,,06/10/2014,"save a lot","Food : Groceries","Food","Groceries","",$4.47,$0.00,-$1724.70
"Discover",,C,,06/10/2014,"USPS","Housing : Supplies","Hidden Categories","Housing ` Supplies","",$9.80,$0.00,-$1734.50
"Discover",,C,,06/11/2014,"wbur","Charity : Other","Charity","Other","",$8.00,$0.00,-$1742.50
"Discover",,C,,06/11/2014,"Price Chopper","Food : Groceries","Food","Groceries","",$34.43,$0.00,-$1776.93
"Discover",,C,,06/13/2014,"Strand theatre","Food : Restaurants","Food","Restaurants","",$1.59,$0.00,-$1778.52
"Discover",,C,,06/13/2014,"Strand theatre","Food : Restaurants","Food","Restaurants","",$27.31,$0.00,-$1805.83
"Discover",,C,,06/13/2014,"Home Depot","Housing : Supplies","Hidden Categories","Housing ` Supplies","",$33.11,$0.00,-$1838.94
"Discover",,C,,06/13/2014,"Shell","Transportation : Gas","Transportation","Gas","",$33.37,$0.00,-$1872.31
"Discover",,C,,06/14/2014,"Amazon","Recreation : Entertainment","Recreation","Entertainment","",$2.99,$0.00,-$1875.30
"Discover",,C,,06/14/2014,"starbucks","Food : Restaurants","Food","Restaurants","",$4.61,$0.00,-$1879.91
"Discover",,C,,06/15/2014,"hannaford","Food : Groceries","Food","Groceries","",$4.59,$0.00,-$1884.50
"Discover",,C,,06/16/2014,"shutter fly","Recreation : Entertainment","Recreation","Entertainment","",$6.10,$0.00,-$1890.60
"Discover",,C,,06/16/2014,"hannaford","Food : Groceries","Food","Groceries","",$47.52,$0.00,-$1938.12
"Discover",,C,,06/16/2014,"hannaford","Food : Groceries","Food","Groceries","",$97.06,$0.00,-$2035.18
"Discover",,C,,06/17/2014,"Planet Fitness","Recreation : His","Recreation","His","",$10.00,$0.00,-$2045.18
"Discover",,C,,06/17/2014,"Especially For Pets","Housing : Dog","Hidden Categories","Housing ` Dog","",$22.09,$0.00,-$2067.27
"Discover",,C,,06/18/2014,"Hess","Transportation : Gas","Transportation","Gas","",$32.83,$0.00,-$2100.10
"Discover",,C,,06/18/2014,"Pllow and hearth","Personal : Gifts","Personal","Gifts","grammy",$55.94,$0.00,-$2156.04
"Discover",,C,,06/18/2014,"Worcester Art Museum","Recreation : Entertainment","Recreation","Entertainment","",$80.00,$0.00,-$2236.04
"Discover",,C,,06/19/2014,"Groupon","Recreation : Alyssa","Recreation","Alyssa","",$5.00,$0.00,-$2241.04
"Discover",,C,,06/19/2014,"Groupon","Recreation : Alyssa","Recreation","Alyssa","",$9.99,$0.00,-$2251.03
"Discover",,C,,06/19/2014,"Groupon","Recreation : Alyssa","Recreation","Alyssa","",$19.00,$0.00,-$2270.03
"Discover",,C,,06/20/2014,"netflix","Recreation : Entertainment","Recreation","Entertainment","",$16.48,$0.00,-$2286.51
"Discover",,C,,06/20/2014,"Price Chopper","Food : Groceries","Food","Groceries","",$74.44,$0.00,-$2360.95
"Discover",,C,,06/21/2014,"shutter fly","Recreation : Entertainment","Recreation","Entertainment","",$3.05,$0.00,-$2364.00
"Discover",,C,,06/23/2014,"Uconn orientation","Education : College","Education","College","",$153.75,$0.00,-$2517.75
"Discover",,C,,06/24/2014,"Milford Ace Hardware","Lisa Business : Supplies","Lisa Business","Supplies","",$0.00,$23.67,-$2494.08
"Discover",,C,,06/24/2014,"Milford Ace Hardware","Lisa Business : Supplies","Lisa Business","Supplies","",$0.00,$1.70,-$2492.38
"Discover",,C,,06/24/2014,"Milford Ace Hardware","Lisa Business : Supplies","Lisa Business","Supplies","",$4.98,$0.00,-$2497.36
"Discover",,C,,06/24/2014,"Milford Ace Hardware","Lisa Business : Supplies","Lisa Business","Supplies","",$31.74,$0.00,-$2529.10
"Discover",,C,,06/25/2014,"hannaford","Food : Groceries","Food","Groceries","",$39.91,$0.00,-$2569.01
"Discover",,C,,06/25/2014,"Ocean State Joblot","Food : Groceries","Food","Groceries","(Split 1/2) ",$25.00,$0.00,-$2618.54
"Discover",,C,,06/25/2014,"Ocean State Joblot","Housing : Supplies","Hidden Categories","Housing ` Supplies","(Split 2/2) ",$24.53,$0.00,-$2618.54
"Discover",,C,,06/25/2014,"Price Chopper","Food : Groceries","Food","Groceries","",$50.55,$0.00,-$2669.09
"Discover",,C,,06/27/2014,"sperry liquor","Food : Groceries","Food","Groceries","",$17.00,$0.00,-$2686.09
"Discover",,C,,06/27/2014,"Shell","Transportation : Gas","Transportation","Gas","",$34.63,$0.00,-$2720.72
"Discover",,C,,06/28/2014,"stop & shop","Food : Groceries","Food","Groceries","",$62.53,$0.00,-$2783.25
"Discover",,C,,06/29/2014,"Davidian Broethers","Food : Restaurants","Food","Restaurants","",$27.25,$0.00,-$2810.50
"Discover",,C,,06/29/2014,"verc enterprise","Transportation : Gas","Transportation","Gas","",$34.47,$0.00,-$2844.97
"Discover",,C,,07/01/2014,"hannaford","Food : Groceries","Food","Groceries","",$43.69,$0.00,-$2888.66
"Discover",,C,,07/02/2014,"Chipotle","Food : Restaurants","Food","Restaurants","",$16.75,$0.00,-$2905.41
"Discover",,C,,07/02/2014,"JD Auto center","Transportation : Gas","Transportation","Gas","",$50.51,$0.00,-$2955.92
"Discover",,C,,07/03/2014,"Burger King","Food : Restaurants","Food","Restaurants","",$4.38,$0.00,-$2960.30
"Discover",,C,,07/03/2014,"Pet Source","Housing : Dog","Hidden Categories","Housing ` Dog","",$5.31,$0.00,-$2965.61
"Discover",,C,,07/03/2014,"hannaford","Food : Groceries","Food","Groceries","",$22.11,$0.00,-$2987.72
"Discover",,C,,07/03/2014,"dunkin donuts","Food : Restaurants","Food","Restaurants","",$22.88,$0.00,-$3010.60
"Discover",,C,,07/03/2014,"Exxon mobile","Transportation : Gas","Transportation","Gas","",$33.72,$0.00,-$3044.32
"Discover",,C,,07/05/2014,"hannaford","Food : Groceries","Food","Groceries","",$67.95,$0.00,-$3112.27
"Discover",,C,,07/06/2014,"Payment","Personal : BankFee","Personal","BankFee","",$0.00,$1776.93,-$1335.34
"Discover",,C,,07/07/2014,"shutter fly","Recreation : Entertainment","Recreation","Entertainment","",$8.78,$0.00,-$1344.12
"Discover",,C,,07/08/2014,"","Personal : BankFee","Personal","BankFee","",$0.00,$1776.93,$432.81
"Discover",,C,,07/08/2014,"Latefee","Personal : BankFee","Personal","BankFee","",$25.00,$0.00,$407.81
"Discover",,C,,07/08/2014,"Chipotle","Food : Restaurants","Food","Restaurants","",$34.24,$0.00,$373.57
"Discover",,C,,07/08/2014,"Market bskt","Food : Groceries","Food","Groceries","",$115.17,$0.00,$258.40
"Discover",,C,,07/08/2014,"Reverse payment","Personal : BankFee","Personal","BankFee","",$1776.93,$0.00,-$1518.53
"Discover",,C,,07/09/2014,"Price Chopper","Food : Groceries","Food","Groceries","",$18.87,$0.00,-$1537.40
"Discover",,C,,07/10/2014,"","Personal : BankFee","Personal","BankFee","",$0.00,$1776.93,$239.53
"Discover",,C,,07/10/2014,"ap score report","Education : College","Education","College","",$15.00,$0.00,$224.53
"Discover",,C,,07/10/2014,"cannine clips","Housing : Dog","Hidden Categories","Housing ` Dog","",$81.60,$0.00,$142.93
"Discover",,C,,07/10/2014,,"Personal : BankFee","Personal","BankFee","",$1776.93,$0.00,-$1634.00
"Discover",,C,,07/11/2014,"coca cola east hartford","Food : Restaurants","Food","Restaurants","",$1.50,$0.00,-$1635.50
"Discover",,C,,07/11/2014,"wbur","Charity : Other","Charity","Other","",$8.00,$0.00,-$1643.50
"Discover",,C,,07/11/2014,"Cumberland Farms","Transportation : Gas","Transportation","Gas","",$34.26,$0.00,-$1677.76
"Discover",,C,,07/11/2014,"hannaford","Food : Groceries","Food","Groceries","",$35.29,$0.00,-$1713.05
"Discover",,C,,07/11/2014,"SSM online","Recreation : Entertainment","Recreation","Entertainment","",$56.60,$0.00,-$1769.65
"Discover",,C,,07/12/2014,"Strand theatre","Food : Restaurants","Food","Restaurants","",$22.00,$0.00,-$1791.65
"Discover",,C,,07/12/2014,"Strand theatre","Food : Restaurants","Food","Restaurants","",$23.59,$0.00,-$1815.24
"Discover",,C,,07/12/2014,"Shell","Transportation : Gas","Transportation","Gas","",$50.22,$0.00,-$1865.46
"Discover",,C,,07/14/2014,"","Personal : BankFee","Personal","BankFee","",$0.00,$25.00,-$1840.46
"Discover",,C,,07/14/2014,"AC MOORE","Recreation : Alyssa","Recreation","Alyssa","",$5.61,$0.00,-$1846.07
"Discover",,C,,07/14/2014,"Davidian Broethers","Food : Restaurants","Food","Restaurants","",$16.03,$0.00,-$1862.10
"Discover",,C,,07/14/2014,,"Personal : BankFee","Personal","BankFee","",$1776.93,$0.00,-$3639.03
"Discover",,C,,07/15/2014,"lowes","Housing : Supplies","Hidden Categories","Housing ` Supplies","",$19.97,$0.00,-$3659.00
"Discover",,C,,07/15/2014,"Market bskt","Food : Groceries","Food","Groceries","",$43.54,$0.00,-$3702.54
"Discover",,C,,07/16/2014,"Transfer : Avidia Checking",,,,"",$0.00,$1769.65,-$1932.89
"Discover",,C,,07/17/2014,"Planet Fitness","Recreation : His","Recreation","His","",$10.00,$0.00,-$1942.89
"Discover",,C,,07/17/2014,"Mutual Oil","Transportation : Gas","Transportation","Gas","",$33.00,$0.00,-$1975.89
"Discover",,C,,07/18/2014,"aribnb","Recreation : Vacation","Recreation","Vacation","",$1.00,$0.00,-$1976.89
"Discover",,C,,07/18/2014,"aribnb","Recreation : Vacation","Recreation","Vacation","",$257.00,$0.00,-$2233.89
"Discover",,C,,07/19/2014,"Micheals","Recreation : Entertainment","Recreation","Entertainment","",$15.70,$0.00,-$2249.59
"Discover",,C,,07/20/2014,"shutter fly","Recreation : Entertainment","Recreation","Entertainment","",$6.11,$0.00,-$2255.70
"Discover",,C,,07/20/2014,"netflix","Recreation : Entertainment","Recreation","Entertainment","",$16.48,$0.00,-$2272.18
"Discover",,C,,07/21/2014,"hannaford","Food : Groceries","Food","Groceries","",$69.32,$0.00,-$2341.50
"Discover",,C,,07/22/2014,"masspike","Transportation : tolls","Transportation","tolls","",$49.60,$0.00,-$2391.10
"Discover",,C,,07/23/2014,"dunkin donuts","Food : Restaurants","Food","Restaurants","",$5.44,$0.00,-$2396.54
"Discover",,C,,07/23/2014,"Hess","Transportation : Gas","Transportation","Gas","",$33.38,$0.00,-$2429.92
"Discover",,C,,07/24/2014,"hannaford","Food : Groceries","Food","Groceries","",$46.42,$0.00,-$2476.34
"Discover",,C,,07/25/2014,"Amazon","Education : Investing","Education","Investing","",$4.26,$0.00,-$2480.60
"Discover",,C,,07/25/2014,"Shell","Transportation : Gas","Transportation","Gas","",$40.55,$0.00,-$2521.15
"Discover",,C,,07/26/2014,"OLFY","Food : Restaurants","Food","Restaurants","",$23.80,$0.00,-$2544.95
"Discover",,C,,07/27/2014,"Passports","Food : Restaurants","Food","Restaurants","",$108.00,$0.00,-$2652.95
"Discover",,C,,07/28/2014,"pho dakao","Food : Restaurants","Food","Restaurants","",$36.95,$0.00,-$2689.90
"Discover",,C,,07/29/2014,"hannaford","Food : Groceries","Food","Groceries","",$28.41,$0.00,-$2718.31
"Discover",,C,,07/30/2014,"Kennedy's","Food : Groceries","Food","Groceries","",$13.00,$0.00,-$2731.31
"Discover",,C,,07/30/2014,"BoatingBoston","Recreation : Entertainment","Recreation","Entertainment","Canoeing alyssa and blue",$31.88,$0.00,-$2763.19
"Discover",,C,,07/31/2014,"Gulf express","Transportation : Gas","Transportation","Gas","",$33.00,$0.00,-$2796.19
"Discover",,C,,07/31/2014,"A1 auto","Transportation : Repairs & Maintenance","Transportation","Repairs & Maintenance","TIRES",$570.60,$0.00,-$3366.79
"Discover",,C,,08/01/2014,"Shell","Transportation : Gas","Transportation","Gas","",$48.38,$0.00,-$3415.17
"Discover",,C,,08/01/2014,"Assabet Bicycle","Recreation : His","Recreation","His","",$120.52,$0.00,-$3535.69
"Discover",,C,,08/01/2014,"Holiday inn","Recreation : Vacation","Recreation","Vacation","",$143.64,$0.00,-$3679.33
"Discover",,C,,08/02/2014,"DNC Travel claire ny","Food : Restaurants","Food","Restaurants","",$4.87,$0.00,-$3684.20
"Discover",,C,,08/02/2014,"Sunoco","Transportation : Gas","Transportation","Gas","",$49.64,$0.00,-$3733.84
"Discover",,C,,08/02/2014,"cc taps","Recreation : Vacation","Recreation","Vacation","",$60.42,$0.00,-$3794.26
"Discover",,C,,08/02/2014,"Always in B&B","Recreation : Vacation","Recreation","Vacation","niagra activity and bus tickets",$154.91,$0.00,-$3949.17
"Discover",,C,,08/03/2014,"Edgewaters Tap Grill","Recreation : Vacation","Recreation","Vacation","",$65.31,$0.00,-$4014.48
"Discover",,C,,08/04/2014,"Dinasaur Adventure GOLF","Recreation : Vacation","Recreation","Vacation","Late night mini-golf",$30.86,$0.00,-$4045.34
"Discover",,C,,08/04/2014,"Skywheel","Recreation : Vacation","Recreation","Vacation","Ferris Wheel",$33.95,$0.00,-$4079.29
"Discover",,C,,08/04/2014,"Pujabi Jut","Recreation : Vacation","Recreation","Vacation","",$61.03,$0.00,-$4140.32
"Discover",,C,,08/05/2014,"George Eastman house","Recreation : Vacation","Recreation","Vacation","",$14.53,$0.00,-$4154.85
"Discover",,C,,08/05/2014,"George Eastman house","Recreation : Vacation","Recreation","Vacation","",$33.00,$0.00,-$4187.85
"Discover",,C,,08/05/2014,"Exxon mobile","Transportation : Gas","Transportation","Gas","",$39.95,$0.00,-$4227.80
"Discover",,C,,08/05/2014,"Furoshiki","Recreation : Vacation","Recreation","Vacation","",$43.72,$0.00,-$4271.52
"Discover",,C,,08/05/2014,"Holiday inn","Recreation : Vacation","Recreation","Vacation","",$140.22,$0.00,-$4411.74
"Discover",,C,,08/06/2014,"linguines","Food : Restaurants","Food","Restaurants","",$35.59,$0.00,-$4447.33
"Discover",,C,,08/07/2014,"dunkin donuts","Food : Restaurants","Food","Restaurants","",$8.31,$0.00,-$4455.64
"Discover",,C,,08/07/2014,"Hess","Transportation : Gas","Transportation","Gas","",$31.80,$0.00,-$4487.44
"Discover",,C,,08/07/2014,"Boston Taxi","Recreation : Vacation","Recreation","Vacation","",$48.66,$0.00,-$4536.10
"Discover",,C,,08/09/2014,"7-eleven","Food : Restaurants","Food","Restaurants","",$3.20,$0.00,-$4539.30
"Discover",,C,,08/09/2014,"verc enterprise","Transportation : Gas","Transportation","Gas","",$18.07,$0.00,-$4557.37
"Discover",,C,,08/09/2014,"Cumberland Farms","Transportation : Gas","Transportation","Gas","",$33.39,$0.00,-$4590.76
"Discover",,U,,08/12/2014,"interest charge","Personal : BankFee","Personal","BankFee","ADDED - TO MATCH INTEREST CHARGES",$30.10,$0.00,-$4620.86
"Discover",,C,,08/13/2014,"Transfer : Avidia Checking",,,,"",$0.00,$1776.93,-$2843.93
"Discover",,C,,08/13/2014,"interest charge","Personal : BankFee","Personal","BankFee","",$20.78,$0.00,-$2864.71
"Discover",,C,,08/14/2014,"interest charge","Personal : BankFee","Personal","BankFee","",$0.00,$50.88,-$2813.83
"Discover",,C,,08/14/2014,"subway","Food : Restaurants","Food","Restaurants","",$3.72,$0.00,-$2817.55
"Discover",,C,,08/14/2014,"wbur","Charity : Other","Charity","Other","",$8.00,$0.00,-$2825.55
"Discover",,C,,08/14/2014,"Chipotle","Food : Restaurants","Food","Restaurants","",$16.48,$0.00,-$2842.03
"Discover",,C,,08/14/2014,"Hess","Transportation : Gas","Transportation","Gas","",$29.53,$0.00,-$2871.56
"Discover",,C,,08/14/2014,"uno chicago grill","Food : Restaurants","Food","Restaurants","",$44.48,$0.00,-$2916.04
"Discover",,C,,08/14/2014,"hanaford","Food : Groceries","Food","Groceries","",$53.66,$0.00,-$2969.70
"Discover",,C,,08/15/2014,"consumer reports","Recreation : Entertainment","Recreation","Entertainment","",$30.00,$0.00,-$2999.70
"Discover",,C,,08/15/2014,"bashas natural market place","Food : Groceries","Food","Groceries","",$42.49,$0.00,-$3042.19
"Discover",,C,,08/15/2014,"Basha","Food : Groceries","Food","Groceries","",$95.59,$0.00,-$3137.78
"Discover",,C,,08/17/2014,"charles square garage","Transportation : Parking","Transportation","Parking","",$10.00,$0.00,-$3147.78
"Discover",,C,,08/17/2014,"Planet Fitness","Recreation : His","Recreation","His","",$10.00,$0.00,-$3157.78
"Discover",,C,,08/17/2014,"willow rest","Food : Restaurants","Food","Restaurants","",$122.92,$0.00,-$3280.70
"Discover",,C,,08/19/2014,"Exxon mobile","Transportation : Gas","Transportation","Gas","",$51.00,$0.00,-$3331.70
"Discover",,C,,08/19/2014,"Siam Village","Food : Restaurants","Food","Restaurants","",$53.00,$0.00,-$3384.70
"Discover",,C,,08/20/2014,"whistelstop gourmet","Food : Restaurants","Food","Restaurants","",$12.25,$0.00,-$3396.95
"Discover",,C,,08/20/2014,"linguines","Food : Restaurants","Food","Restaurants","",$15.19,$0.00,-$3412.14
"Discover",,C,,08/20/2014,"netflix","Recreation : Entertainment","Recreation","Entertainment","",$16.48,$0.00,-$3428.62
"Discover",,C,,08/20/2014,"Roche Brothers","Food : Groceries","Food","Groceries","",$47.27,$0.00,-$3475.89
"Discover",,C,,08/22/2014,"Japan one","Food : Restaurants","Food","Restaurants","",$21.94,$0.00,-$3497.83
"Discover",,C,,08/22/2014,"Angellino's","Food : Restaurants","Food","Restaurants","",$83.88,$0.00,-$3581.71
"Discover",,C,,08/25/2014,"Hess","Transportation : Gas","Transportation","Gas","",$31.45,$0.00,-$3613.16
"Discover",,C,,08/26/2014,"Shell","Transportation : Gas","Transportation","Gas","",$47.55,$0.00,-$3660.71
"Discover",,C,,08/26/2014,"hannaford","Food : Groceries","Food","Groceries","",$63.12,$0.00,-$3723.83
"Discover",,C,,08/29/2014,"USPS","Housing : Supplies","Hidden Categories","Housing ` Supplies","",$9.80,$0.00,-$3733.63
"Discover",,C,,08/30/2014,"Shell","Transportation : Gas","Transportation","Gas","",$32.60,$0.00,-$3766.23
"Discover",,C,,09/01/2014,"Market bskt","Food : Groceries","Food","Groceries","",$88.61,$0.00,-$3854.84
"Discover",,C,,09/02/2014,"Amazon","Recreation : Entertainment","Recreation","Entertainment","",$2.99,$0.00,-$3857.83
"Discover",,C,,09/02/2014,"USPS","Housing : Supplies","Hidden Categories","Housing ` Supplies","",$5.80,$0.00,-$3863.63
"Discover",,C,,09/03/2014,"Pay Pal ETC?","Personal : Gifts","Personal","Gifts","",$20.00,$0.00,-$3883.63
"Discover",,C,,09/04/2014,"Transfer : Avidia Checking",,,,"",$0.00,$2864.71,-$1018.92
"Discover",,C,,09/04/2014,"Rocky's Hardware","Housing : Maintenance & Repairs","Hidden Categories","Housing ` Maintenance & Repairs","",$20.18,$0.00,-$1039.10
"Discover",,C,,09/05/2014,"verc enterprise","Transportation : Gas","Transportation","Gas","",$14.25,$0.00,-$1053.35
"Discover",,C,,09/07/2014,"Amazon","Recreation : Entertainment","Recreation","Entertainment","",$2.99,$0.00,-$1056.34
"Discover",,C,,09/07/2014,"Hess","Transportation : Gas","Transportation","Gas","",$39.46,$0.00,-$1095.80
"Discover",,C,,09/07/2014,"masspike","Transportation : tolls","Transportation","tolls","",$45.04,$0.00,-$1140.84
"Discover",,C,,09/08/2014,"shutter fly","Recreation : Entertainment","Recreation","Entertainment","",$9.97,$0.00,-$1150.81
"Discover",,C,,09/09/2014,"Shell","Transportation : Gas","Transportation","Gas","",$31.39,$0.00,-$1182.20
"Discover",,C,,09/09/2014,"hannaford","Food : Groceries","Food","Groceries","",$88.54,$0.00,-$1270.74
"Discover",,C,,09/10/2014,"dunkin donuts","Food : Restaurants","Food","Restaurants","",$4.90,$0.00,-$1275.64
"Discover",,C,,09/11/2014,"town of brookline","Transportation : Parking","Transportation","Parking","",$1.00,$0.00,-$1276.64
"Discover",,C,,09/12/2014,"town of brookline","Transportation : Parking","Transportation","Parking","",$1.50,$0.00,-$1278.14
"Discover",,C,,09/12/2014,"wbur","Charity : Other","Charity","Other","",$8.00,$0.00,-$1286.14
"Discover",,C,,09/13/2014,"Shell","Transportation : Gas","Transportation","Gas","",$11.21,$0.00,-$1297.35
"Discover",,C,,09/13/2014,"Carlson orchard","Food : Groceries","Food","Groceries","",$15.44,$0.00,-$1312.79
"Discover",,C,,09/13/2014,"hannaford","Food : Groceries","Food","Groceries","",$47.74,$0.00,-$1360.53
"Discover",,C,,09/14/2014,"Market bskt","Food : Groceries","Food","Groceries","",$18.40,$0.00,-$1378.93
"Discover",,C,,09/15/2014,"sears","Personal : cloths","Personal","cloths","",$17.15,$0.00,-$1396.08
"Discover",,C,,09/15/2014,"Town Pizza","Food : Restaurants","Food","Restaurants","",$37.99,$0.00,-$1434.07
"Discover",,C,,09/16/2014,"dunkin donuts","Food : Restaurants","Food","Restaurants","",$5.44,$0.00,-$1439.51
"Discover",,C,,09/16/2014,"Hess","Transportation : Gas","Transportation","Gas","",$29.18,$0.00,-$1468.69
"Discover",,C,,09/16/2014,"Shell","Transportation : Gas","Transportation","Gas","",$44.20,$0.00,-$1512.89
"Discover",,C,,09/17/2014,"Planet Fitness","Recreation : His","Recreation","His","",$10.00,$0.00,-$1522.89
"Discover",,C,,09/17/2014,"hannaford","Food : Groceries","Food","Groceries","",$66.38,$0.00,-$1589.27
"Discover",,C,,09/18/2014,"Amazon photojojo","Recreation : Alyssa","Recreation","Alyssa","",$50.00,$0.00,-$1639.27
"Discover",,C,,09/18/2014,"cannine clips","Housing : Dog","Hidden Categories","Housing ` Dog","",$78.20,$0.00,-$1717.47
"Discover",,C,,09/19/2014,"Amazon","Recreation : Entertainment","Recreation","Entertainment","",$4.95,$0.00,-$1722.42
"Discover",,C,,09/19/2014,"hannaford","Food : Groceries","Food","Groceries","",$27.11,$0.00,-$1749.53
"Discover",,C,,09/19/2014,"Fiesta 5 De Mayo","Food : Restaurants","Food","Restaurants","",$129.38,$0.00,-$1878.91
"Discover",,C,,09/20/2014,"uncon parking","Transportation : Parking","Transportation","Parking","",$3.00,$0.00,-$1881.91
"Discover",,C,,09/20/2014,"netflix","Recreation : Entertainment","Recreation","Entertainment","",$16.48,$0.00,-$1898.39
"Discover",,C,,09/20/2014,"trader Joes","Food : Groceries","Food","Groceries","",$40.59,$0.00,-$1938.98
"Discover",,C,,09/20/2014,"yummy kitchen","Food : Restaurants","Food","Restaurants","",$57.41,$0.00,-$1996.39
"Discover",,C,,09/23/2014,"hannaford","Food : Groceries","Food","Groceries","",$11.99,$0.00,-$2008.38
"Discover",,C,,09/23/2014,"Hess","Transportation : Gas","Transportation","Gas","",$29.27,$0.00,-$2037.65
"Discover",,C,,09/25/2014,"Dollar general","Recreation : His","Recreation","His","",$3.75,$0.00,-$2041.40
"Discover",,C,,09/25/2014,"MRKT BSKT","Food : Groceries","Food","Groceries","",$15.65,$0.00,-$2057.05
"Discover",,C,,09/25/2014,"save-a-lot","Food : Groceries","Food","Groceries","",$19.25,$0.00,-$2076.30
"Discover",,C,,09/26/2014,"publix","Food : Groceries","Food","Groceries","",$53.02,$0.00,-$2129.32
"Discover",,C,,09/26/2014,"Hanover Theatre","Recreation : Entertainment","Recreation","Entertainment","",$212.00,$0.00,-$2341.32
"Discover",,C,,09/28/2014,"shutter fly","Recreation : Entertainment","Recreation","Entertainment","",$3.18,$0.00,-$2344.50
"Discover",,C,,09/28/2014,"AMAZON KINDLE","Recreation : His","Recreation","His","",$10.49,$0.00,-$2354.99
"Discover",,C,,09/28/2014,"Hess","Transportation : Gas","Transportation","Gas","",$33.54,$0.00,-$2388.53
"Discover",,C,,09/28/2014,"winn-dixie","Food : Groceries","Food","Groceries","",$36.22,$0.00,-$2424.75
"Discover",,C,,10/01/2014,"save a lot","Food : Groceries","Food","Groceries","",$15.91,$0.00,-$2440.66
"Discover",,C,,10/01/2014,"Planet Fitness","Recreation : His","Recreation","His","",$20.00,$0.00,-$2460.66
"Discover",,C,,10/01/2014,"hannaford","Food : Groceries","Food","Groceries","",$27.31,$0.00,-$2487.97
"Discover",,C,,10/02/2014,"verc enterprise","Transportation : Gas","Transportation","Gas","",$25.00,$0.00,-$2512.97
"Discover",,C,,10/03/2014,"Transfer : Avidia Checking",,,,"",$0.00,$1275.64,-$1237.33
"Discover",,C,,10/03/2014,"save a lot","Food : Groceries","Food","Groceries","",$8.92,$0.00,-$1246.25
"Discover",,C,,10/03/2014,"publix","Food : Groceries","Food","Groceries","",$36.12,$0.00,-$1282.37
"Discover",,C,,10/03/2014,"Amazon","Recreation : Alyssa","Recreation","Alyssa","",$74.58,$0.00,-$1356.95
"Discover",,C,,10/03/2014,"equus","Recreation : Alyssa","Recreation","Alyssa","",$92.45,$0.00,-$1449.40
"Discover",,C,,10/04/2014,"Shell","Transportation : Gas","Transportation","Gas","",$46.36,$0.00,-$1495.76
"Discover",,C,,10/04/2014,"Dimensional","Recreation : Alyssa","Recreation","Alyssa","",$47.00,$0.00,-$1542.76
"Discover",,C,,10/04/2014,"Providence Airport","Transportation : Parking","Transportation","Parking","",$128.00,$0.00,-$1670.76
"Discover",,C,,10/05/2014,"hanaford","Food : Groceries","Food","Groceries","",$7.98,$0.00,-$1678.74
"Discover",,C,,10/05/2014,"Monsoon","Food : Restaurants","Food","Restaurants","",$17.41,$0.00,-$1696.15
"Discover",,C,,10/06/2014,"hanaford","Food : Groceries","Food","Groceries","",$12.86,$0.00,-$1709.01
"Discover",,C,,10/07/2014,"Hess","Transportation : Gas","Transportation","Gas","",$27.86,$0.00,-$1736.87
"Discover",,C,,10/07/2014,"MHS Folding Stair","Transportation : Repairs & Maintenance","Transportation","Repairs & Maintenance","",$35.15,$0.00,-$1772.02
"Discover",,C,,10/08/2014,"Chipotle","Food : Restaurants","Food","Restaurants","",$8.03,$0.00,-$1780.05
"Discover",,C,,10/09/2014,"hannaford","Food : Groceries","Food","Groceries","",$3.99,$0.00,-$1784.04
"Discover",,C,,10/10/2014,"sperry liquor","Food : Groceries","Food","Groceries","",$9.99,$0.00,-$1794.03
"Discover",,C,,10/10/2014,"hannaford","Food : Groceries","Food","Groceries","",$38.94,$0.00,-$1832.97
"Discover",,C,,10/11/2014,"hannaford","Food : Groceries","Food","Groceries","",$5.98,$0.00,-$1838.95
"Discover",,C,,10/12/2014,"Florence Griswold Museum","Recreation : Entertainment","Recreation","Entertainment","Fairy Garden",$40.00,$0.00,-$1878.95
"Discover",,C,,10/12/2014,"Rosemary and Sagle","Food : Restaurants","Food","Restaurants","",$113.18,$0.00,-$1992.13
"Discover",,C,,10/13/2014,"hannaford","Food : Groceries","Food","Groceries","",$48.41,$0.00,-$2040.54
"Discover",,C,,10/14/2014,"shutter fly","Recreation : Entertainment","Recreation","Entertainment","",$5.31,$0.00,-$2045.85
"Discover",,C,,10/14/2014,"Uconn","Education : College","Education","College","",$37.22,$0.00,-$2083.07
"Discover",,C,,10/15/2014,"hannaford","Food : Groceries","Food","Groceries","",$3.99,$0.00,-$2087.06
"Discover",,C,,10/15/2014,"Price Chopper","Food : Groceries","Food","Groceries","",$9.05,$0.00,-$2096.11
"Discover",,C,,10/15/2014,"Hess","Transportation : Gas","Transportation","Gas","",$28.47,$0.00,-$2124.58
"Discover",,C,,10/15/2014,"Shell","Transportation : Gas","Transportation","Gas","",$46.99,$0.00,-$2171.57
"Discover",,C,,10/16/2014,"consumer auto parts","Transportation : Repairs & Maintenance","Transportation","Repairs & Maintenance","",$4.24,$0.00,-$2175.81
"Discover",,C,,10/17/2014,"USPS","Housing : Supplies","Hidden Categories","Housing ` Supplies","",$5.75,$0.00,-$2181.56
"Discover",,C,,10/17/2014,"Planet Fitness","Recreation : His","Recreation","His","",$10.00,$0.00,-$2191.56
"Discover",,C,,10/17/2014,"lake williams pizza","Food : Restaurants","Food","Restaurants","",$17.10,$0.00,-$2208.66
"Discover",,C,,10/18/2014,"MRKT BSKT","Food : Groceries","Food","Groceries","",$7.17,$0.00,-$2215.83
"Discover",,C,,10/19/2014,"verc enterprise","Food : Restaurants","Food","Restaurants","",$2.98,$0.00,-$2218.81
"Discover",,C,,10/19/2014,"dunkin donuts","Food : Restaurants","Food","Restaurants","",$4.90,$0.00,-$2223.71
"Discover",,C,,10/19/2014,"hannaford","Food : Groceries","Food","Groceries","",$5.78,$0.00,-$2229.49
"Discover",,C,,10/19/2014,"marlboro wine & spirits","Food : Groceries","Food","Groceries","",$46.56,$0.00,-$2276.05
"Discover",,C,,10/19/2014,"hannaford","Food : Groceries","Food","Groceries","",$64.60,$0.00,-$2340.65
"Discover",,C,,10/20/2014,"dunkin donuts","Food : Restaurants","Food","Restaurants","",$5.22,$0.00,-$2345.87
"Discover",,C,,10/20/2014,"netflix","Recreation : Entertainment","Recreation","Entertainment","",$16.48,$0.00,-$2362.35
"Discover",,C,,10/20/2014,"A1 auto","Transportation : Repairs & Maintenance","Transportation","Repairs & Maintenance",,$36.85,$0.00,-$2399.20
"Discover",,C,,10/20/2014,"hannaford","Food : Groceries","Food","Groceries","",$37.95,$0.00,-$2437.15
"Discover",,C,,10/21/2014,"A1 auto","Transportation : Repairs & Maintenance","Transportation","Repairs & Maintenance","",$34.35,$0.00,-$2471.50
"Discover",,C,,10/23/2014,"Cts shrewsbury","Personal : Gifts","Personal","Gifts","",$34.96,$0.00,-$2506.46
"Discover",,C,,10/23/2014,"hannaford","Food : Groceries","Food","Groceries","",$55.01,$0.00,-$2561.47
"Discover",,U,,10/23/2014,"Marlboro Animal Hospital","Housing : Dog","Hidden Categories","Housing ` Dog","",$498.65,$0.00,-$3060.12
"Discover",,C,,10/24/2014,"Dimensional","Recreation : Alyssa","Recreation","Alyssa","",$0.00,$47.00,-$3013.12
"Discover",,C,,10/24/2014,"paypal ebay","Personal : BankFee","Personal","BankFee","",$4.50,$0.00,-$3017.62
"Discover",,C,,10/24/2014,"Chipotle","Food : Restaurants","Food","Restaurants","",$8.72,$0.00,-$3026.34
"Discover",,C,,10/24/2014,"charles river plaza","Transportation : Parking","Transportation","Parking","",$17.00,$0.00,-$3043.34
"Discover",,C,,10/24/2014,"lowes","Housing : Supplies","Hidden Categories","Housing ` Supplies","",$19.97,$0.00,-$3063.31
"Discover",,C,,10/24/2014,"hannaford","Food : Groceries","Food","Groceries","",$82.67,$0.00,-$3145.98
"Discover",,C,,10/25/2014,"etsy","Personal : Gifts","Personal","Gifts","",$25.50,$0.00,-$3171.48
"Discover",,C,,10/25/2014,"Shell","Transportation : Gas","Transportation","Gas","",$43.86,$0.00,-$3215.34
"Discover",,C,,10/25/2014,"spicepepper action","Food : Restaurants","Food","Restaurants","",$89.91,$0.00,-$3305.25
"Discover",,C,,10/26/2014,"spirit halloween","Recreation : Alyssa","Recreation","Alyssa","",$10.60,$0.00,-$3315.85
"Discover",,C,,10/26/2014,"hannaford","Food : Groceries","Food","Groceries","",$25.87,$0.00,-$3341.72
"Discover",,C,,10/26/2014,"Shell","Transportation : Gas","Transportation","Gas","",$28.48,$0.00,-$3370.20
"Discover",,C,,10/26/2014,"China Taste","Food : Restaurants","Food","Restaurants","",$37.13,$0.00,-$3407.33
"Discover",,C,,10/27/2014,"etsy","Personal : Gifts","Personal","Gifts","",$0.00,$25.50,-$3381.83
"Discover",,C,,10/27/2014,"walgreens","Personal : Miscellaneous","Personal","Miscellaneous","",$4.66,$0.00,-$3386.49
"Discover",,C,,10/27/2014,"Verill Farm","Food : Groceries","Food","Groceries","",$15.29,$0.00,-$3401.78
"Discover",,C,,10/29/2014,"Amazon","Recreation : His","Recreation","His","",$9.99,$0.00,-$3411.77
"Discover",,C,,10/29/2014,"MRKT BSKT","Food : Groceries","Food","Groceries","",$105.39,$0.00,-$3517.16
"Discover",,C,,10/31/2014,"Pet Source","Housing : Dog","Hidden Categories","Housing ` Dog","",$10.61,$0.00,-$3527.77
"Discover",,C,,10/31/2014,"Lowe's of Hudson","Housing : Maintenance & Repairs","Hidden Categories","Housing ` Maintenance & Repairs","",$11.63,$0.00,-$3539.40
"Discover",,C,,10/31/2014,"Shell","Transportation : Gas","Transportation","Gas","",$29.95,$0.00,-$3569.35
"Discover",,C,,10/31/2014,"Bertucci","Food : Restaurants","Food","Restaurants","",$31.01,$0.00,-$3600.36
"Discover",,C,,11/01/2014,"Hoyt cape code","Recreation : Entertainment","Recreation","Entertainment","",$31.50,$0.00,-$3631.86
"Discover",,C,,11/02/2014,"Hess","Transportation : Gas","Transportation","Gas","",$37.89,$0.00,-$3669.75
"Discover",,C,,11/02/2014,"Baryanns","Food : Restaurants","Food","Restaurants","",$146.65,$0.00,-$3816.40
"Discover",,C,,11/03/2014,"GNC","Housing : Dog","Hidden Categories","Housing ` Dog","",$41.43,$0.00,-$3857.83
"Discover",,C,,11/03/2014,"hannaford","Food : Groceries","Food","Groceries","",$42.13,$0.00,-$3899.96
"Discover",,C,,11/04/2014,"Transfer : Avidia Checking",,,,"",$0.00,$1992.13,-$1907.83
"Discover",,C,,11/04/2014,"Home Depot","Housing : Maintenance & Repairs","Hidden Categories","Housing ` Maintenance & Repairs","",$12.69,$0.00,-$1920.52
"Discover",,C,,11/05/2014,"town of brookline","Transportation : Parking","Transportation","Parking","",$1.50,$0.00,-$1922.02
"Discover",,C,,11/06/2014,"hanaford","Food : Groceries","Food","Groceries","",$37.67,$0.00,-$1959.69
"Discover",,C,,11/07/2014,"Next Step Living","Housing : Maintenance & Repairs","Hidden Categories","Housing ` Maintenance & Repairs","",$425.72,$0.00,-$2385.41
"Discover",,C,,11/08/2014,"wendy's","Food : Restaurants","Food","Restaurants","",$13.43,$0.00,-$2398.84
"Discover",,C,,11/08/2014,"Chipotle","Food : Restaurants","Food","Restaurants","",$41.20,$0.00,-$2440.04
"Discover",,C,,11/08/2014,"IYA Sushi and Noodle S. Hadley","Food : Restaurants","Food","Restaurants","",$91.29,$0.00,-$2531.33
"Discover",,C,,11/09/2014,"verc enterprise","Transportation : Gas","Transportation","Gas","",$41.71,$0.00,-$2573.04
"Discover",,C,,11/10/2014,"hannaford","Food : Groceries","Food","Groceries","",$39.27,$0.00,-$2612.31
"Discover",,C,,11/11/2014,"Shell","Transportation : Gas","Transportation","Gas","",$25.29,$0.00,-$2637.60
"Discover",,C,,11/12/2014,"Yankee candle","Education : College","Education","College","",$59.12,$0.00,-$2696.72
"Discover",,C,,11/12/2014,"Apple Store","business (bob) : Equipment","Hidden Categories","business (bob) ` Equipment","",$323.13,$0.00,-$3019.85
"Discover",,C,,11/13/2014,"MRKT BSKT","Food : Groceries","Food","Groceries","",$52.57,$0.00,-$3072.42
"Discover",,C,,11/15/2014,"Shell","Transportation : Gas","Transportation","Gas","",$37.61,$0.00,-$3110.03
"Discover",,C,,11/16/2014,"subway","Food : Restaurants","Food","Restaurants","",$9.79,$0.00,-$3119.82
"Discover",,C,,11/17/2014,"Planet Fitness","Recreation : His","Recreation","His","",$10.00,$0.00,-$3129.82
"Discover",,C,,11/17/2014,"nicolevelas","Personal : Gifts","Personal","Gifts","",$68.54,$0.00,-$3198.36
"Discover",,C,,11/17/2014,"hannaford","Food : Groceries","Food","Groceries","",$73.76,$0.00,-$3272.12
"Discover",,C,,11/19/2014,"Hess","Transportation : Gas","Transportation","Gas","",$25.87,$0.00,-$3297.99
"Discover",,C,,11/20/2014,"netflix","Recreation : Entertainment","Recreation","Entertainment","",$16.48,$0.00,-$3314.47
"Discover",,C,,11/20/2014,"Shell","Transportation : Gas","Transportation","Gas","",$37.58,$0.00,-$3352.05
"Discover",,C,,11/20/2014,"MRKT BSKT","Food : Groceries","Food","Groceries","",$52.93,$0.00,-$3404.98
"Discover",,C,,11/23/2014,"HALFWAY","Food : Restaurants","Food","Restaurants","",$24.59,$0.00,-$3429.57
"Discover",,C,,11/23/2014,"hannaford","Food : Groceries","Food","Groceries","",$26.15,$0.00,-$3455.72
"Discover",,C,,11/23/2014,"shutter fly","Lisa Business : Business expenses","Lisa Business","Business expenses","",$198.90,$0.00,-$3654.62
"Discover",,C,,11/24/2014,"Amazon video","Recreation : Entertainment","Recreation","Entertainment","",$4.99,$0.00,-$3659.61
"Discover",,C,,11/24/2014,"subway","Food : Restaurants","Food","Restaurants","",$6.21,$0.00,-$3665.82
"Discover",,C,,11/25/2014,"hannaford","Food : Groceries","Food","Groceries","",$4.24,$0.00,-$3670.06
"Discover",,C,,11/25/2014,"Printerpix","Personal : Gifts","Personal","Gifts","",$9.95,$0.00,-$3680.01
"Discover",,C,,11/25/2014,"Shell","Transportation : Gas","Transportation","Gas","",$36.94,$0.00,-$3716.95
"Discover",,C,,11/25/2014,"hannaford","Food : Groceries","Food","Groceries","",$94.39,$0.00,-$3811.34
"Discover",,C,,11/26/2014,"Blurb","Education : College","Education","College","",$0.00,$17.98,-$3793.36
"Discover",,C,,11/26/2014,"BLURP","Education : College","Education","College","",$17.98,$0.00,-$3811.34
"Discover",,C,,11/26/2014,"BLURP","Education : College","Education","College","",$17.98,$0.00,-$3829.32
"Discover",,C,,11/29/2014,"Chipotle","Food : Restaurants","Food","Restaurants","",$18.94,$0.00,-$3848.26
"Discover",,C,,11/29/2014,"Go Calendars","Personal : Gifts","Personal","Gifts","",$55.21,$0.00,-$3903.47
"Discover",,C,,11/29/2014,"linguines","Food : Restaurants","Food","Restaurants","Takeout for alyssa",$63.88,$0.00,-$3967.35
"Discover",,C,,11/30/2014,"Amazon video","Recreation : Entertainment","Recreation","Entertainment","",$3.99,$0.00,-$3971.34
"Discover",,C,,11/30/2014,"American Brain Tumor","Charity : Other","Charity","Other","",$100.00,$0.00,-$4071.34
"Discover",,C,,11/30/2014,"PAYPEL DER","Recreation : Hers","Recreation","Hers","",$100.00,$0.00,-$4171.34
"Discover",,C,,11/30/2014,"trader Joes","Food : Groceries","Food","Groceries","",$114.56,$0.00,-$4285.90
"Discover",,C,,11/30/2014,"bella Costa","Food : Restaurants","Food","Restaurants","",$131.21,$0.00,-$4417.11
"Discover",,C,,12/01/2014,"amazon service","Recreation : His","Recreation","His","",$0.99,$0.00,-$4418.10
"Discover",,C,,12/01/2014,"amazon service","Recreation : His","Recreation","His","",$2.99,$0.00,-$4421.09
"Discover",,C,,12/01/2014,"Southbridge fuels","Transportation : Gas","Transportation","Gas","",$33.18,$0.00,-$4454.27
"Discover",,C,,12/02/2014,"Hess","Transportation : Gas","Transportation","Gas","",$25.99,$0.00,-$4480.26
"Discover",,C,,12/02/2014,"Amazon","Personal : Gifts","Personal","Gifts","",$55.03,$0.00,-$4535.29
"Discover",,C,,12/03/2014,"Amazon","Personal : Gifts","Personal","Gifts","",$8.26,$0.00,-$4543.55
"Discover",,C,,12/03/2014,"Amazon","Personal : Gifts","Personal","Gifts","",$39.61,$0.00,-$4583.16
"Discover",,C,,12/04/2014,"Transfer : Avidia Checking",,,,"",$0.00,$2637.60,-$1945.56
"Discover",,C,,12/04/2014,"shutter fly","Recreation : Alyssa","Recreation","Alyssa","",$31.06,$0.00,-$1976.62
"Discover",,C,,12/04/2014,"hannaford","Food : Groceries","Food","Groceries","",$129.41,$0.00,-$2106.03
"Discover",,C,,12/07/2014,"Amazon","Recreation : Entertainment","Recreation","Entertainment","",$33.49,$0.00,-$2139.52
"Discover",,C,,12/07/2014,"Shell","Transportation : Gas","Transportation","Gas","",$35.43,$0.00,-$2174.95
"Discover",,C,,12/07/2014,"Viva Fresh Pasta","Food : Restaurants","Food","Restaurants","",$99.00,$0.00,-$2273.95
"Discover",,C,,12/08/2014,"Home Depot","Housing : Maintenance & Repairs","Hidden Categories","Housing ` Maintenance & Repairs","",$32.75,$0.00,-$2306.70
"Discover",,C,,12/09/2014,"hannaford","Food : Groceries","Food","Groceries","",$22.59,$0.00,-$2329.29
"Discover",,C,,12/10/2014,"Scargo","Personal : Gifts","Personal","Gifts","",$25.00,$0.00,-$2354.29
"Discover",,C,,12/11/2014,"just picked","Food : Groceries","Food","Groceries","",$26.00,$0.00,-$2380.29
"Discover",,C,,12/11/2014,"cannine clips","Housing : Dog","Hidden Categories","Housing ` Dog","",$68.00,$0.00,-$2448.29
"Discover",,C,,12/12/2014,"cts Store natick ma","Personal : Gifts","Personal","Gifts","",$57.42,$0.00,-$2505.71
"Discover",,C,,12/12/2014,"EDSHEERAN NY","Recreation : Alyssa","Recreation","Alyssa","",$72.74,$0.00,-$2578.45
"Discover",,C,,12/13/2014,"Hess","Transportation : Gas","Transportation","Gas","",$24.40,$0.00,-$2602.85
"Discover",,C,,12/13/2014,"Marshside East","Personal : Gifts","Personal","Gifts","",$25.00,$0.00,-$2627.85
"Discover",,C,,12/14/2014,"citigo","Transportation : Gas","Transportation","Gas","",$34.39,$0.00,-$2662.24
"Discover",,C,,12/14/2014,"hannaford","Food : Groceries","Food","Groceries","",$195.58,$0.00,-$2857.82
"Discover",,C,,12/15/2014,"Hess","Transportation : Gas","Transportation","Gas","",$24.53,$0.00,-$2882.35
"Discover",,C,,12/16/2014,"Divine Thai","Food : Restaurants","Food","Restaurants","",$23.02,$0.00,-$2905.37
"Discover",,C,,12/16/2014,"Ink Pixi","Personal : Gifts","Personal","Gifts","",$56.93,$0.00,-$2962.30
"Discover",,C,,12/16/2014,"sassy fox","Personal : cloths","Personal","cloths","",$66.42,$0.00,-$3028.72
"Discover",,C,,12/17/2014,"Planet Fitness","Recreation : His","Recreation","His","",$10.00,$0.00,-$3038.72
"Discover",,C,,12/17/2014,"Paper Store","Personal : Gifts","Personal","Gifts","",$15.88,$0.00,-$3054.60
"Discover",,C,,12/17/2014,"walgreens","Personal : Miscellaneous","Personal","Miscellaneous","",$26.53,$0.00,-$3081.13
"Discover",,C,,12/17/2014,"sperry liquor","Food : Groceries","Food","Groceries","",$32.98,$0.00,-$3114.11
"Discover",,C,,12/17/2014,"stop & shop","Food : Groceries","Food","Groceries","",$109.78,$0.00,-$3223.89
"Discover",,C,,12/18/2014,"Providence Airport","Transportation : Parking","Transportation","Parking","",$9.00,$0.00,-$3232.89
"Discover",,C,,12/18/2014,"USPS","Housing : Supplies","Hidden Categories","Housing ` Supplies","",$65.95,$0.00,-$3298.84
"Discover",,C,,12/19/2014,"Delfino","Food : Restaurants","Food","Restaurants","",$61.00,$0.00,-$3359.84
"Discover",,C,,12/20/2014,"netflix","Recreation : Entertainment","Recreation","Entertainment","",$16.48,$0.00,-$3376.32
"Discover",,C,,12/20/2014,"Shell","Transportation : Gas","Transportation","Gas","",$23.09,$0.00,-$3399.41
"Discover",,C,,12/20/2014,"hannaford","Food : Groceries","Food","Groceries","",$45.65,$0.00,-$3445.06
"Discover",,C,,12/21/2014,"paypal ebay","Personal : Gifts","Personal","Gifts","",$15.95,$0.00,-$3461.01
"Discover",,C,,12/21/2014,"Sarku","Food : Restaurants","Food","Restaurants","",$20.93,$0.00,-$3481.94
"Discover",,C,,12/21/2014,"shoe dpt encore","Personal : cloths","Personal","cloths","",$24.98,$0.00,-$3506.92
"Discover",,C,,12/21/2014,"Paper Store","Personal : Gifts","Personal","Gifts","",$29.75,$0.00,-$3536.67
"Discover",,C,,12/21/2014,"Solomon pond mall","Personal : Gifts","Personal","Gifts","",$50.00,$0.00,-$3586.67
"Discover",,C,,12/22/2014,"hannaford","Food : Groceries","Food","Groceries","",$21.39,$0.00,-$3608.06
"Discover",,C,,12/22/2014,"hannaford","Food : Groceries","Food","Groceries","",$34.82,$0.00,-$3642.88
"Discover",,C,,12/23/2014,"Amazon","Personal : Gifts","Personal","Gifts","",$9.76,$0.00,-$3652.64
"Discover",,C,,12/23/2014,"Amazon","Recreation : Entertainment","Recreation","Entertainment","",$25.91,$0.00,-$3678.55
"Discover",,C,,12/23/2014,"Price Chopper","Food : Groceries","Food","Groceries","",$155.35,$0.00,-$3833.90
"Discover",,C,,12/23/2014,"Best Buy","Recreation : Alyssa","Recreation","Alyssa","",$743.74,$0.00,-$4577.64
"Discover",,C,,12/24/2014,"marlboro wine & spirits","Food : Groceries","Food","Groceries","",$26.54,$0.00,-$4604.18
"Discover",,C,,12/24/2014,"hannaford","Food : Groceries","Food","Groceries","",$28.15,$0.00,-$4632.33
"Discover",,C,,12/25/2014,"Amazon","Personal : Gifts","Personal","Gifts","",$100.00,$0.00,-$4732.33
"Discover",,C,,12/26/2014,"PAYPAL *VITALINDUST 4029357733 CA","Personal : Gifts","Personal","Gifts","",$19.00,$0.00,-$4751.33
"Discover",,C,,12/26/2014,"Hanson Grain","Recreation : Alyssa","Recreation","Alyssa","Boots?",$30.00,$0.00,-$4781.33
"Discover",,C,,12/26/2014,"Shell","Transportation : Gas","Transportation","Gas","",$30.90,$0.00,-$4812.23
"Discover",,C,,12/26/2014,"Amazon","Personal : Gifts","Personal","Gifts","",$39.86,$0.00,-$4852.09
"Discover",,C,,12/28/2014,"Newbury Comics","Personal : Gifts","Personal","Gifts","",$24.35,$0.00,-$4876.44
"Discover",,C,,12/29/2014,"hannaford","Food : Groceries","Food","Groceries","",$63.77,$0.00,-$4940.21
"Discover",,C,,12/30/2014,"Amazon","Personal : Gifts","Personal","Gifts","",$30.36,$0.00,-$4970.57
"Discover",,C,,12/31/2014,"Price Chopper","Food : Groceries","Food","Groceries","",$19.63,$0.00,-$4990.20
"Discover",,C,,01/02/2015,"Getty","Transportation : Gas","Transportation","Gas","",$33.50,$0.00,-$5023.70
"Discover",,C,,01/02/2015,"China Taste","Food : Restaurants","Food","Restaurants","",$46.06,$0.00,-$5069.76
"Discover",,C,,01/03/2015,"Transfer : Avidia Checking",,,,"",$0.00,$2448.29,-$2621.47
"Discover",,C,,01/03/2015,"marlboro wine & spirits","Food : Groceries","Food","Groceries","",$6.80,$0.00,-$2628.27
"Discover",,C,,01/03/2015,"masspike","Transportation : tolls","Transportation","tolls","",$45.10,$0.00,-$2673.37
"Discover",,C,,01/03/2015,"hannaford","Food : Groceries","Food","Groceries","",$49.16,$0.00,-$2722.53
"Discover",,C,,01/03/2015,"Clean & Green Car Wash","Personal : Gifts","Personal","Gifts","",$50.00,$0.00,-$2772.53
"Discover",,C,,01/04/2015,"Chipotle","Food : Restaurants","Food","Restaurants","",$25.47,$0.00,-$2798.00
"Discover",,C,,01/05/2015,"Hess","Transportation : Gas","Transportation","Gas","",$21.14,$0.00,-$2819.14
"Discover",,C,,01/05/2015,"Home Depot","Housing : Maintenance & Repairs","Hidden Categories","Housing ` Maintenance & Repairs","",$136.69,$0.00,-$2955.83
"Discover",,C,,01/06/2015,"Amazon video","Recreation : Entertainment","Recreation","Entertainment","",$4.99,$0.00,-$2960.82
"Discover",,C,,01/10/2015,"hannaford","Food : Groceries","Food","Groceries","",$79.05,$0.00,-$3039.87
"Discover",,C,,01/11/2015,"Sun on South Dennis","Food : Restaurants","Food","Restaurants","",$69.71,$0.00,-$3109.58
"Discover",,C,,01/12/2015,"trader Joes","Food : Groceries","Food","Groceries","",$23.13,$0.00,-$3132.71
"Discover",,C,,01/12/2015,"Hess","Transportation : Gas","Transportation","Gas","",$32.82,$0.00,-$3165.53
"Discover",,C,,01/15/2015,"Groupon","Personal : Gifts","Personal","Gifts","",$61.00,$0.00,-$3226.53
"Discover",,C,,01/16/2015,"Cumberland Farms","Transportation : Gas","Transportation","Gas","",$23.60,$0.00,-$3250.13
"Discover",,C,,01/17/2015,"Planet Fitness","Recreation : His","Recreation","His","",$10.00,$0.00,-$3260.13
"Discover",,C,,01/17/2015,"Boston Rv","RV : MISC","RV","MISC","",$30.00,$0.00,-$3290.13
"Discover",,C,,01/17/2015,"hannaford","Food : Groceries","Food","Groceries","",$70.42,$0.00,-$3360.55
"Discover",,C,,01/18/2015,"LAZ Parking","Transportation : Parking","Transportation","Parking","",$19.00,$0.00,-$3379.55
"Discover",,C,,01/19/2015,"hannaford","Food : Groceries","Food","Groceries","",$37.95,$0.00,-$3417.50
"Discover",,C,,01/20/2015,"netflix","Recreation : Entertainment","Recreation","Entertainment","",$16.48,$0.00,-$3433.98
"Discover",,C,,01/20/2015,"Hess","Transportation : Gas","Transportation","Gas","",$20.71,$0.00,-$3454.69
"Discover",,C,,01/20/2015,"Home Depot","Housing : Maintenance & Repairs","Hidden Categories","Housing ` Maintenance & Repairs","",$654.15,$0.00,-$4108.84
"Discover",,C,,01/22/2015,"Shell","Transportation : Gas","Transportation","Gas","",$16.03,$0.00,-$4124.87
"Discover",,C,,01/22/2015,"Ruby Tuesday","Food : Restaurants","Food","Restaurants","",$48.87,$0.00,-$4173.74
"Discover",,C,,01/23/2015,"MRKT BSKT","Food : Groceries","Food","Groceries","",$98.85,$0.00,-$4272.59
"Discover",,C,,01/24/2015,"Amazon","Personal : Gifts","Personal","Gifts","",$7.00,$0.00,-$4279.59
"Discover",,C,,01/24/2015,"Amazon","Recreation : Alyssa","Recreation","Alyssa","",$12.18,$0.00,-$4291.77
"Discover",,C,,01/24/2015,"Amazon","Recreation : Hers","Recreation","Hers","",$26.27,$0.00,-$4318.04
"Discover",,C,,01/25/2015,"shutter fly","Recreation : Alyssa","Recreation","Alyssa","",$6.37,$0.00,-$4324.41
"Discover",,C,,01/25/2015,"Chipotle","Food : Restaurants","Food","Restaurants","",$24.50,$0.00,-$4348.91
"Discover",,C,,01/25/2015,"Shell","Transportation : Gas","Transportation","Gas","",$24.71,$0.00,-$4373.62
"Discover",,C,,01/25/2015,"Lowe's of Hudson","Housing : Maintenance & Repairs","Hidden Categories","Housing ` Maintenance & Repairs","",$36.02,$0.00,-$4409.64
"Discover",,C,,01/25/2015,"Micheals","Education : College","Education","College","Alyssa art supplies",$221.27,$0.00,-$4630.91
"Discover",,C,,01/26/2015,"Home Depot","Housing : Maintenance & Repairs","Hidden Categories","Housing ` Maintenance & Repairs","",$7.88,$0.00,-$4638.79
"Discover",,C,,01/26/2015,"AAII","Education : Investing","Education","Investing","",$29.00,$0.00,-$4667.79
"Discover",,C,,01/26/2015,"Intuit Turbo tax","Personal : Miscellaneous","Personal","Miscellaneous","",$84.99,$0.00,-$4752.78
"Discover",,C,,01/26/2015,"Price Chopper","Food : Groceries","Food","Groceries","",$87.54,$0.00,-$4840.32
"Discover",,C,,01/29/2015,"subway","Food : Restaurants","Food","Restaurants","",$9.90,$0.00,-$4850.22
"Discover",,C,,01/29/2015,"USPS","Lisa Business : Office supplies","Lisa Business","Office supplies","",$16.95,$0.00,-$4867.17
"Discover",,C,,01/30/2015,"Cap cod art","Education : College","Education","College","Alyssa art supplies",$10.00,$0.00,-$4877.17
"Discover",,C,,01/31/2015,"Home Depot","Housing : Maintenance & Repairs","Hidden Categories","Housing ` Maintenance & Repairs","",$0.00,$83.94,-$4793.23
"Discover",,C,,02/03/2015,"Transfer : Dcu Checking",,,,"",$0.00,$3109.58,-$1683.65
"Discover",,C,,02/03/2015,"Hess","Transportation : Gas","Transportation","Gas","",$25.89,$0.00,-$1709.54
"Discover",,C,,02/04/2015,"Shell","Transportation : Gas","Transportation","Gas","",$16.57,$0.00,-$1726.11
"Discover",,C,,02/04/2015,"Intuit Turbo tax","Lisa Business : Supplies","Lisa Business","Supplies","",$19.99,$0.00,-$1746.10
"Discover",,U,,02/05/2015,"Intuit Turbo tax","Housing : Supplies","Hidden Categories","Housing ` Supplies","Alyssa tax filing",$19.99,$0.00,-$1766.09
"Discover",,C,,02/05/2015,"Good Sam","RV : MISC","RV","MISC","",$25.00,$0.00,-$1791.09
"Discover",,C,,02/05/2015,"Experian Auto Hist check",,,,"Background check on RV",$29.99,$0.00,-$1821.08
"Discover",,C,,02/05/2015,"Good Sam","RV : MISC","RV","MISC","Roadside assistend",$54.95,$0.00,-$1876.03
"Discover",,C,,02/05/2015,"Assabet River Bicycles","Recreation : His","Recreation","His","Mountain bike repair",$60.45,$0.00,-$1936.48
"Discover",,C,,02/05/2015,"Price Chopper","Food : Groceries","Food","Groceries","",$114.68,$0.00,-$2051.16
"Discover",,C,,02/05/2015,"Prezo grill","Food : Restaurants","Food","Restaurants","Elaine and Phil",$151.11,$0.00,-$2202.27
"Discover",,C,,02/06/2015,"MGH GROP OFFICe","Personal : Doctor, Dentist","Personal","Doctor, Dentist","",$10.00,$0.00,-$2212.27
"Discover",,C,,02/06/2015,"charles River Medical","Personal : Doctor, Dentist","Personal","Doctor, Dentist","",$12.00,$0.00,-$2224.27
"Discover",,C,,02/07/2015,"Cumberland Farms","Transportation : Gas","Transportation","Gas","",$29.33,$0.00,-$2253.60
"Discover",,C,,02/07/2015,"H.A Cafe","Food : Restaurants","Food","Restaurants","",$33.07,$0.00,-$2286.67
"Discover",,C,,02/07/2015,"Chucks Margarita Grill","Food : Restaurants","Food","Restaurants","Meal with Alyssa",$51.03,$0.00,-$2337.70
"Discover",,C,,02/08/2015,"Best Buy Marlborough","RV : Equipment/Supplies","RV","Equipment/Supplies","",$53.11,$0.00,-$2390.81
"Discover",,C,,02/08/2015,"Walmart","RV : Equipment/Supplies","RV","Equipment/Supplies","",$131.36,$0.00,-$2522.17
"Discover",,C,,02/10/2015,"Amazon","RV : Campgrounds","RV","Campgrounds","",$20.82,$0.00,-$2542.99
"Discover",,C,,02/10/2015,"Home Depot","Housing : Maintenance & Repairs","Hidden Categories","Housing ` Maintenance & Repairs","",$50.61,$0.00,-$2593.60
"Discover",,C,,02/10/2015,"Canine Clips","Housing : Dog","Hidden Categories","Housing ` Dog","Grooming",$74.75,$0.00,-$2668.35
"Discover",,C,,02/10/2015,"Birchlers Automotive",,,,"Tires",$724.35,$0.00,-$3392.70
"Discover",,C,,02/11/2015,"monnick home supplies","Housing : Maintenance & Repairs","Hidden Categories","Housing ` Maintenance & Repairs","",$3.18,$0.00,-$3395.88
"Discover",,C,,02/11/2015,"linguines","Food : Restaurants","Food","Restaurants","",$8.24,$0.00,-$3404.12
"Discover",,C,,02/11/2015,"Adam Gas","RV : gasoline","RV","gasoline","",$88.00,$0.00,-$3492.12
"Discover",,C,,02/11/2015,"Amazon","RV : Equipment/Supplies","RV","Equipment/Supplies","",$125.49,$0.00,-$3617.61
"Discover",,C,,02/12/2015,"marlboro wine & spirits","Food : Groceries","Food","Groceries","",$21.78,$0.00,-$3639.39
"Discover",,C,,02/12/2015,"Walmart","RV : Equipment/Supplies","RV","Equipment/Supplies","walmart supplies?",$137.21,$0.00,-$3776.60
"Discover",,C,,02/12/2015,"hannaford","Food : Groceries","Food","Groceries","",$259.14,$0.00,-$4035.74
"Discover",,C,,02/13/2015,"Applie Itunes","Recreation : Entertainment","Recreation","Entertainment","",$1.05,$0.00,-$4036.79
"Discover",,C,,02/13/2015,"wilco","Food : Restaurants","Food","Restaurants","",$4.22,$0.00,-$4041.01
"Discover",,C,,02/13/2015,"linguines","Food : Restaurants","Food","Restaurants","",$41.57,$0.00,-$4082.58
"Discover",,C,,02/13/2015,"exitt 77 travel","RV : gasoline","RV","gasoline","",$55.66,$0.00,-$4138.24
"Discover",,C,,02/13/2015,"Exxon mobile","RV : gasoline","RV","gasoline","",$80.56,$0.00,-$4218.80
"Discover",,C,,02/13/2015,"WIreless hot spot","RV : MISC","RV","MISC","",$90.00,$0.00,-$4308.80
"Discover",,C,,02/14/2015,"starbucks","Food : Restaurants","Food","Restaurants","",$2.21,$0.00,-$4311.01
"Discover",,C,,02/14/2015,"Martins Chester VA","Food : Groceries","Food","Groceries","",$3.59,$0.00,-$4314.60
"Discover",,C,,02/14/2015,"Martins Chester VA","Food : Groceries","Food","Groceries","",$8.46,$0.00,-$4323.06
"Discover",,C,,02/14/2015,"Petco","Housing : Dog","Hidden Categories","Housing ` Dog","",$12.63,$0.00,-$4335.69
"Discover",,C,,02/14/2015,"Walmart","Food : Groceries","Food","Groceries","",$30.44,$0.00,-$4366.13
"Discover",,C,,02/14/2015,"wawa","RV : gasoline","RV","gasoline","",$48.89,$0.00,-$4415.02
"Discover",,C,,02/14/2015,"sunoco fayetteville NC","RV : gasoline","RV","gasoline","",$70.40,$0.00,-$4485.42
"Discover",,C,,02/14/2015,"Myrtle Beach Travel park","RV : Campgrounds","RV","Campgrounds","",$88.80,$0.00,-$4574.22
"Discover",,C,,02/14/2015,"Walmart myrtle beach","RV : Equipment/Supplies","RV","Equipment/Supplies","",$210.52,$0.00,-$4784.74
"Discover",,C,,02/15/2015,"Belkd Myrtle Beack","Personal : cloths","Personal","cloths","",$21.16,$0.00,-$4805.90
"Discover",,C,,02/15/2015,"marshalls","Personal : cloths","Personal","cloths","",$39.57,$0.00,-$4845.47
"Discover",,C,,02/15/2015,"shoe dpt encore","Personal : cloths","Personal","cloths","",$42.78,$0.00,-$4888.25
"Discover",,C,,02/16/2015,"Briarcliff RV resort","RV : Campgrounds","RV","Campgrounds","10495 N Kings Hwy, Myrtle Beach, SC 29572",$40.86,$0.00,-$4929.11
"Discover",,C,,02/16/2015,"Krogers","Food : Groceries","Food","Groceries","",$68.88,$0.00,-$4997.99
"Discover",,C,,02/17/2015,"Planet Fitness","Recreation : His","Recreation","His","",$10.00,$0.00,-$5007.99
"Discover",,C,,02/17/2015,"Briarcliff RV resort","RV : Campgrounds","RV","Campgrounds","",$40.86,$0.00,-$5048.85
"Discover",,C,,02/17/2015,"Red Gate Savannah Ga","RV : Campgrounds","RV","Campgrounds","136 Red Gate Farms TrailSavannah, GA 31405",$45.00,$0.00,-$5093.85
"Discover",,C,,02/18/2015,"Red Gate Savannah Ga","RV : Campgrounds","RV","Campgrounds","136 Red Gate Farms TrailSavannah, GA 31405",$36.00,$0.00,-$5129.85
"Discover",,C,,02/18/2015,"wilco","RV : gasoline","RV","gasoline","",$38.68,$0.00,-$5168.53
"Discover",,C,,02/19/2015,"wallmart sc","Food : Groceries","Food","Groceries","",$37.33,$0.00,-$5205.86
"Discover",,C,,02/19/2015,"Tubby's River St. Restaurante","Food : Restaurants","Food","Restaurants","",$60.76,$0.00,-$5266.62
"Discover",,C,,02/19/2015,"walmart sc","RV : Equipment/Supplies","RV","Equipment/Supplies","",$114.08,$0.00,-$5380.70
"Discover",,C,,02/20/2015,"netflix","Recreation : Entertainment","Recreation","Entertainment","",$16.48,$0.00,-$5397.18
"Discover",,C,,02/20/2015,"wildwood KOA","RV : Campgrounds","RV","Campgrounds","",$37.06,$0.00,-$5434.24
"Discover",,C,,02/20/2015,"wildwood KOA","RV : Campgrounds","RV","Campgrounds","",$78.23,$0.00,-$5512.47
"Discover",,C,,02/20/2015,"racetrack","Transportation : Gas","Transportation","Gas","",$80.03,$0.00,-$5592.50
"Discover",,C,,02/24/2015,"Shell","Transportation : Gas","Transportation","Gas","",$84.38,$0.00,-$5676.88
"Discover",,C,,02/28/2015,"Sun N Shade RV Punta Korda","RV : Campgrounds","RV","Campgrounds","14880 Tamiami Trail, Punta Gorda, FL 33955",$25.00,$0.00,-$5701.88
"Discover",,C,,02/28/2015,"Knights Marathon","RV : Campgrounds","RV","Campgrounds","CLosed Marathon Key",$78.75,$0.00,-$5780.63
"Discover",,C,,02/28/2015,"Walmart","RV : Equipment/Supplies","RV","Equipment/Supplies","",$201.62,$0.00,-$5982.25
"Discover",,C,,03/01/2015,"Hurricane Charleys Marathon","Food : Restaurants","Food","Restaurants","",$82.36,$0.00,-$6064.61
"Discover",,C,,03/02/2015,"Sun N Shade RV Punta Korda","RV : Campgrounds","RV","Campgrounds","",$42.41,$0.00,-$6107.02
"Discover",,C,,03/03/2015,"Transfer : Dcu Checking",,,,"",$0.00,$3776.60,-$2330.42
"Discover",,C,,03/03/2015,"Crystal Lake RV","RV : Campgrounds","RV","Campgrounds","",$312.40,$0.00,-$2642.82
"Discover",,C,,03/04/2015,"Amazon Prime","Recreation : Entertainment","Recreation","Entertainment","",$49.00,$0.00,-$2691.82
"Discover",,C,,03/05/2015,"Walmart","RV : Equipment/Supplies","RV","Equipment/Supplies","",$0.00,$21.08,-$2670.74
"Discover",,C,,03/05/2015,"Naples Batonic Garden","RV : MISC","RV","MISC","",$39.85,$0.00,-$2710.59
"Discover",,C,,03/05/2015,"Kangeroo express","RV : gasoline","RV","gasoline","",$77.95,$0.00,-$2788.54
"Discover",,C,,03/05/2015,"Walmart","RV : Equipment/Supplies","RV","Equipment/Supplies","",$195.66,$0.00,-$2984.20
"Discover",,C,,03/06/2015,"Shell","RV : gasoline","RV","gasoline","",$32.86,$0.00,-$3017.06
"Discover",,C,,03/06/2015,"Knights Marathon","RV : Campgrounds","RV","Campgrounds","",$315.00,$0.00,-$3332.06
"Discover",,C,,03/07/2015,"CoinMach","RV : MISC","RV","MISC","laundry",$5.50,$0.00,-$3337.56
"Discover",,C,,03/07/2015,"Budget","RV : MISC","RV","MISC","Car Rental",$77.87,$0.00,-$3415.43
"Discover",,C,,03/08/2015,"Sandal Factory","Personal : cloths","Personal","cloths","T-shirts BOB",$11.83,$0.00,-$3427.26
"Discover",,C,,03/08/2015,"Sunset Grille","Food : Restaurants","Food","Restaurants","",$53.00,$0.00,-$3480.26
"Discover",,C,,03/09/2015,"CoinMach","RV : MISC","RV","MISC","Laundry",$5.50,$0.00,-$3485.76
"Discover",,C,,03/09/2015,"Turte Hospital Marathon","RV : Attractions","RV","Attractions","",$36.00,$0.00,-$3521.76
"Discover",,C,,03/09/2015,"publix","Food : Groceries","Food","Groceries","",$65.67,$0.00,-$3587.43
"Discover",,C,,03/10/2015,"UPS","Lisa Business : Supplies","Lisa Business","Supplies","",$3.40,$0.00,-$3590.83
"Discover",,C,,03/10/2015,"Tropical Shell Gift","Personal : Gifts","Personal","Gifts","",$30.08,$0.00,-$3620.91
"Discover",,C,,03/10/2015,"Blue Heaven","Food : Restaurants","Food","Restaurants","",$48.31,$0.00,-$3669.22
"Discover",,C,,03/11/2015,"Exxon mobile","Transportation : Gas","Transportation","Gas","",$14.29,$0.00,-$3683.51
"Discover",,C,,03/11/2015,"Sunoco Stewart FL","RV : gasoline","RV","gasoline","",$35.64,$0.00,-$3719.15
"Discover",,C,,03/11/2015,"Florids keylime pro","Food : Groceries","Food","Groceries","Keylime  pies",$67.27,$0.00,-$3786.42
"Discover",,C,,03/12/2015,"racetrack Mebourne FL","RV : gasoline","RV","gasoline","",$99.00,$0.00,-$3885.42
"Discover",,C,,03/14/2015,"redbox","Recreation : Entertainment","Recreation","Entertainment","",$1.59,$0.00,-$3887.01
"Discover",,C,,03/14/2015,"Walmart","Food : Groceries","Food","Groceries","",$49.93,$0.00,-$3936.94
"Discover",,C,,03/14/2015,"Verizon data trip","RV : MISC","RV","MISC","DATA for trip",$60.00,$0.00,-$3996.94
"Discover",,C,,03/14/2015,"Raceway Yulee FL","RV : gasoline","RV","gasoline","",$77.57,$0.00,-$4074.51
"Discover",,C,,03/15/2015,"shutter fly","Recreation : Alyssa","Recreation","Alyssa","",$6.37,$0.00,-$4080.88
"Discover",,C,,03/15/2015,"Jekyll Entrace","RV : Campgrounds","RV","Campgrounds","1197 Riverview Dr, Jekyll Island, GA 31527",$10.00,$0.00,-$4090.88
"Discover",,C,,03/15/2015,"Jekyll Gifts","Personal : Gifts","Personal","Gifts","",$14.82,$0.00,-$4105.70
"Discover",,C,,03/16/2015,"Global Affairs","Education : College","Education","College","",$25.00,$0.00,-$4130.70
"Discover",,C,,03/16/2015,"Publi Kitchen Savannah","Food : Restaurants","Food","Restaurants","",$85.00,$0.00,-$4215.70
"Discover",,C,,03/17/2015,"Planet Fitness","Recreation : His","Recreation","His","",$10.00,$0.00,-$4225.70
"Discover",,C,,03/17/2015,"Moon RIver Brewing","Food : Restaurants","Food","Restaurants","",$32.50,$0.00,-$4258.20
"Discover",,C,,03/18/2015,"Santee IGA","Food : Groceries","Food","Groceries","",$17.92,$0.00,-$4276.12
"Discover",,C,,03/18/2015,"Rvacation","RV : Campgrounds","RV","Campgrounds","",$33.00,$0.00,-$4309.12
"Discover",,C,,03/18/2015,"Exxon mobile","RV : gasoline","RV","gasoline","",$41.73,$0.00,-$4350.85
"Discover",,C,,03/18/2015,"Circle B 10 nc","RV : gasoline","RV","gasoline","",$79.60,$0.00,-$4430.45
"Discover",,C,,03/18/2015,"Exxon Santee sc","RV : gasoline","RV","gasoline","",$137.09,$0.00,-$4567.54
"Discover",,C,,03/19/2015,"hidden acres","RV : Campgrounds","RV","Campgrounds","",$37.50,$0.00,-$4605.04
"Discover",,C,,03/19/2015,"Fas Mart","RV : gasoline","RV","gasoline","",$61.01,$0.00,-$4666.05
"Discover",,C,,03/19/2015,"Hinnant vineyard pine","Food : Groceries","Food","Groceries","",$74.91,$0.00,-$4740.96
"Discover",,C,,03/20/2015,"netflix","Recreation : Entertainment","Recreation","Entertainment","",$16.48,$0.00,-$4757.44
"Discover",,C,,03/20/2015,"walmart sc","Food : Groceries","Food","Groceries","",$36.06,$0.00,-$4793.50
"Discover",,C,,03/21/2015,"redbox","Recreation : Entertainment","Recreation","Entertainment","",$1.59,$0.00,-$4795.09
"Discover",,C,,03/21/2015,"Walmart","Food : Groceries","Food","Groceries","",$7.26,$0.00,-$4802.35
"Discover",,C,,03/21/2015,"Walmart","Food : Groceries","Food","Groceries","",$15.28,$0.00,-$4817.63
"Discover",,C,,03/21/2015,"hershey","RV : Attractions","RV","Attractions","",$31.85,$0.00,-$4849.48
"Discover",,C,,03/21/2015,"shell PA","RV : gasoline","RV","gasoline","",$85.30,$0.00,-$4934.78
"Discover",,C,,03/23/2015,"Sears Roebuck","RV : Equipment/Supplies","RV","Equipment/Supplies","",$69.00,$0.00,-$5003.78
"Discover",,C,,03/23/2015,"Shell","RV : gasoline","RV","gasoline","",$99.06,$0.00,-$5102.84
"Discover",,C,,03/24/2015,"mad willies","Food : Restaurants","Food","Restaurants","",$9.07,$0.00,-$5111.91
"Discover",,C,,03/24/2015,"China Taste","Food : Restaurants","Food","Restaurants","",$27.77,$0.00,-$5139.68
"Discover",,C,,03/25/2015,"Shell","Transportation : Gas","Transportation","Gas","",$27.42,$0.00,-$5167.10
"Discover",,C,,03/25/2015,"hanaford","Food : Groceries","Food","Groceries","",$84.10,$0.00,-$5251.20
"Discover",,C,,03/25/2015,"Chucks Margarita Grill","Food : Restaurants","Food","Restaurants","",$126.22,$0.00,-$5377.42
"Discover",,C,,03/25/2015,"Marlboro dental","Personal : Doctor, Dentist","Personal","Doctor, Dentist","",$449.00,$0.00,-$5826.42
"Discover",,C,,03/26/2015,"hannaford","Food : Groceries","Food","Groceries","",$102.85,$0.00,-$5929.27
"Discover",,C,,03/27/2015,"still life home consignment","Personal : cloths","Personal","cloths","",$26.13,$0.00,-$5955.40
"Discover",,C,,03/28/2015,"hanaford","Food : Groceries","Food","Groceries","",$66.68,$0.00,-$6022.08
"Discover",,C,,03/29/2015,"sears","RV : Equipment/Supplies","RV","Equipment/Supplies","",$22.96,$0.00,-$6045.04
"Discover",,C,,03/29/2015,"chipolte","Food : Restaurants","Food","Restaurants","",$25.47,$0.00,-$6070.51
"Discover",,C,,03/29/2015,"Shell","Transportation : Gas","Transportation","Gas","",$28.54,$0.00,-$6099.05
"Discover",,C,,03/30/2015,"Hess","Transportation : Gas","Transportation","Gas","",$22.09,$0.00,-$6121.14
"Discover",,C,,04/02/2015,"Claiire's","Personal : cloths","Personal","cloths","",$11.95,$0.00,-$6133.09
"Discover",,C,,04/02/2015,"Hot Topic","Recreation : Alyssa","Recreation","Alyssa","",$16.73,$0.00,-$6149.82
"Discover",,C,,04/03/2015,"hannaford","Food : Groceries","Food","Groceries","",$172.30,$0.00,-$6322.12
"Discover",,C,,04/04/2015,"Micheals","Recreation : His","Recreation","His","",$12.48,$0.00,-$6334.60
"Discover",,C,,04/04/2015,"basha's matural","Food : Groceries","Food","Groceries","",$18.03,$0.00,-$6352.63
"Discover",,C,,04/04/2015,"Cumberland Farms","Transportation : Gas","Transportation","Gas","",$20.29,$0.00,-$6372.92
"Discover",,C,,04/04/2015,"sperry liquor","Food : Groceries","Food","Groceries","",$37.18,$0.00,-$6410.10
"Discover",,C,,04/04/2015,"MRKT BSKT","Food : Groceries","Food","Groceries","",$47.69,$0.00,-$6457.79
"Discover",,C,,04/06/2015,"Transfer : Dcu Checking",,,,"",$0.00,$3786.42,-$2671.37
"Discover",,C,,04/07/2015,"Rpbinsons Hardware","Housing : Maintenance & Repairs","Hidden Categories","Housing ` Maintenance & Repairs","",$5.97,$0.00,-$2677.34
"Discover",,C,,04/08/2015,"Hess","Transportation : Gas","Transportation","Gas","",$20.80,$0.00,-$2698.14
"Discover",,C,,04/08/2015,"shaw's Market","Food : Groceries","Food","Groceries","",$93.89,$0.00,-$2792.03
"Discover",,C,,04/09/2015,"USPS","Lisa Business : Office supplies","Lisa Business","Office supplies","",$13.38,$0.00,-$2805.41
"Discover",,C,,04/09/2015,"Basha","Food : Groceries","Food","Groceries","",$23.36,$0.00,-$2828.77
"Discover",,C,,04/10/2015,"Micheals","Recreation : His","Recreation","His",,$10.07,$0.00,-$2838.84
"Discover",,C,,04/10/2015,"tjmaxx","Personal : cloths","Personal","cloths","",$29.99,$0.00,-$2868.83
"Discover",,C,,04/12/2015,"Madris","Personal : cloths","Personal","cloths","",$27.82,$0.00,-$2896.65
"Discover",,C,,04/13/2015,"Price Chopper","Food : Groceries","Food","Groceries","",$75.65,$0.00,-$2972.30
"Discover",,C,,04/14/2015,"Exxon mobile","Transportation : Gas","Transportation","Gas","",$22.16,$0.00,-$2994.46
"Discover",,C,,04/15/2015,"Eaton Place oncology","Personal : Doctor, Dentist","Personal","Doctor, Dentist","",$22.00,$0.00,-$3016.46
"Discover",,C,,04/15/2015,"hannaford","Food : Groceries","Food","Groceries","",$33.52,$0.00,-$3049.98
"Discover",,C,,04/16/2015,"Canine Clips","Housing : Dog","Hidden Categories","Housing ` Dog","",$70.00,$0.00,-$3119.98
"Discover",,C,,04/17/2015,"Planet Fitness","Recreation : His","Recreation","His","",$10.00,$0.00,-$3129.98
"Discover",,C,,04/17/2015,"Home Depot","Lisa Business : Business expenses","Lisa Business","Business expenses","(Split 1/2) ",$17.00,$0.00,-$3183.87
"Discover",,C,,04/17/2015,"Home Depot","Transportation : Repairs & Maintenance","Transportation","Repairs & Maintenance","(Split 2/2) ",$36.89,$0.00,-$3183.87
"Discover",,C,,04/18/2015,"Price Chopper","Food : Groceries","Food","Groceries","",$65.93,$0.00,-$3249.80
"Discover",,C,,04/19/2015,"Walmart","RV : Equipment/Supplies","RV","Equipment/Supplies","wax",$19.06,$0.00,-$3268.86
"Discover",,C,,04/19/2015,"hannaford","Food : Groceries","Food","Groceries","",$37.29,$0.00,-$3306.15
"Discover",,C,,04/19/2015,"home depote","Transportation : Repairs & Maintenance","Transportation","Repairs & Maintenance","",$43.16,$0.00,-$3349.31
"Discover",,C,,04/19/2015,"sears","RV : Equipment/Supplies","RV","Equipment/Supplies","buffer",$53.11,$0.00,-$3402.42
"Discover",,C,,04/20/2015,"netflix","Recreation : Entertainment","Recreation","Entertainment","",$16.48,$0.00,-$3418.90
"Discover",,C,,04/20/2015,"hanaford","Food : Groceries","Food","Groceries","",$37.54,$0.00,-$3456.44
"Discover",,C,,04/21/2015,"Shell","Transportation : Gas","Transportation","Gas","",$31.48,$0.00,-$3487.92
"Discover",,C,,04/21/2015,"Cornerstone Supply","Lisa Business : Cost of Goods Sold","Lisa Business","Cost of Goods Sold","",$189.87,$0.00,-$3677.79
"Discover",,C,,04/22/2015,"hannaford","Food : Groceries","Food","Groceries","",$16.30,$0.00,-$3694.09
"Discover",,U,,04/23/2015,"Home Depot","Lisa Business : Supplies","Lisa Business","Supplies","",$14.15,$0.00,-$3708.24
"Discover",,C,,04/23/2015,"lamberts flowers","Lisa Business : Cost of Goods Sold","Lisa Business","Cost of Goods Sold","",$38.23,$0.00,-$3746.47
"Discover",,U,,04/23/2015,"Assabet Bicycle","Recreation : His","Recreation","His","",$203.50,$0.00,-$3949.97
"Discover",,U,,04/24/2015,"Cumberland Farms","Transportation : Gas","Transportation","Gas","",$21.62,$0.00,-$3971.59
"Discover",,U,,04/24/2015,"IYA Sushi and Noodle S. Hadley","Food : Restaurants","Food","Restaurants","",$52.00,$0.00,-$4023.59
"Discover",,U,,04/25/2015,"dunkin donuts","Food : Restaurants","Food","Restaurants","",$4.15,$0.00,-$4027.74
"Discover",,U,,04/27/2015,"hannaford","Food : Groceries","Food","Groceries","",$51.53,$0.00,-$4079.27
"Discover",,U,,04/29/2015,"shutter fly","Recreation : Entertainment","Recreation","Entertainment","",$23.84,$0.00,-$4103.11
"Discover",,U,,04/30/2015,"Shell","RV : gasoline","RV","gasoline","",$25.09,$0.00,-$4128.20
"Discover",,U,,05/01/2015,"woo jung","Food : Restaurants","Food","Restaurants","",$30.00,$0.00,-$4158.20
"Discover",,U,,05/01/2015,"Casa Vllarta","Food : Restaurants","Food","Restaurants","",$64.46,$0.00,-$4222.66
"Discover",,U,,05/02/2015,"poshmark","Personal : cloths","Personal","cloths","",$22.99,$0.00,-$4245.65
"Discover",,U,,05/02/2015,"hannaford","Food : Groceries","Food","Groceries","",$62.00,$0.00,-$4307.65
"Discover",,U,,05/03/2015,"Insominia Cookies","Food : Restaurants","Food","Restaurants","",$12.76,$0.00,-$4320.41
"Discover",,U,,05/03/2015,"Peppertree","RV : Campgrounds","RV","Campgrounds","",$30.00,$0.00,-$4350.41
"Discover",,U,,05/03/2015,"Peppertree","RV : propane","RV","propane","propane",$32.00,$0.00,-$4382.41
"Discover",,U,,05/03/2015,"Dog Lane","Food : Restaurants","Food","Restaurants","",$45.00,$0.00,-$4427.41
"Discover",,U,,05/04/2015,"hannaford","Food : Groceries","Food","Groceries","",$23.49,$0.00,-$4450.90
"Discover",,U,,05/05/2015,"Di Napoli","Food : Restaurants","Food","Restaurants","",$8.98,$0.00,-$4459.88
"Discover",,U,,05/06/2015,"Transfer : Dcu Checking",,,,"",$0.00,$2896.65,-$1563.23
"Discover",,U,,05/06/2015,"Amazon","business (bob) : Equipment","Hidden Categories","business (bob) ` Equipment","Book on writing",$12.59,$0.00,-$1575.82
"Discover",,U,,05/06/2015,"Amazon","RV : Equipment/Supplies","RV","Equipment/Supplies","Sealent Roof",$31.47,$0.00,-$1607.29
"Discover",,U,,05/06/2015,"Shell","Transportation : Gas","Transportation","Gas","",$35.11,$0.00,-$1642.40
"Discover",,U,,05/07/2015,"Shell","Transportation : Gas","Transportation","Gas","",$24.97,$0.00,-$1667.37
"Discover",,U,,05/07/2015,"Market bskt","Food : Groceries","Food","Groceries","",$81.33,$0.00,-$1748.70
"Discover",,U,,05/08/2015,"Basha","Food : Groceries","Food","Groceries","",$14.86,$0.00,-$1763.56
"Discover",,U,,05/11/2015,"Cumberland Farms","Transportation : Gas","Transportation","Gas","",$34.02,$0.00,-$1797.58
"Discover",,U,,05/12/2015,"Amazon","Recreation : Hers","Recreation","Hers","",$12.97,$0.00,-$1810.55
"Discover",,U,,05/12/2015,"hanaford","Food : Groceries","Food","Groceries","",$116.39,$0.00,-$1926.94
"Discover",,U,,05/15/2015,"hannaford","Food : Groceries","Food","Groceries","",$12.60,$0.00,-$1939.54
"Discover",,U,,05/15/2015,"northborough gas","Transportation : Gas","Transportation","Gas","",$23.26,$0.00,-$1962.80
"Discover",,U,,05/16/2015,"Supreme pizza","Food : Restaurants","Food","Restaurants","",$36.94,$0.00,-$1999.74
"Discover",,U,,05/17/2015,"Planet Fitness","Recreation : His","Recreation","His","",$10.00,$0.00,-$2009.74
"Discover",,U,,05/18/2015,"hannaford","Food : Groceries","Food","Groceries","",$107.56,$0.00,-$2117.30
"Discover",,U,,05/20/2015,"netflix","Recreation : Entertainment","Recreation","Entertainment","",$16.48,$0.00,-$2133.78
"Discover",,U,,05/21/2015,"Exxon mobile","RV : gasoline","RV","gasoline","",$34.13,$0.00,-$2167.91
"Discover",,U,,05/22/2015,"wayland mini market","Food : Groceries","Food","Groceries","",$4.87,$0.00,-$2172.78
"Discover",,U,,05/22/2015,"Price Chopper","Food : Groceries","Food","Groceries","",$47.22,$0.00,-$2220.00
"Discover",,U,,05/24/2015,"verc enterprise","Transportation : Gas","Transportation","Gas","",$25.42,$0.00,-$2245.42
"Discover",,U,,05/24/2015,"Lowe's of Hudson","Housing : Supplies","Hidden Categories","Housing ` Supplies","",$39.94,$0.00,-$2285.36
"Discover",,U,,05/24/2015,"Market bskt","Food : Groceries","Food","Groceries","",$162.18,$0.00,-$2447.54
"Discover",,U,,05/28/2015,"Price Chopper","Food : Groceries","Food","Groceries","",$88.94,$0.00,-$2536.48
"Discover",,U,,05/30/2015,"Cumberland Farms","Transportation : Gas","Transportation","Gas","",$24.91,$0.00,-$2561.39
"Discover",,U,,05/30/2015,"Maharaja Indian","Food : Restaurants","Food","Restaurants","",$42.63,$0.00,-$2604.02
"Discover",,U,,05/31/2015,"hanaford","Food : Groceries","Food","Groceries","",$74.26,$0.00,-$2678.28
"Discover",,U,,05/31/2015,"trader Joes","Food : Groceries","Food","Groceries","",$179.33,$0.00,-$2857.61
"Discover",,U,,06/01/2015,"ups store","Education : College","Education","College","fax to college",$6.38,$0.00,-$2863.99
"Discover",,U,,06/03/2015,"verc enterprise","Transportation : Gas","Transportation","Gas","",$32.48,$0.00,-$2896.47
"Discover",,U,,06/06/2015,"Transfer : Dcu Checking",,,,"",$0.00,$1797.58,-$1098.89
"Discover",,U,,06/06/2015,"linguines","Food : Restaurants","Food","Restaurants","",$34.40,$0.00,-$1133.29
"Discover",,U,,06/06/2015,"masspike","Transportation : tolls","Transportation","tolls","??",$50.10,$0.00,-$1183.39
"Discover",,U,,06/06/2015,"hannaford","Food : Groceries","Food","Groceries","",$169.56,$0.00,-$1352.95
"Discover",,U,,06/08/2015,"shutter fly","Recreation : Entertainment","Recreation","Entertainment","",$5.09,$0.00,-$1358.04
"Discover",,U,,06/08/2015,"Best Buy","Recreation : Alyssa","Recreation","Alyssa","",$65.61,$0.00,-$1423.65
"Discover",,U,,06/09/2015,"dunkin donuts","Food : Restaurants","Food","Restaurants","",$6.93,$0.00,-$1430.58
"Discover",,U,,06/09/2015,"","Transportation : Gas","Transportation","Gas","",$34.78,$0.00,-$1465.36
"Discover",,U,,06/10/2015,"shaw's Market","Food : Groceries","Food","Groceries","",$23.92,$0.00,-$1489.28
"Discover",,U,,06/12/2015,"Casa Vllarta","Food : Restaurants","Food","Restaurants","",$90.00,$0.00,-$1579.28
"Discover",,U,,06/14/2015,"China Taste","Food : Restaurants","Food","Restaurants","",$36.01,$0.00,-$1615.29
"Discover",,U,,06/14/2015,"hannaford","Food : Groceries","Food","Groceries","",$130.34,$0.00,-$1745.63
"Discover",,U,,06/15/2015,"Red Barn","Food : Restaurants","Food","Restaurants","",$15.14,$0.00,-$1760.77
"Discover",,U,,06/15/2015,"Gulf express","Transportation : Gas","Transportation","Gas","",$46.83,$0.00,-$1807.60
"Discover",,U,,06/16/2015,"Amazon","Recreation : Hers","Recreation","Hers","",$18.25,$0.00,-$1825.85
"Discover",,U,,06/16/2015,"Amazon","Education : College","Education","College","",$105.57,$0.00,-$1931.42
"Discover",,U,,06/17/2015,"Planet Fitness","Recreation : His","Recreation","His","",$10.00,$0.00,-$1941.42
"Discover",,U,,06/17/2015,"gasoline","Transportation : Gas","Transportation","Gas","",$33.32,$0.00,-$1974.74
"Discover",,U,,06/18/2015,"Shell","Transportation : Gas","Transportation","Gas","",$13.25,$0.00,-$1987.99
"Discover",,U,,06/18/2015,"hannaford","Food : Groceries","Food","Groceries","",$37.29,$0.00,-$2025.28
"Discover",,U,,06/19/2015,"Shell","Transportation : Gas","Transportation","Gas","",$24.53,$0.00,-$2049.81
"Discover",,U,,06/20/2015,"netflix","Recreation : Entertainment","Recreation","Entertainment","",$16.48,$0.00,-$2066.29
"Discover",,U,,06/23/2015,"Shell","Transportation : Gas","Transportation","Gas","",$37.78,$0.00,-$2104.07
"Discover",,U,,06/23/2015,"hannaford","Food : Groceries","Food","Groceries","",$112.89,$0.00,-$2216.96
"Discover",,U,,06/26/2015,"dunkin donuts","Food : Restaurants","Food","Restaurants","",$5.22,$0.00,-$2222.18
"Discover",,U,,06/27/2015,"verc enterprise","Transportation : Gas","Transportation","Gas","",$26.93,$0.00,-$2249.11
"Discover",,U,,06/27/2015,"hannaford","Food : Groceries","Food","Groceries","",$32.43,$0.00,-$2281.54
"Discover",,U,,06/27/2015,"minuteman campground","RV : Campgrounds","RV","Campgrounds","",$50.40,$0.00,-$2331.94
"Discover",,U,,06/29/2015,"shutter fly","Recreation : Entertainment","Recreation","Entertainment","",$3.05,$0.00,-$2334.99
"Discover",,U,,06/30/2015,"Market bskt","Food : Groceries","Food","Groceries","",$121.87,$0.00,-$2456.86
"Discover",,U,,07/01/2015,"Shell","Transportation : Gas","Transportation","Gas","",$32.98,$0.00,-$2489.84
"Discover",,U,,07/02/2015,"A1 auto","Transportation : Repairs & Maintenance","Transportation","Repairs & Maintenance","Brakes",$480.76,$0.00,-$2970.60
"Discover",,U,,07/03/2015,"reg of motor vehicles","Transportation : Registration","Transportation","Registration","",$60.00,$0.00,-$3030.60
"Discover",,U,,07/04/2015,"Amazon","Recreation : Alyssa","Recreation","Alyssa",,$0.00,$0.00,-$3030.60
"Discover",,U,,07/04/2015,"Amazon","Education : College","Education","College","",$13.80,$0.00,-$3044.40
"Discover",,U,,07/04/2015,"Amazon","Education : College","Education","College","",$63.98,$0.00,-$3108.38
"Discover",,U,,07/06/2015,"Transfer : Dcu Checking",,,,"",$0.00,$1489.28,-$1619.10
"Discover",,U,,07/06/2015,"Amazon","Recreation : Hers","Recreation","Hers","",$44.99,$0.00,-$1664.09
"Discover",,U,,07/06/2015,"hannaford","Food : Groceries","Food","Groceries","",$48.58,$0.00,-$1712.67
"Discover",,U,,07/07/2015,,"Transportation : Gas","Transportation","Gas","",$24.00,$0.00,-$1736.67
"Discover",,U,,07/07/2015,"Canine Clips","Housing : Dog","Hidden Categories","Housing ` Dog","",$80.50,$0.00,-$1817.17
"Discover",,U,,07/07/2015,"Price Chopper","Food : Groceries","Food","Groceries","",$104.65,$0.00,-$1921.82
"Discover",,U,,07/08/2015,"Exxon mobile","Transportation : Gas","Transportation","Gas","",$34.11,$0.00,-$1955.93
"Discover",,U,,07/09/2015,"Mr Macs","Food : Restaurants","Food","Restaurants","",$31.47,$0.00,-$1987.40
"Discover",,U,,07/10/2015,"Exxon mobile","RV : gasoline","RV","gasoline","",$100.00,$0.00,-$2087.40
"Discover",,U,,07/11/2015,"Price Chopper","Food : Groceries","Food","Groceries","",$33.97,$0.00,-$2121.37
"Discover",,U,,07/11/2015,"Cumberland Farms","Transportation : Gas","Transportation","Gas","",$34.71,$0.00,-$2156.08
"Discover",,U,,07/11/2015,"Price Chopper","Food : Groceries","Food","Groceries","",$88.52,$0.00,-$2244.60
"Discover",,U,,07/13/2015,"hannaford","Food : Groceries","Food","Groceries","",$27.89,$0.00,-$2272.49
"Discover",,U,,07/13/2015,"Marlboro Animal Hospital","Housing : Dog","Hidden Categories","Housing ` Dog","",$249.30,$0.00,-$2521.79
"Discover",,U,,07/16/2015,"Shell","Transportation : Gas","Transportation","Gas","",$32.28,$0.00,-$2554.07
"Discover",,U,,07/16/2015,"hannaford","Food : Groceries","Food","Groceries","",$86.90,$0.00,-$2640.97
"Discover",,U,,07/17/2015,"Planet Fitness","Recreation : His","Recreation","His","",$10.00,$0.00,-$2650.97
"Discover",,U,,07/18/2015,"chipolte","Food : Restaurants","Food","Restaurants","",$33.22,$0.00,-$2684.19
"Discover",,U,,07/20/2015,"netflix","Recreation : Entertainment","Recreation","Entertainment","",$16.48,$0.00,-$2700.67
"Discover",,U,,07/20/2015,"Shell","Transportation : Gas","Transportation","Gas","",$24.27,$0.00,-$2724.94
"Discover",,U,,07/21/2015,"Shell","Transportation : Gas","Transportation","Gas","",$38.24,$0.00,-$2763.18
"Discover",,U,,07/21/2015,"hannaford","Food : Groceries","Food","Groceries","",$81.85,$0.00,-$2845.03
"Discover",,U,,07/24/2015,"bolton orchards","Food : Groceries","Food","Groceries","",$8.79,$0.00,-$2853.82
"Discover",,U,,07/24/2015,"hannaford","Food : Groceries","Food","Groceries","",$72.89,$0.00,-$2926.71
"Discover",,U,,07/27/2015,"speedway","Transportation : Gas","Transportation","Gas","",$30.88,$0.00,-$2957.59
"Discover",,U,,07/28/2015,"whole foods","Food : Groceries","Food","Groceries","",$16.07,$0.00,-$2973.66
"Discover",,U,,07/28/2015,"Gulf express","Transportation : Gas","Transportation","Gas","",$25.53,$0.00,-$2999.19
"Discover",,U,,07/28/2015,"Marlboro Animal Hospital","Housing : Dog","Hidden Categories","Housing ` Dog","Choking/seizure emergency",$53.00,$0.00,-$3052.19
"Discover",,U,,07/28/2015,"hannaford","Food : Groceries","Food","Groceries","",$77.39,$0.00,-$3129.58
"Discover",,U,,07/29/2015,"dunkin donuts","Food : Restaurants","Food","Restaurants","",$5.44,$0.00,-$3135.02
"Discover",,U,,07/29/2015,"hannaford","Food : Groceries","Food","Groceries","",$15.27,$0.00,-$3150.29
"Discover",,U,,07/31/2015,"linguines","Food : Restaurants","Food","Restaurants","",$131.25,$0.00,-$3281.54
"Discover",,U,,08/02/2015,"Price Chopper","Food : Groceries","Food","Groceries","",$121.99,$0.00,-$3403.53
"Discover",,U,,08/03/2015,"Exxon mobile","Transportation : Gas","Transportation","Gas","",$24.12,$0.00,-$3427.65
"Discover",,U,,08/04/2015,"Price Chopper","Food : Groceries","Food","Groceries","",$0.00,$6.33,-$3421.32
"Discover",,U,,08/04/2015,"Price Chopper","Food : Groceries","Food","Groceries","",$35.53,$0.00,-$3456.85
"Discover",,U,,08/04/2015,,"Transportation : Gas","Transportation","Gas","",$37.05,$0.00,-$3493.90
"Discover",,U,,08/04/2015,"stop & shop","Food : Groceries","Food","Groceries","",$43.31,$0.00,-$3537.21
"Discover",,U,,08/05/2015,"Svg","Personal : Doctor, Dentist","Personal","Doctor, Dentist","",$15.00,$0.00,-$3552.21
"Discover",,U,,08/05/2015,"Virgin Atlantic","Recreation : Vacation","Recreation","Vacation","",$847.70,$0.00,-$4399.91
"Discover",,U,,08/06/2015,"Transfer : Dcu Checking",,,,"",$0.00,$2122.11,-$2277.80
"Discover",,U,,08/06/2015,"McDonalds","Food : Restaurants","Food","Restaurants","",$17.19,$0.00,-$2294.99
"Discover",,U,,08/07/2015,"Paquet Farm Shrewsbury","Food : Groceries","Food","Groceries","",$15.09,$0.00,-$2310.08
"Discover",,U,,08/08/2015,"hannaford","Food : Groceries","Food","Groceries","",$22.26,$0.00,-$2332.34
"Discover",,U,,08/08/2015,"Sunoco","Transportation : Gas","Transportation","Gas","",$23.63,$0.00,-$2355.97
"Discover",,U,,08/11/2015,"Dairy Joy","Food : Restaurants","Food","Restaurants","",$32.30,$0.00,-$2388.27
"Discover",,U,,08/11/2015,"Sameday Service","Personal : Miscellaneous","Personal","Miscellaneous","",$263.70,$0.00,-$2651.97
"Discover",,U,,08/13/2015,"hannaford","Food : Groceries","Food","Groceries","",$13.60,$0.00,-$2665.57
"Discover",,U,,08/14/2015,"Cumberland Farms","Transportation : Gas","Transportation","Gas","",$16.31,$0.00,-$2681.88
"Discover",,U,,08/15/2015,"consumer reports","Recreation : Entertainment","Recreation","Entertainment","",$30.00,$0.00,-$2711.88
"Discover",,U,,08/15/2015,"Shell","Transportation : Gas","Transportation","Gas","",$32.00,$0.00,-$2743.88
"Discover",,U,,08/16/2015,"hannaford","Food : Groceries","Food","Groceries","",$11.37,$0.00,-$2755.25
"Discover",,U,,08/16/2015,"Roche Brothers","Food : Groceries","Food","Groceries","",$51.65,$0.00,-$2806.90
"Discover",,U,,08/16/2015,"Museum of science","Recreation : His","Recreation","His","",$61.00,$0.00,-$2867.90
"Discover",,U,,08/17/2015,"shutter fly","Recreation : Entertainment","Recreation","Entertainment","",$6.10,$0.00,-$2874.00
"Discover",,U,,08/17/2015,"Planet Fitness","Recreation : His","Recreation","His","",$10.00,$0.00,-$2884.00
"Discover",,U,,08/17/2015,"Flaming Wok","Food : Restaurants","Food","Restaurants","",$32.98,$0.00,-$2916.98
"Discover",,U,,08/17/2015,"masspike","Transportation : tolls","Transportation","tolls","",$47.25,$0.00,-$2964.23
"Discover",,U,,08/18/2015,"Strand theatre","Food : Restaurants","Food","Restaurants","",$44.20,$0.00,-$3008.43
"Discover",,U,,08/19/2015,"town of brookline","Transportation : Parking","Transportation","Parking","",$2.00,$0.00,-$3010.43
"Discover",,U,,08/19/2015,"verc enterprise","Transportation : Gas","Transportation","Gas","",$12.56,$0.00,-$3022.99
"Discover",,U,,08/19/2015,"trader Joes","Food : Groceries","Food","Groceries","",$13.07,$0.00,-$3036.06
"Discover",,U,,08/19/2015,"walgreens","Housing : Supplies","Hidden Categories","Housing ` Supplies","",$18.56,$0.00,-$3054.62
"Discover",,U,,08/19/2015,"Fish","Food : Restaurants","Food","Restaurants","",$115.28,$0.00,-$3169.90
"Discover",,U,,08/20/2015,"netflix","Recreation : Entertainment","Recreation","Entertainment","",$16.48,$0.00,-$3186.38
"Discover",,U,,08/20/2015,"chipolte","Food : Restaurants","Food","Restaurants","",$24.34,$0.00,-$3210.72
"Discover",,U,,08/20/2015,"sea basket Restaurant","Food : Restaurants","Food","Restaurants","",$27.38,$0.00,-$3238.10
"Discover",,U,,08/20/2015,"A1 auto","Transportation : Repairs & Maintenance","Transportation","Repairs & Maintenance","",$34.35,$0.00,-$3272.45
"Discover",,U,,08/20/2015,"Papa Gino's","Food : Restaurants","Food","Restaurants","",$48.78,$0.00,-$3321.23
"Discover",,U,,08/20/2015,"hannaford","Food : Groceries","Food","Groceries","",$165.24,$0.00,-$3486.47
"Discover",,U,,08/22/2015,"coastal Maine botanical","Recreation : Vacation","Recreation","Vacation","",$83.12,$0.00,-$3569.59
"Discover",,U,,08/22/2015,"coastal Maine botanical","Recreation : Vacation","Recreation","Vacation","",$89.04,$0.00,-$3658.63
"Discover",,U,,08/23/2015,"Sadie Green's","Personal : Gifts","Personal","Gifts","",$11.55,$0.00,-$3670.18
"Discover",,U,,08/24/2015,"Shell","Transportation : Gas","Transportation","Gas","",$80.56,$0.00,-$3750.74
"Discover",,U,,08/25/2015,"Strand theatre","Food : Restaurants","Food","Restaurants","",$16.50,$0.00,-$3767.24
"Discover",,U,,08/25/2015,"Shell","Transportation : Gas","Transportation","Gas","",$31.47,$0.00,-$3798.71
"Discover",,U,,08/25/2015,"Strand theatre","Food : Restaurants","Food","Restaurants","",$41.86,$0.00,-$3840.57
"Discover",,U,,08/26/2015,"naziha","Transportation : Gas","Transportation","Gas","",$23.59,$0.00,-$3864.16
"Discover",,U,,08/27/2015,"Price Chopper","Food : Groceries","Food","Groceries","",$13.31,$0.00,-$3877.47
"Discover",,U,,08/28/2015,"LAZ Parking","Transportation : Parking","Transportation","Parking","",$20.00,$0.00,-$3897.47
"Discover",,U,,08/29/2015,"hanaford","Food : Groceries","Food","Groceries","",$100.30,$0.00,-$3997.77
"Discover",,U,,08/31/2015,"Southboro autotech","Transportation : Gas","Transportation","Gas","",$30.45,$0.00,-$4028.22
"Discover",,U,,08/31/2015,"Virgin Atlantic","Recreation : Vacation","Recreation","Vacation","",$1699.60,$0.00,-$5727.82
"Discover",,U,,09/01/2015,"Price Chopper","Food : Groceries","Food","Groceries","",$105.25,$0.00,-$5833.07
"Discover",,U,,09/01/2015,"airbnb","Recreation : Vacation","Recreation","Vacation","",$857.00,$0.00,-$6690.07
"Discover",,U,,09/02/2015,"Amazon","Personal : Gifts","Personal","Gifts","",$59.66,$0.00,-$6749.73
"Discover",,U,,09/02/2015,"Marlboro dental","Personal : Doctor, Dentist","Personal","Doctor, Dentist","",$299.00,$0.00,-$7048.73
"Discover",,U,,09/03/2015,"hanaford","Food : Groceries","Food","Groceries","",$13.12,$0.00,-$7061.85
"Discover",,U,,09/04/2015,"verc enterprise","Transportation : Gas","Transportation","Gas","",$21.77,$0.00,-$7083.62
"Discover",,U,,09/04/2015,"Apple Store","Housing : Phone & Internet","Hidden Categories","Housing ` Phone & Internet","",$105.19,$0.00,-$7188.81
"Discover",,U,,09/04/2015,"Apple Store","Housing : Phone & Internet","Hidden Categories","Housing ` Phone & Internet","",$105.19,$0.00,-$7294.00
"Discover",,U,,09/04/2015,"Apple Store","Housing : Phone & Internet","Hidden Categories","Housing ` Phone & Internet","",$204.19,$0.00,-$7498.19
"Discover",,U,,09/05/2015,"hanaford","Food : Groceries","Food","Groceries","",$91.74,$0.00,-$7589.93
"Discover",,U,,09/06/2015,"Transfer : Dcu Checking",,,,"",$0.00,$2619.67,-$4970.26
"Discover",,U,,09/07/2015,"Price Chopper","Food : Groceries","Food","Groceries","",$43.00,$0.00,-$5013.26
"Discover",,U,,09/07/2015,"Dsw","Personal : cloths","Personal","cloths","",$46.35,$0.00,-$5059.61
"Discover",,U,,09/07/2015,"hannaford","Food : Groceries","Food","Groceries","",$60.64,$0.00,-$5120.25
"Discover",,U,,09/08/2015,"Kindle","Recreation : Entertainment","Recreation","Entertainment","",$9.04,$0.00,-$5129.29
"Discover",,U,,09/08/2015,"wahlgreens","Housing : Supplies","Hidden Categories","Housing ` Supplies","",$21.23,$0.00,-$5150.52
"Discover",,U,,09/08/2015,"Shell","Transportation : Gas","Transportation","Gas","",$31.53,$0.00,-$5182.05
"Discover",,U,,09/11/2015,"verc enterprise","Transportation : Gas","Transportation","Gas","",$22.03,$0.00,-$5204.08
"Discover",,U,,09/11/2015,"Canine Clips","Housing : Dog","Hidden Categories","Housing ` Dog","",$55.00,$0.00,-$5259.08
"Discover",,U,,09/12/2015,"Massport Logan","Lisa Business : Parking","Lisa Business","Parking","",$6.00,$0.00,-$5265.08
"Discover",,U,,09/12/2015,"Amazon","Personal : Gifts","Personal","Gifts","",$27.90,$0.00,-$5292.98
"Discover",,U,,09/12/2015,"boylston","Transportation : Gas","Transportation","Gas","",$28.74,$0.00,-$5321.72
"Discover",,U,,09/13/2015,"Panera Bread","Food : Restaurants","Food","Restaurants","",$10.63,$0.00,-$5332.35
"Discover",,U,,09/15/2015,"Pet Source","Housing : Dog","Hidden Categories","Housing ` Dog","",$8.49,$0.00,-$5340.84
"Discover",,U,,09/15/2015,"Gulfmart","Transportation : Gas","Transportation","Gas","",$29.67,$0.00,-$5370.51
"Discover",,U,,09/15/2015,"Marlboro Animal Hospital","Housing : Dog","Hidden Categories","Housing ` Dog","",$360.66,$0.00,-$5731.17
"Discover",,U,,09/16/2015,"Pet Gone Healthy","Housing : Dog","Hidden Categories","Housing ` Dog","",$35.04,$0.00,-$5766.21
"Discover",,U,,09/17/2015,"Planet Fitness","Recreation : His","Recreation","His","",$10.00,$0.00,-$5776.21
"Discover",,U,,09/17/2015,"NYA Joe","Food : Restaurants","Food","Restaurants","",$60.79,$0.00,-$5837.00
"Discover",,U,,09/17/2015,"Tufts Animal Hospital","Housing : Dog","Hidden Categories","Housing ` Dog","",$2625.00,$0.00,-$8462.00
"Discover",,U,,09/18/2015,"Bertucci","Food : Restaurants","Food","Restaurants","",$57.73,$0.00,-$8519.73
"Discover",,U,,09/19/2015,"itunes","Recreation : Entertainment","Recreation","Entertainment","",$0.99,$0.00,-$8520.72
"Discover",,U,,09/19/2015,"Nancies Candy","Food : Restaurants","Food","Restaurants","",$33.78,$0.00,-$8554.50
"Discover",,U,,09/20/2015,"netflix","Recreation : Entertainment","Recreation","Entertainment","",$16.48,$0.00,-$8570.98
"Discover",,U,,09/20/2015,"Exxon mobile","Transportation : Gas","Transportation","Gas","",$22.98,$0.00,-$8593.96
"Discover",,U,,09/21/2015,"hannaford","Food : Groceries","Food","Groceries","",$114.44,$0.00,-$8708.40
"Discover",,U,,09/23/2015,"masspike","Transportation : tolls","Transportation","tolls","",$50.80,$0.00,-$8759.20
"Discover",,U,,09/24/2015,"Amazon","Personal : Gifts","Personal","Gifts","",$0.00,$20.56,-$8738.64
"Discover",,U,,09/26/2015,"Market bskt","Food : Groceries","Food","Groceries","",$87.24,$0.00,-$8825.88
"Discover",,U,,09/28/2015,"Cumberland Farms","Transportation : Gas","Transportation","Gas","",$20.93,$0.00,-$8846.81
"Discover",,U,,09/28/2015,"Cts shrewsbury","Personal : Gifts","Personal","Gifts","",$38.51,$0.00,-$8885.32
"Discover",,U,,09/29/2015,"Marlboro Animal Hospital","Housing : Dog","Hidden Categories","Housing ` Dog","",$0.00,$70.66,-$8814.66
"Discover",,U,,09/30/2015,"hannaford","Food : Groceries","Food","Groceries","",$56.61,$0.00,-$8871.27
"Discover",,U,,10/01/2015,"Planet Fitness","Recreation : His","Recreation","His","",$20.00,$0.00,-$8891.27
"Discover",,U,,10/01/2015,"Officemax","Lisa Business : Office supplies","Lisa Business","Office supplies","",$48.86,$0.00,-$8940.13
"Discover",,U,,10/01/2015,"soul of Sudbury","Food : Restaurants","Food","Restaurants","",$72.46,$0.00,-$9012.59
"Discover",,U,,10/02/2015,"hanaford","Food : Groceries","Food","Groceries","",$58.99,$0.00,-$9071.58
"Discover",,U,,10/03/2015,"Peppertree","RV : MISC","RV","MISC","",$64.99,$0.00,-$9136.57
"Discover",,U,,10/05/2015,"hannaford","Food : Groceries","Food","Groceries","",$23.91,$0.00,-$9160.48
"Discover",,U,,10/06/2015,"Transfer : Dcu Checking",,,,"",$0.00,$5287.82,-$3872.66
"Discover",,U,,10/06/2015,"Southboro autotech","Transportation : Gas","Transportation","Gas","",$26.59,$0.00,-$3899.25
"Discover",,U,,10/06/2015,"Ocean State Joblot","Housing : Supplies","Hidden Categories","Housing ` Supplies","",$28.54,$0.00,-$3927.79
"Discover",,U,,10/06/2015,"Marlborough Super Buffet","Food : Restaurants","Food","Restaurants",,$29.85,$0.00,-$3957.64
"Discover",,U,,10/07/2015,"speedway","Transportation : Gas","Transportation","Gas","",$15.94,$0.00,-$3973.58
"Discover",,U,,10/07/2015,"Price Chopper","Food : Groceries","Food","Groceries","",$16.65,$0.00,-$3990.23
"Discover",,U,,10/09/2015,"whole foods","Food : Groceries","Food","Groceries","",$9.14,$0.00,-$3999.37
"Discover",,U,,10/11/2015,"reg of motor vehicles","Transportation : Registration","Transportation","Registration","",$60.00,$0.00,-$4059.37
"Discover",,U,,10/12/2015,"wendy's","Food : Restaurants","Food","Restaurants","",$11.74,$0.00,-$4071.11
"Discover",,U,,10/12/2015,"beehive Bristol","Food : Restaurants","Food","Restaurants","",$33.96,$0.00,-$4105.07
"Discover",,U,,10/13/2015,"Santa   Cruz Deli","Food : Restaurants","Food","Restaurants","",$9.31,$0.00,-$4114.38
"Discover",,U,,10/13/2015,"Mostlypaw","Housing : Dog","Hidden Categories","Housing ` Dog","",$9.95,$0.00,-$4124.33
"Discover",,U,,10/13/2015,"hannaford","Food : Groceries","Food","Groceries","",$29.09,$0.00,-$4153.42
"Discover",,U,,10/13/2015,"hannaford","Food : Groceries","Food","Groceries","",$57.92,$0.00,-$4211.34
"Discover",,U,,10/14/2015,"speedway","Transportation : Gas","Transportation","Gas","",$17.70,$0.00,-$4229.04
"Discover",,U,,10/14/2015,"hannaford","Food : Groceries","Food","Groceries","",$19.23,$0.00,-$4248.27
"Discover",,U,,10/15/2015,"USPS","Lisa Business : Office supplies","Lisa Business","Office supplies","",$9.80,$0.00,-$4258.07
"Discover",,U,,10/17/2015,"Planet Fitness","Recreation : His","Recreation","His","",$10.00,$0.00,-$4268.07
"Discover",,U,,10/17/2015,"Price Chopper","Food : Groceries","Food","Groceries","",$23.73,$0.00,-$4291.80
"Discover",,U,,10/17/2015,"Marshall's","Personal : cloths","Personal","cloths","",$38.97,$0.00,-$4330.77
"Discover",,U,,10/18/2015,"itunes","Recreation : Entertainment","Recreation","Entertainment","",$0.99,$0.00,-$4331.76
"Discover",,U,,10/18/2015,"Bolton spring farm","Food : Groceries","Food","Groceries","",$8.95,$0.00,-$4340.71
"Discover",,U,,10/18/2015,"Exxon mobile","Transportation : Gas","Transportation","Gas","",$25.65,$0.00,-$4366.36
"Discover",,U,,10/18/2015,"hannaford","Food : Groceries","Food","Groceries","",$39.51,$0.00,-$4405.87
"Discover",,U,,10/19/2015,"Birchlers Automotive","RV : MISC","RV","MISC","",$179.90,$0.00,-$4585.77
"Discover",,U,,10/20/2015,"netflix","Recreation : Entertainment","Recreation","Entertainment","",$16.48,$0.00,-$4602.25
"Discover",,U,,10/21/2015,"chipolte","Food : Restaurants","Food","Restaurants","",$17.55,$0.00,-$4619.80
"Discover",,U,,10/21/2015,"speedway","Transportation : Gas","Transportation","Gas","",$18.29,$0.00,-$4638.09
"Discover",,U,,10/22/2015,"hanaford","Food : Groceries","Food","Groceries","",$57.07,$0.00,-$4695.16
"Discover",,U,,10/22/2015,"Dolphin Seafood","Food : Restaurants","Food","Restaurants","",$93.31,$0.00,-$4788.47
"Discover",,U,,10/24/2015,"Mos Cafe","Food : Restaurants","Food","Restaurants","",$3.76,$0.00,-$4792.23
"Discover",,U,,10/24/2015,"Museum of science","Recreation : His","Recreation","His","",$5.00,$0.00,-$4797.23
"Discover",,U,,10/24/2015,"Mos Cafe","Food : Restaurants","Food","Restaurants","",$9.29,$0.00,-$4806.52
"Discover",,U,,10/24/2015,"Museum of science","Recreation : His","Recreation","His","",$10.00,$0.00,-$4816.52
"Discover",,U,,10/24/2015,"Museum of science","Recreation : His","Recreation","His","",$10.00,$0.00,-$4826.52
"Discover",,U,,10/24/2015,"Museum of science","Recreation : His","Recreation","His","",$13.00,$0.00,-$4839.52
"Discover",,U,,10/24/2015,"Shell","Transportation : Gas","Transportation","Gas","",$25.75,$0.00,-$4865.27
"Discover",,U,,10/24/2015,"Museum of science","Recreation : His","Recreation","His","",$130.00,$0.00,-$4995.27
"Discover",,U,,10/26/2015,"speedway","Transportation : Gas","Transportation","Gas","",$16.85,$0.00,-$5012.12
"Discover",,U,,10/26/2015,"Goodwill Hyannis","Personal : cloths","Personal","cloths","",$30.96,$0.00,-$5043.08
"Discover",,U,,10/27/2015,"dunkin donuts","Food : Restaurants","Food","Restaurants","",$3.47,$0.00,-$5046.55
"Discover",,U,,10/27/2015,"whole foods","Food : Groceries","Food","Groceries","",$11.50,$0.00,-$5058.05
"Discover",,U,,10/28/2015,"USPS","Housing : Supplies","Hidden Categories","Housing ` Supplies","",$25.75,$0.00,-$5083.80
"Discover",,U,,10/29/2015,"Burger King","Food : Restaurants","Food","Restaurants","",$4.90,$0.00,-$5088.70
"Discover",,U,,10/29/2015,"Price Chopper","Food : Groceries","Food","Groceries","",$174.73,$0.00,-$5263.43
"Discover",,U,,10/30/2015,"verc enterprise","Transportation : Gas","Transportation","Gas","",$26.16,$0.00,-$5289.59
"Discover",,U,,10/31/2015,"masspike","Transportation : tolls","Transportation","tolls","",$48.85,$0.00,-$5338.44
"Discover",,U,,11/02/2015,"Sunoco","Transportation : Gas","Transportation","Gas","",$14.18,$0.00,-$5352.62
"Discover",,U,,11/03/2015,"Vanilla Bean Cafe","Food : Restaurants","Food","Restaurants","",$33.75,$0.00,-$5386.37
"Discover",,U,,11/04/2015,"Price Chopper","Food : Groceries","Food","Groceries","",$41.81,$0.00,-$5428.18
"Discover",,U,,11/05/2015,"Shell","Transportation : Gas","Transportation","Gas","",$29.98,$0.00,-$5458.16
"Discover",,U,,11/05/2015,"A1 auto","Transportation : Repairs & Maintenance","Transportation","Repairs & Maintenance","",$36.85,$0.00,-$5495.01
"Discover",,U,,11/06/2015,"Transfer : Dcu Checking",,,,"",$0.00,$4093.33,-$1401.68
"Discover",,U,,11/06/2015,"Shell","Transportation : Gas","Transportation","Gas","",$6.12,$0.00,-$1407.80
"Discover",,U,,11/06/2015,"Chez siam","Food : Restaurants","Food","Restaurants","",$40.00,$0.00,-$1447.80
"Discover",,U,,11/06/2015,"reg of motor vehicles","Transportation : Registration","Transportation","Registration","",$50.00,$0.00,-$1497.80
"Discover",,U,,11/09/2015,"kelly's roastbeef","Food : Restaurants","Food","Restaurants","",$13.05,$0.00,-$1510.85
"Discover",,U,,11/10/2015,"subway","Food : Restaurants","Food","Restaurants","",$6.20,$0.00,-$1517.05
"Discover",,U,,11/10/2015,"chipolte","Food : Restaurants","Food","Restaurants","",$8.00,$0.00,-$1525.05
"Discover",,U,,11/10/2015,"Exxon mobile","Transportation : Gas","Transportation","Gas","",$19.26,$0.00,-$1544.31
"Discover",,U,,11/10/2015,"Walmart","Housing : Supplies","Hidden Categories","Housing ` Supplies","",$19.36,$0.00,-$1563.67
"Discover",,U,,11/10/2015,"represent","Personal : Gifts","Personal","Gifts","",$33.98,$0.00,-$1597.65
"Discover",,U,,11/10/2015,"Marshall's","Personal : cloths","Personal","cloths","",$48.79,$0.00,-$1646.44
"Discover",,U,,11/11/2015,"Shell","Transportation : Gas","Transportation","Gas","",$26.92,$0.00,-$1673.36
"Discover",,U,,11/11/2015,"the bistro","Food : Restaurants","Food","Restaurants","",$28.65,$0.00,-$1702.01
"Discover",,U,,11/11/2015,"hannaford","Food : Groceries","Food","Groceries","",$31.39,$0.00,-$1733.40
"Discover",,U,,11/12/2015,"hanaford","Food : Groceries","Food","Groceries","",$17.12,$0.00,-$1750.52
"Discover",,U,,11/12/2015,"hannaford","Food : Groceries","Food","Groceries","",$27.12,$0.00,-$1777.64
"Discover",,U,,11/12/2015,"silk road bistro","Food : Restaurants","Food","Restaurants","",$40.61,$0.00,-$1818.25
"Discover",,U,,11/15/2015,"slaters Bolton","Food : Restaurants","Food","Restaurants","",$37.72,$0.00,-$1855.97
"Discover",,U,,11/16/2015,"Amazon","Housing : Supplies","Hidden Categories","Housing ` Supplies","",$15.98,$0.00,-$1871.95
"Discover",,U,,11/16/2015,"Market bskt","Food : Groceries","Food","Groceries","",$45.95,$0.00,-$1917.90
"Discover",,U,,11/16/2015,"aribnb","Recreation : Vacation","Recreation","Vacation","",$983.00,$0.00,-$2900.90
"Discover",,U,,11/17/2015,"itunes","Recreation : Entertainment","Recreation","Entertainment","",$0.99,$0.00,-$2901.89
"Discover",,U,,11/17/2015,"subway","Food : Restaurants","Food","Restaurants","",$6.84,$0.00,-$2908.73
"Discover",,U,,11/17/2015,"Planet Fitness","Recreation : His","Recreation","His","",$10.00,$0.00,-$2918.73
"Discover",,U,,11/17/2015,"sudbury golf","Transportation : Gas","Transportation","Gas","",$21.36,$0.00,-$2940.09
"Discover",,U,,11/17/2015,"masspike","Transportation : tolls","Transportation","tolls","",$46.20,$0.00,-$2986.29
"Discover",,U,,11/18/2015,"Honey Dew","Food : Groceries","Food","Groceries","",$5.30,$0.00,-$2991.59
"Discover",,U,,11/18/2015,"USPS","Housing : Supplies","Hidden Categories","Housing ` Supplies","",$7.42,$0.00,-$2999.01
"Discover",,U,,11/18/2015,"Shell","Transportation : Gas","Transportation","Gas","",$26.00,$0.00,-$3025.01
"Discover",,U,,11/18/2015,"silk road bistro","Food : Restaurants","Food","Restaurants","",$41.46,$0.00,-$3066.47
"Discover",,U,,11/19/2015,"sperry liquor","Food : Groceries","Food","Groceries","",$18.28,$0.00,-$3084.75
"Discover",,U,,11/19/2015,"Price Chopper","Food : Groceries","Food","Groceries","",$66.42,$0.00,-$3151.17
"Discover",,U,,11/20/2015,"netflix","Recreation : Entertainment","Recreation","Entertainment","",$16.48,$0.00,-$3167.65
"Discover",,U,,11/20/2015,"hannaford","Food : Groceries","Food","Groceries","",$138.01,$0.00,-$3305.66
"Discover",,U,,11/22/2015,"Lowe's of Hudson","Housing : Maintenance & Repairs","Hidden Categories","Housing ` Maintenance & Repairs","",$4.23,$0.00,-$3309.89
"Discover",,U,,11/23/2015,"dunkin donuts","Food : Restaurants","Food","Restaurants","",$8.68,$0.00,-$3318.57
"Discover",,U,,11/24/2015,"LAZ Parking","Transportation : Parking","Transportation","Parking","",$20.00,$0.00,-$3338.57
"Discover",,U,,11/24/2015,"verc enterprise","Transportation : Gas","Transportation","Gas","",$20.63,$0.00,-$3359.20
"Discover",,U,,11/24/2015,"Shell","Transportation : Gas","Transportation","Gas","",$26.95,$0.00,-$3386.15
"Discover",,U,,11/24/2015,"New England Aquariam","Recreation : Entertainment","Recreation","Entertainment","",$53.90,$0.00,-$3440.05
"Discover",,U,,11/24/2015,"cabelas","Personal : Gifts","Personal","Gifts","",$100.00,$0.00,-$3540.05
"Discover",,U,,11/24/2015,"cantina Italians","Food : Restaurants","Food","Restaurants","",$111.09,$0.00,-$3651.14
"Discover",,U,,11/25/2015,"dunkin donuts","Food : Restaurants","Food","Restaurants","",$3.90,$0.00,-$3655.04
"Discover",,U,,11/25/2015,"Honey Dew","Food : Groceries","Food","Groceries","",$5.21,$0.00,-$3660.25
"Discover",,U,,11/25/2015,"Bertucci","Food : Restaurants","Food","Restaurants","",$51.34,$0.00,-$3711.59
"Discover",,U,,11/25/2015,"hannaford","Food : Groceries","Food","Groceries","",$74.20,$0.00,-$3785.79
"Discover",,U,,11/28/2015,"Groupon","Recreation : Entertainment","Recreation","Entertainment","",$84.98,$0.00,-$3870.77
"Discover",,U,,11/29/2015,"Home Depot","Housing : Maintenance & Repairs","Hidden Categories","Housing ` Maintenance & Repairs","",$8.46,$0.00,-$3879.23
"Discover",,U,,11/29/2015,"chipolte","Food : Restaurants","Food","Restaurants","",$19.74,$0.00,-$3898.97
"Discover",,U,,11/29/2015,"Home Depot","Housing : Supplies","Hidden Categories","Housing ` Supplies","Fridge",$1076.31,$0.00,-$4975.28
"Discover",,U,,11/30/2015,"walgreens","Housing : Supplies","Hidden Categories","Housing ` Supplies","",$2.41,$0.00,-$4977.69
"Discover",,U,,12/01/2015,"Kindle","Recreation : Entertainment","Recreation","Entertainment","",$6.99,$0.00,-$4984.68
"Discover",,U,,12/01/2015,"dunkin donuts","Food : Restaurants","Food","Restaurants","",$7.67,$0.00,-$4992.35
"Discover",,U,,12/01/2015,"China Taste","Food : Restaurants","Food","Restaurants","",$46.38,$0.00,-$5038.73
"Discover",,U,,12/02/2015,"dunkin donuts","Food : Restaurants","Food","Restaurants","",$3.62,$0.00,-$5042.35
"Discover",,U,,12/02/2015,"gulf mart","Transportation : Gas","Transportation","Gas","",$19.23,$0.00,-$5061.58
"Discover",,U,,12/02/2015,"Kennedy's","Food : Restaurants","Food","Restaurants","",$62.88,$0.00,-$5124.46
"Discover",,U,,12/03/2015,"hannaford","Food : Groceries","Food","Groceries","",$25.35,$0.00,-$5149.81
"Discover",,U,,12/03/2015,"Price Chopper","Food : Groceries","Food","Groceries","",$103.25,$0.00,-$5253.06
"Discover",,U,,12/04/2015,"Shell","Transportation : Gas","Transportation","Gas","",$29.39,$0.00,-$5282.45
"Discover",,U,,12/06/2015,"Transfer : Dcu Checking",,,,"",$0.00,$1733.40,-$3549.05
"Discover",,U,,12/07/2015,"Exxon mobile","Savings : RV REPLACEMENT","Savings","RV REPLACEMENT","",$85.28,$0.00,-$3634.33
"Discover",,U,,12/07/2015,"stop & shop","Food : Groceries","Food","Groceries","",$99.20,$0.00,-$3733.53
"Discover",,U,,12/09/2015,"Brignams And Women's hospital","Food : Restaurants","Food","Restaurants","",$8.00,$0.00,-$3741.53
"Discover",,U,,12/09/2015,"Amazon","Personal : Gifts","Personal","Gifts","",$25.98,$0.00,-$3767.51
"Discover",,U,,12/09/2015,"Amazon","Personal : Gifts","Personal","Gifts","",$26.58,$0.00,-$3794.09
"Discover",,U,,12/09/2015,"Shell","Transportation : Gas","Transportation","Gas","",$27.61,$0.00,-$3821.70
"Discover",,U,,12/09/2015,"Amazon","Personal : Gifts","Personal","Gifts","",$31.98,$0.00,-$3853.68
"Discover",,U,,12/10/2015,"masspike","Transportation : tolls","Transportation","tolls","",$45.10,$0.00,-$3898.78
"Discover",,U,,12/10/2015,"Amazon","Personal : Gifts","Personal","Gifts","",$51.22,$0.00,-$3950.00
"Discover",,U,,12/10/2015,"SICHUAN GOURMENT","Food : Restaurants","Food","Restaurants","",$61.68,$0.00,-$4011.68
"Discover",,U,,12/11/2015,"Amazon","Personal : Gifts","Personal","Gifts","",$42.37,$0.00,-$4054.05
"Discover",,U,,12/11/2015,"Amazon","Personal : Gifts","Personal","Gifts","",$58.40,$0.00,-$4112.45
"Discover",,U,,12/13/2015,"A.L. Prime","Transportation : Gas","Transportation","Gas","",$18.13,$0.00,-$4130.58
"Discover",,U,,12/13/2015,"hannaford","Food : Groceries","Food","Groceries","",$79.89,$0.00,-$4210.47
"Discover",,U,,12/14/2015,"Dr Kofos","Personal : Doctor, Dentist","Personal","Doctor, Dentist","",$184.00,$0.00,-$4394.47
"Discover",,U,,12/16/2015,"Micheals","Recreation : His","Recreation","His","",$6.34,$0.00,-$4400.81
"Discover",,U,,12/17/2015,"Planet Fitness","Recreation : His","Recreation","His","",$10.00,$0.00,-$4410.81
"Discover",,U,,12/18/2015,"itunes","Recreation : Entertainment","Recreation","Entertainment","",$0.99,$0.00,-$4411.80
"Discover",,U,,12/20/2015,"netflix","Recreation : Entertainment","Recreation","Entertainment","",$16.48,$0.00,-$4428.28
"Discover",,U,,12/20/2015,"Exxon mobile","Savings : RV REPLACEMENT","Savings","RV REPLACEMENT","",$23.96,$0.00,-$4452.24
"Discover",,U,,12/20/2015,"hanaford","Food : Groceries","Food","Groceries","",$29.67,$0.00,-$4481.91
"Discover",,U,,12/23/2015,"hillside meadows","Recreation : Alyssa Horse","Recreation","Alyssa Horse","",$100.00,$0.00,-$4581.91
"Discover",,U,,12/23/2015,"saramassge","Personal : Gifts","Personal","Gifts","",$100.00,$0.00,-$4681.91
"Discover",,U,,12/24/2015,"Basha","Food : Groceries","Food","Groceries","",$24.42,$0.00,-$4706.33
"Discover",,U,,12/24/2015,"walgreens","Housing : Supplies","Hidden Categories","Housing ` Supplies","",$25.47,$0.00,-$4731.80
"Discover",,U,,12/24/2015,"Paper Store","Personal : Gifts","Personal","Gifts","",$28.07,$0.00,-$4759.87
"Discover",,U,,12/26/2015,"stop & shop","Food : Groceries","Food","Groceries","",$25.97,$0.00,-$4785.84
"Discover",,U,,12/27/2015,"Amazon video","Recreation : Entertainment","Recreation","Entertainment","",$4.99,$0.00,-$4790.83
"Discover",,U,,12/27/2015,"speedway","Transportation : Gas","Transportation","Gas","",$23.29,$0.00,-$4814.12
"Discover",,U,,12/28/2015,"Amazon","Personal : Gifts","Personal","Gifts","",$4.99,$0.00,-$4819.11
"Discover",,U,,12/28/2015,"speedway","Transportation : Gas","Transportation","Gas","",$17.95,$0.00,-$4837.06
"Discover",,U,,12/28/2015,"Price Chopper","Food : Groceries","Food","Groceries","",$123.05,$0.00,-$4960.11
"Discover",,U,,12/30/2015,"Amazon video","Recreation : Entertainment","Recreation","Entertainment","",$5.99,$0.00,-$4966.10
"Discover",,U,,12/30/2015,"AAII","Education : Investing","Education","Investing","",$29.00,$0.00,-$4995.10
"Discover",,U,,12/31/2015,"Amazon video","Recreation : Entertainment","Recreation","Entertainment","",$4.99,$0.00,-$5000.09
"Discover",,U,,12/31/2015,"linguines","Food : Restaurants","Food","Restaurants","",$38.79,$0.00,-$5038.88
"Discover",,U,,01/02/2016,"Paper Store","Personal : Gifts","Personal","Gifts","",$0.00,$14.99,-$5023.89
"Discover",,U,,01/02/2016,"stop & shop","Food : Groceries","Food","Groceries","",$32.20,$0.00,-$5056.09
"Discover",,U,,01/02/2016,"stop & shop","Food : Groceries","Food","Groceries","",$36.12,$0.00,-$5092.21
"Discover",,U,,01/03/2016,"Marshall's","Personal : cloths","Personal","cloths","",$6.91,$0.00,-$5099.12
"Discover",,U,,01/03/2016,"Amazon","Personal : Gifts","Personal","Gifts","",$7.61,$0.00,-$5106.73
"Discover",,U,,01/03/2016,"Amazon","Personal : Gifts","Personal","Gifts","",$7.96,$0.00,-$5114.69
"Discover",,U,,01/03/2016,"Amazon","Personal : Gifts","Personal","Gifts","",$10.89,$0.00,-$5125.58
"Discover",,U,,01/03/2016,"savers marlboro","Personal : cloths","Personal","cloths","",$11.66,$0.00,-$5137.24
"Discover",,U,,01/03/2016,"ben and Jerries","Food : Restaurants","Food","Restaurants","",$13.00,$0.00,-$5150.24
"Discover",,U,,01/03/2016,"Ocean State Joblot","Housing : Supplies","Hidden Categories","Housing ` Supplies","",$28.77,$0.00,-$5179.01
"Discover",,U,,01/03/2016,"Sears Roebuck","Personal : cloths","Personal","cloths","",$31.83,$0.00,-$5210.84
"Discover",,U,,01/04/2016,"Amazon","Personal : Gifts","Personal","Gifts","",$13.99,$0.00,-$5224.83
"Discover",,U,,01/04/2016,"Wayside inn","Food : Restaurants","Food","Restaurants","",$62.15,$0.00,-$5286.98
"Discover",,U,,01/05/2016,"shutter fly","Recreation : Entertainment","Recreation","Entertainment","",$8.14,$0.00,-$5295.12
"Discover",,U,,01/05/2016,"Aceituna Cafe","Food : Restaurants","Food","Restaurants","",$10.43,$0.00,-$5305.55
"Discover",,U,,01/05/2016,"Amazon","Personal : Gifts","Personal","Gifts","",$15.85,$0.00,-$5321.40
"Discover",,U,,01/05/2016,"chili basil","Food : Restaurants","Food","Restaurants","",$24.22,$0.00,-$5345.62
"Discover",,U,,01/05/2016,"Amazon","Personal : Gifts","Personal","Gifts","",$52.65,$0.00,-$5398.27
"Discover",,U,,01/05/2016,"hannaford","Food : Groceries","Food","Groceries","",$66.10,$0.00,-$5464.37
"Discover",,U,,01/06/2016,"Transfer : Dcu Checking",,,,"",$0.00,$4011.68,-$1452.69
"Discover",,U,,01/06/2016,"Cumberland Farms","Transportation : Gas","Transportation","Gas","",$16.82,$0.00,-$1469.51
"Discover",,U,,01/06/2016,"kelly's roastbeef","Food : Restaurants","Food","Restaurants","",$30.12,$0.00,-$1499.63
"Discover",,U,,01/06/2016,"masspike","Transportation : tolls","Transportation","tolls","",$49.45,$0.00,-$1549.08
"Discover",,U,,01/07/2016,"walgreens","Housing : Supplies","Hidden Categories","Housing ` Supplies","",$12.73,$0.00,-$1561.81
"Discover",,U,,01/07/2016,"Shell","Transportation : Gas","Transportation","Gas","",$24.75,$0.00,-$1586.56
"Discover",,U,,01/08/2016,"hannaford","Food : Groceries","Food","Groceries","",$46.87,$0.00,-$1633.43
"Discover",,U,,01/09/2016,"hannaford","Food : Groceries","Food","Groceries","",$29.61,$0.00,-$1663.04
"Discover",,U,,01/09/2016,"Bertucci","Food : Restaurants","Food","Restaurants","",$66.30,$0.00,-$1729.34
"Discover",,U,,01/10/2016,"Cumberland Farms","Transportation : Gas","Transportation","Gas","",$17.34,$0.00,-$1746.68
"Discover",,U,,01/10/2016,"Lowe's of Hudson","Housing : Maintenance & Repairs","Hidden Categories","Housing ` Maintenance & Repairs","",$19.97,$0.00,-$1766.65
"Discover",,U,,01/10/2016,"Roche Brothers","Food : Groceries","Food","Groceries","",$93.21,$0.00,-$1859.86
"Discover",,U,,01/10/2016,"trader Joes","Food : Groceries","Food","Groceries","",$109.53,$0.00,-$1969.39
"Discover",,U,,01/11/2016,"Casa Vllarta","Food : Restaurants","Food","Restaurants","",$147.64,$0.00,-$2117.03
"Discover",,U,,01/12/2016,"Amazon video","Recreation : Entertainment","Recreation","Entertainment","",$2.99,$0.00,-$2120.02
"Discover",,U,,01/12/2016,"Newbury Comics","Personal : Gifts","Personal","Gifts","",$14.86,$0.00,-$2134.88
"Discover",,U,,01/12/2016,"Metrowest oral surgeon","Personal : Doctor, Dentist","Personal","Doctor, Dentist","",$620.00,$0.00,-$2754.88
"Discover",,U,,01/13/2016,"speedway","Transportation : Gas","Transportation","Gas","",$23.43,$0.00,-$2778.31
"Discover",,U,,01/13/2016,"Special Olympics","Charity : Other","Charity","Other","",$50.00,$0.00,-$2828.31
"Discover",,U,,01/14/2016,"hannaford","Food : Groceries","Food","Groceries","",$38.51,$0.00,-$2866.82
"Discover",,U,,01/15/2016,"Cumberland Farms","Transportation : Gas","Transportation","Gas","",$13.93,$0.00,-$2880.75
"Discover",,U,,01/15/2016,"Good Sam","RV : MISC","RV","MISC","",$27.00,$0.00,-$2907.75
"Discover",,U,,01/15/2016,"Good Sam","RV : MISC","RV","MISC","",$109.95,$0.00,-$3017.70
"Discover",,U,,01/15/2016,"Soul of India Sudbury","Food : Restaurants","Food","Restaurants","",$110.02,$0.00,-$3127.72
"Discover",,U,,01/16/2016,"Smartpak Equine","Recreation : Alyssa Horse","Recreation","Alyssa Horse","",$271.90,$0.00,-$3399.62
"Discover",,U,,01/17/2016,"Planet Fitness","Recreation : His","Recreation","His","",$10.00,$0.00,-$3409.62
"Discover",,U,,01/17/2016,"Willimantic Brewing","Food : Restaurants","Food","Restaurants","",$112.40,$0.00,-$3522.02
"Discover",,U,,01/18/2016,"itunes","Recreation : Entertainment","Recreation","Entertainment","",$0.99,$0.00,-$3523.01
"Discover",,U,,01/18/2016,"Larry Ng","Transportation : Gas","Transportation","Gas","",$25.63,$0.00,-$3548.64
"Discover",,U,,01/19/2016,"hannaford","Food : Groceries","Food","Groceries","",$98.70,$0.00,-$3647.34
"Discover",,U,,01/20/2016,"Sears Roebuck","Personal : cloths","Personal","cloths","",$0.00,$10.62,-$3636.72
"Discover",,U,,01/20/2016,"netflix","Recreation : Entertainment","Recreation","Entertainment","",$16.48,$0.00,-$3653.20
"Discover",,U,,01/20/2016,"Shop at tower hill","Lisa Business : Cost of Goods Sold","Lisa Business","Cost of Goods Sold",,$19.13,$0.00,-$3672.33
"Discover",,U,,01/20/2016,"Amazon","Personal : Gifts","Personal","Gifts","",$260.00,$0.00,-$3932.33
"Discover",,U,,01/21/2016,"Bushel in","Food : Restaurants","Food","Restaurants","",$12.73,$0.00,-$3945.06
"Discover",,U,,01/21/2016,"Goodwill Worcestor","Personal : cloths","Personal","cloths","",$18.47,$0.00,-$3963.53
"Discover",,U,,01/22/2016,"gulf mart","Transportation : Gas","Transportation","Gas","",$15.32,$0.00,-$3978.85
"Discover",,U,,01/22/2016,"uno chicago grill","Food : Restaurants","Food","Restaurants","",$73.05,$0.00,-$4051.90
"Discover",,U,,01/23/2016,"Batteries Plus","Housing : Supplies","Hidden Categories","Housing ` Supplies","",$7.21,$0.00,-$4059.11
"Discover",,U,,01/23/2016,"Home Depot","Housing : Supplies","Hidden Categories","Housing ` Supplies","",$34.01,$0.00,-$4093.12
"Discover",,U,,01/24/2016,"Sunoco","Transportation : Gas","Transportation","Gas","",$23.43,$0.00,-$4116.55
"Discover",,U,,01/24/2016,"La tapatia","Food : Restaurants","Food","Restaurants","",$37.56,$0.00,-$4154.11
"Discover",,U,,01/24/2016,"Yama Zakura","Food : Restaurants","Food","Restaurants","",$110.82,$0.00,-$4264.93
"Discover",,U,,01/24/2016,"Jetblue","Recreation : Vacation","Recreation","Vacation","",$342.20,$0.00,-$4607.13
"Discover",,U,,01/26/2016,"Burger King","Food : Restaurants","Food","Restaurants","",$9.30,$0.00,-$4616.43
"Discover",,U,,01/26/2016,"Walmart","RV : Equipment/Supplies","RV","Equipment/Supplies","",$146.71,$0.00,-$4763.14
"Discover",,U,,01/27/2016,"Shell","Transportation : Gas","Transportation","Gas","",$23.64,$0.00,-$4786.78
"Discover",,U,,01/27/2016,"Lake magic","Recreation : Vacation","Recreation","Vacation","",$63.00,$0.00,-$4849.78
"Discover",,U,,01/28/2016,"subway","Food : Restaurants","Food","Restaurants","",$5.58,$0.00,-$4855.36
"Discover",,U,,01/28/2016,"Walmart","Housing : Supplies","Hidden Categories","Housing ` Supplies","",$49.28,$0.00,-$4904.64
"Discover",,U,,01/28/2016,"masspike","Transportation : tolls","Transportation","tolls","",$49.50,$0.00,-$4954.14
"Discover",,U,,01/28/2016,"jcpenney","Personal : cloths","Personal","cloths","",$100.00,$0.00,-$5054.14
"Discover",,U,,01/29/2016,"Cumberland Farms","Transportation : Gas","Transportation","Gas","",$3.48,$0.00,-$5057.62
"Discover",,U,,01/29/2016,"USPS","Housing : Supplies","Hidden Categories","Housing ` Supplies","",$9.80,$0.00,-$5067.42
"Discover",,U,,01/29/2016,"gulf mart","Transportation : Gas","Transportation","Gas","",$13.44,$0.00,-$5080.86
"Discover",,U,,01/29/2016,"Best Buy","Recreation : Alyssa","Recreation","Alyssa","",$31.89,$0.00,-$5112.75
"Discover",,U,,01/30/2016,"Marlboro fee","Housing : Real Estate Tax","Hidden Categories","Housing ` Real Estate Tax","",$38.69,$0.00,-$5151.44
"Discover",,U,,01/30/2016,"Amazon","Personal : Gifts","Personal","Gifts","",$42.13,$0.00,-$5193.57
"Discover",,U,,01/30/2016,"hannaford","Food : Groceries","Food","Groceries","",$82.54,$0.00,-$5276.11
"Discover",,U,,01/30/2016,"Intuit Turbo tax","Lisa Business : Business expenses","Lisa Business","Business expenses","",$106.24,$0.00,-$5382.35
"Discover",,U,,01/30/2016,"city of marlboro","Housing : Real Estate Tax","Hidden Categories","Housing ` Real Estate Tax","",$1224.61,$0.00,-$6606.96
"Discover",,U,,01/31/2016,"Sears Roebuck","Personal : cloths","Personal","cloths",,$13.98,$0.00,-$6620.94
"Discover",,U,,01/31/2016,"Juniors Pizza","Food : Restaurants","Food","Restaurants","",$18.73,$0.00,-$6639.67
"Discover",,U,,01/31/2016,"speedway","RV : gasoline","RV","gasoline","",$47.07,$0.00,-$6686.74
"Discover",,U,,02/01/2016,"Walmart","Recreation : Vacation","Recreation","Vacation","",$27.31,$0.00,-$6714.05
"Discover",,U,,02/01/2016,"Shell","RV : gasoline","RV","gasoline","",$45.90,$0.00,-$6759.95
"Discover",,U,,02/01/2016,"Loves country store","RV : gasoline","RV","gasoline","",$55.00,$0.00,-$6814.95
"Discover",,U,,02/02/2016,"Tennessee Aquarium","Recreation : Vacation","Recreation","Vacation","",$29.95,$0.00,-$6844.90
"Discover",,U,,02/02/2016,"Tennessee Aquarium","Recreation : Vacation","Recreation","Vacation","",$29.95,$0.00,-$6874.85
"Discover",,U,,02/02/2016,"raccoon MTN Caverns Chattanooga","Recreation : Vacation","Recreation","Vacation","",$37.36,$0.00,-$6912.21
"Discover",,U,,02/02/2016,"circle k","RV : gasoline","RV","gasoline","",$37.53,$0.00,-$6949.74
"Discover",,U,,02/02/2016,"Big River Chattanooga","Recreation : Vacation","Recreation","Vacation","",$42.22,$0.00,-$6991.96
"Discover",,U,,02/02/2016,"Walmart","Recreation : Vacation","Recreation","Vacation","",$49.18,$0.00,-$7041.14
"Discover",,U,,02/03/2016,"AMAZON KINDLE","Recreation : His","Recreation","His","",$22.85,$0.00,-$7063.99
"Discover",,U,,02/03/2016,"raccoon MTN Caverns Chattanooga","Recreation : Vacation","Recreation","Vacation","",$39.33,$0.00,-$7103.32
"Discover",,U,,02/03/2016,"212 Market Chattanooga","Recreation : Vacation","Recreation","Vacation","",$74.82,$0.00,-$7178.14
"Discover",,U,,02/04/2016,"Shell","RV : gasoline","RV","gasoline","",$40.58,$0.00,-$7218.72
"Discover",,U,,02/04/2016,"Walmart","Recreation : Vacation","Recreation","Vacation","",$44.98,$0.00,-$7263.70
"Discover",,U,,02/04/2016,"PR Fuels","RV : gasoline","RV","gasoline","",$52.88,$0.00,-$7316.58
"Discover",,U,,02/05/2016,"Pilot","Recreation : Vacation","Recreation","Vacation","",$2.05,$0.00,-$7318.63
"Discover",,U,,02/05/2016,"Walmart","RV : gasoline","RV","gasoline","",$25.61,$0.00,-$7344.24
"Discover",,U,,02/05/2016,"walmart victoria","Recreation : Vacation","Recreation","Vacation","",$36.22,$0.00,-$7380.46
"Discover",,U,,02/05/2016,"Cheveron","RV : gasoline","RV","gasoline","",$46.62,$0.00,-$7427.08
"Discover",,U,,02/05/2016,"Baytown Seaffod","Recreation : Vacation","Recreation","Vacation","",$58.71,$0.00,-$7485.79
"Discover",,U,,02/06/2016,"Transfer : Dcu Checking",,,,"",$0.00,$2740.02,-$4745.77
"Discover",,U,,02/06/2016,"Valley Travelland","RV : Equipment/Supplies","RV","Equipment/Supplies","",$23.27,$0.00,-$4769.04
"Discover",,U,,02/06/2016,"Break time","RV : gasoline","RV","gasoline","",$52.13,$0.00,-$4821.17
"Discover",,U,,02/07/2016,"Stan Winston School","Education : College","Education","College","",$215.40,$0.00,-$5036.57
"Discover",,U,,02/09/2016,"SW Air Dallas","Personal : Miscellaneous","Personal","Miscellaneous","",$251.98,$0.00,-$5288.55
"Discover",,U,,02/09/2016,"SW Air Dallas","Personal : Miscellaneous","Personal","Miscellaneous","",$251.98,$0.00,-$5540.53
"Discover",,U,,02/09/2016,"SW Air Dallas","Personal : Miscellaneous","Personal","Miscellaneous","",$251.98,$0.00,-$5792.51
"Discover",,U,,02/10/2016,"True value hardware","RV : Equipment/Supplies","RV","Equipment/Supplies","",$3.83,$0.00,-$5796.34
"Discover",,U,,02/11/2016,"Plantation Food","Recreation : Vacation","Recreation","Vacation","",$5.63,$0.00,-$5801.97
"Discover",,U,,02/11/2016,"Stripes","Recreation : Vacation","Recreation","Vacation","",$9.04,$0.00,-$5811.01
"Discover",,U,,02/11/2016,"Knights airport limo","Recreation : Vacation","Recreation","Vacation","",$86.00,$0.00,-$5897.01
"Discover",,U,,02/11/2016,"Enterprice care rental","Personal : Miscellaneous","Personal","Miscellaneous","",$106.24,$0.00,-$6003.25
"Discover",,U,,02/12/2016,"Faulkner Cafe","Food : Restaurants","Food","Restaurants","",$6.65,$0.00,-$6009.90
"Discover",,U,,02/12/2016,"Faulkner parking","Transportation : Parking","Transportation","Parking","",$9.00,$0.00,-$6018.90
"Discover",,U,,02/12/2016,"Cumberland Farms","Transportation : Gas","Transportation","Gas","",$14.37,$0.00,-$6033.27
"Discover",,U,,02/12/2016,"Barnes and Noble","Personal : Gifts","Personal","Gifts","",$16.99,$0.00,-$6050.26
"Discover",,U,,02/12/2016,"speedway","Transportation : Gas","Transportation","Gas","",$20.85,$0.00,-$6071.11
"Discover",,U,,02/12/2016,"Smartpak Equine","Recreation : Alyssa Horse","Recreation","Alyssa Horse","",$38.17,$0.00,-$6109.28
"Discover",,U,,02/12/2016,"Pappadeux","Recreation : Vacation","Recreation","Vacation","",$77.00,$0.00,-$6186.28
"Discover",,U,,02/12/2016,"hannaford","Food : Groceries","Food","Groceries","",$81.20,$0.00,-$6267.48
"Discover",,U,,02/12/2016,"hannaford","Food : Groceries","Food","Groceries","",$127.02,$0.00,-$6394.50
"Discover",,U,,02/13/2016,"Amazon video","Recreation : Entertainment","Recreation","Entertainment",,$4.99,$0.00,-$6399.49
"Discover",,U,,02/13/2016,"Amazon","Personal : Gifts","Personal","Gifts","",$21.89,$0.00,-$6421.38
"Discover",,U,,02/17/2016,"Planet Fitness","Recreation : His","Recreation","His","",$10.00,$0.00,-$6431.38
"Discover",,U,,02/17/2016,"Wegmans","Food : Groceries","Food","Groceries","",$28.84,$0.00,-$6460.22
"Discover",,U,,02/18/2016,"itunes","Recreation : Entertainment","Recreation","Entertainment","",$0.99,$0.00,-$6461.21
"Discover",,U,,02/18/2016,"Sprinkles Icecream","Food : Restaurants","Food","Restaurants","",$8.03,$0.00,-$6469.24
"Discover",,U,,02/18/2016,"speedway","Transportation : Gas","Transportation","Gas","",$14.02,$0.00,-$6483.26
"Discover",,U,,02/18/2016,"Newbury Comics","Personal : Gifts","Personal","Gifts","",$16.23,$0.00,-$6499.49
"Discover",,U,,02/18/2016,"Sprinkles Icecream","Food : Restaurants","Food","Restaurants","",$17.60,$0.00,-$6517.09
"Discover",,U,,02/18/2016,"speedway","Transportation : Gas","Transportation","Gas","",$19.43,$0.00,-$6536.52
"Discover",,U,,02/18/2016,"Smartpak Equine","Recreation : Alyssa Horse","Recreation","Alyssa Horse","",$27.96,$0.00,-$6564.48
"Discover",,U,,02/18/2016,"Dock Square Parking","Transportation : Parking","Transportation","Parking","",$36.00,$0.00,-$6600.48
"Discover",,U,,02/19/2016,"Market bskt","Food : Groceries","Food","Groceries","",$164.90,$0.00,-$6765.38
"Discover",,U,,02/19/2016,"A1 auto","Transportation : Repairs & Maintenance","Transportation","Repairs & Maintenance","",$447.43,$0.00,-$7212.81
"Discover",,U,,02/20/2016,"Popover lady","Food : Restaurants","Food","Restaurants","",$3.00,$0.00,-$7215.81
"Discover",,U,,02/20/2016,"Raos Coffee","Food : Restaurants","Food","Restaurants","",$5.97,$0.00,-$7221.78
"Discover",,U,,02/20/2016,"netflix","Recreation : Entertainment","Recreation","Entertainment","",$16.48,$0.00,-$7238.26
"Discover",,U,,02/20/2016,"IYA Sushi and Noodle S. Hadley","Food : Restaurants","Food","Restaurants",,$45.95,$0.00,-$7284.21
"Discover",,U,,02/21/2016,"Roche Brothers","Food : Groceries","Food","Groceries","",$23.56,$0.00,-$7307.77
"Discover",,U,,02/21/2016,"Roche Brothers","Food : Groceries","Food","Groceries","",$43.51,$0.00,-$7351.28
"Discover",,U,,02/22/2016,"Cumberland Farms","Transportation : Gas","Transportation","Gas","",$22.92,$0.00,-$7374.20
"Discover",,U,,02/23/2016,"Bonhoeffers Nashua NH","business (bob) : Real Estate","Hidden Categories","business (bob) ` Real Estate","",$18.40,$0.00,-$7392.60
"Discover",,U,,02/23/2016,"Jetblue","Recreation : Vacation","Recreation","Vacation","",$83.10,$0.00,-$7475.70
"Discover",,U,,02/23/2016,"Jetblue","Recreation : Vacation","Recreation","Vacation","",$83.10,$0.00,-$7558.80
"Discover",,U,,02/23/2016,"Jetlue airways","Recreation : Vacation","Recreation","Vacation","",$83.10,$0.00,-$7641.90
"Discover",,U,,02/24/2016,"tatnuck Book Sellers","Recreation : Entertainment","Recreation","Entertainment","",$13.80,$0.00,-$7655.70
"Discover",,U,,02/24/2016,"Apple Store","Housing : Phone & Internet","Hidden Categories","Housing ` Phone & Internet","",$30.81,$0.00,-$7686.51
"Discover",,U,,02/25/2016,"hannaford","Food : Groceries","Food","Groceries","",$49.92,$0.00,-$7736.43
"Discover",,U,,02/26/2016,"Hudson fuel","Transportation : Gas","Transportation","Gas","",$12.38,$0.00,-$7748.81
"Discover",,U,,02/26/2016,"walgreens","Housing : Supplies","Hidden Categories","Housing ` Supplies","",$15.33,$0.00,-$7764.14
"Discover",,U,,02/26/2016,"L B Wheatons Camera","Education : College","Education","College","",$24.65,$0.00,-$7788.79
"Discover",,U,,02/27/2016,"Shell","Transportation : Gas","Transportation","Gas","",$9.55,$0.00,-$7798.34
"Discover",,U,,02/27/2016,"linguines","Food : Restaurants","Food","Restaurants","",$35.04,$0.00,-$7833.38
"Discover",,U,,02/28/2016,"BP","Transportation : Gas","Transportation","Gas","",$17.64,$0.00,-$7851.02
"Discover",,U,,02/29/2016,"Panera Bread","Food : Restaurants","Food","Restaurants","",$22.64,$0.00,-$7873.66
"Discover",,U,,02/29/2016,"SICHUAN GOURMENT","Food : Restaurants","Food","Restaurants","",$141.47,$0.00,-$8015.13
"Discover",,U,,03/01/2016,"Stripes Harlingen","Transportation : Gas","Transportation","Gas","",$5.22,$0.00,-$8020.35
"Discover",,U,,03/01/2016,"potbelly","Food : Restaurants","Food","Restaurants","",$20.38,$0.00,-$8040.73
"Discover",,U,,03/01/2016,"Knights airport limo","Recreation : Vacation","Recreation","Vacation","",$86.00,$0.00,-$8126.73
"Discover",,U,,03/01/2016,"Hertz","Recreation : Vacation","Recreation","Vacation","",$103.67,$0.00,-$8230.40
"Discover",,U,,03/02/2016,"S Padre Island Birding","Recreation : Vacation","Recreation","Vacation","",$11.00,$0.00,-$8241.40
"Discover",,U,,03/03/2016,"HEB","Recreation : Vacation","Recreation","Vacation","",$17.23,$0.00,-$8258.63
"Discover",,U,,03/03/2016,"Longhorn Cattle","Food : Restaurants","Food","Restaurants","",$107.36,$0.00,-$8365.99
"Discover",,U,,03/04/2016,"bucees","Recreation : Vacation","Recreation","Vacation","",$31.31,$0.00,-$8397.30
"Discover",,U,,03/04/2016,"Amazon Prime","Recreation : Entertainment","Recreation","Entertainment","",$49.00,$0.00,-$8446.30
"Discover",,U,,03/04/2016,"Loves country store","RV : gasoline","RV","gasoline",,$49.93,$0.00,-$8496.23
"Discover",,U,,03/05/2016,"Willies Grill and Icehouse Houston","Recreation : Vacation","Recreation","Vacation","",$114.61,$0.00,-$8610.84
"Discover",,U,,03/06/2016,"Transfer : Dcu Checking",,,,"",$0.00,$5979.58,-$2631.26
"Discover",,U,,03/06/2016,"shutter fly","Recreation : Entertainment","Recreation","Entertainment","",$6.37,$0.00,-$2637.63
"Discover",,U,,03/06/2016,"Corner Store","Recreation : Vacation","Recreation","Vacation","",$10.19,$0.00,-$2647.82
"Discover",,U,,03/06/2016,"Cracker Barrel","Recreation : Vacation","Recreation","Vacation","",$25.09,$0.00,-$2672.91
"Discover",,U,,03/06/2016,"Corner Store","Recreation : Vacation","Recreation","Vacation","",$28.61,$0.00,-$2701.52
"Discover",,U,,03/06/2016,"Florida State Parks","Recreation : Vacation","Recreation","Vacation","",$73.60,$0.00,-$2775.12
"Discover",,U,,03/06/2016,"Pntchartran Landing New Orleans","Recreation : Vacation","Recreation","Vacation","",$122.18,$0.00,-$2897.30
"Discover",,U,,03/06/2016,"Walmart","Recreation : Vacation","Recreation","Vacation","",$160.64,$0.00,-$3057.94
"Discover",,U,,03/07/2016,"Walmart","Recreation : Vacation","Recreation","Vacation","",$3.25,$0.00,-$3061.19
"Discover",,U,,03/07/2016,"Pontchartrain","Recreation : Vacation","Recreation","Vacation","",$12.00,$0.00,-$3073.19
"Discover",,U,,03/07/2016,"Olde Nawlins Cookery","Recreation : Vacation","Recreation","Vacation","",$46.05,$0.00,-$3119.24
"Discover",,U,,03/07/2016,"racetrack","Recreation : Vacation","Recreation","Vacation","",$56.52,$0.00,-$3175.76
"Discover",,U,,03/08/2016,"Laura's Candies","Recreation : Vacation","Recreation","Vacation","",$6.49,$0.00,-$3182.25
"Discover",,U,,03/08/2016,"Fudery at french NO","Recreation : Vacation","Recreation","Vacation","",$10.88,$0.00,-$3193.13
"Discover",,U,,03/08/2016,"Pontchartrain","Recreation : Vacation","Recreation","Vacation","",$12.00,$0.00,-$3205.13
"Discover",,U,,03/08/2016,"toysrus","Recreation : Vacation","Recreation","Vacation","",$15.89,$0.00,-$3221.02
"Discover",,U,,03/08/2016,"toysrus","Recreation : Vacation","Recreation","Vacation","",$41.32,$0.00,-$3262.34
"Discover",,U,,03/08/2016,"801 Royal NO","Recreation : Vacation","Recreation","Vacation","",$68.35,$0.00,-$3330.69
"Discover",,U,,03/10/2016,"winn-dixie","Recreation : Vacation","Recreation","Vacation","",$27.88,$0.00,-$3358.57
"Discover",,U,,03/11/2016,"Labcorp","Personal : Doctor, Dentist","Personal","Doctor, Dentist","",$36.62,$0.00,-$3395.19
"Discover",,U,,03/11/2016,"Metrowest medical center","Personal : Doctor, Dentist","Personal","Doctor, Dentist","",$41.40,$0.00,-$3436.59
"Discover",,U,,03/11/2016,"Metrowest medical center","Personal : Doctor, Dentist","Personal","Doctor, Dentist",,$110.53,$0.00,-$3547.12
"Discover",,U,,03/12/2016,"Gulf Islands","Recreation : Vacation","Recreation","Vacation","",$15.00,$0.00,-$3562.12
"Discover",,U,,03/12/2016,"Usa foods","Recreation : Vacation","Recreation","Vacation","",$50.00,$0.00,-$3612.12
"Discover",,U,,03/12/2016,"winn-dixie","Recreation : Vacation","Recreation","Vacation","",$56.10,$0.00,-$3668.22
"Discover",,U,,03/12/2016,"Walmart","Recreation : Vacation","Recreation","Vacation","",$56.49,$0.00,-$3724.71
"Discover",,U,,03/12/2016,"Marathon","Recreation : Vacation","Recreation","Vacation","",$72.39,$0.00,-$3797.10
"Discover",,U,,03/13/2016,"LK Magic","Recreation : Vacation","Recreation","Vacation","",$401.00,$0.00,-$4198.10
"Discover",,U,,03/14/2016,"Trex Orlando","Recreation : Vacation","Recreation","Vacation","",$168.04,$0.00,-$4366.14
"Discover",,U,,03/15/2016,"7-eleven","Recreation : Vacation","Recreation","Vacation","",$19.94,$0.00,-$4386.08
"Discover",,U,,03/15/2016,"disney parking","Recreation : Vacation","Recreation","Vacation","",$20.00,$0.00,-$4406.08
"Discover",,U,,03/15/2016,"Three brooms","Recreation : Vacation","Recreation","Vacation","",$37.24,$0.00,-$4443.32
"Discover",,U,,03/15/2016,"cowfish","Food : Restaurants","Food","Restaurants","",$52.50,$0.00,-$4495.82
"Discover",,U,,03/15/2016,"disney","Recreation : Vacation","Recreation","Vacation","",$330.16,$0.00,-$4825.98
"Discover",,U,,03/15/2016,"Disney Epcot","Recreation : Vacation","Recreation","Vacation","",$349.32,$0.00,-$5175.30
"Discover",,U,,03/16/2016,"titw Ice cream","Recreation : Vacation","Recreation","Vacation","",$8.00,$0.00,-$5183.30
"Discover",,U,,03/16/2016,"tutto Italia","Recreation : Vacation","Recreation","Vacation","",$9.94,$0.00,-$5193.24
"Discover",,U,,03/16/2016,"Disney stuff","Recreation : Vacation","Recreation","Vacation","",$13.84,$0.00,-$5207.08
"Discover",,U,,03/16/2016,"Parking disney","Recreation : Vacation","Recreation","Vacation","",$20.00,$0.00,-$5227.08
"Discover",,U,,03/16/2016,"Lotus Blosson","Recreation : Vacation","Recreation","Vacation","",$32.00,$0.00,-$5259.08
"Discover",,U,,03/16/2016,"disney restaurant","Recreation : Vacation","Recreation","Vacation","",$34.01,$0.00,-$5293.09
"Discover",,U,,03/17/2016,"itunes","Recreation : Entertainment","Recreation","Entertainment","",$0.99,$0.00,-$5294.08
"Discover",,U,,03/17/2016,"Planet Fitness","Recreation : His","Recreation","His","",$10.00,$0.00,-$5304.08
"Discover",,U,,03/17/2016,"save a lot","Food : Groceries","Food","Groceries","",$14.40,$0.00,-$5318.48
"Discover",,U,,03/17/2016,"7-eleven","Recreation : Vacation","Recreation","Vacation","",$21.50,$0.00,-$5339.98
"Discover",,U,,03/17/2016,"winn-dixie","Recreation : Vacation","Recreation","Vacation","",$31.89,$0.00,-$5371.87
"Discover",,U,,03/17/2016,"Disney Guest Relations","Recreation : Vacation","Recreation","Vacation","",$80.94,$0.00,-$5452.81
"Discover",,U,,03/18/2016,"wet n wild","Recreation : Vacation","Recreation","Vacation","",$15.00,$0.00,-$5467.81
"Discover",,U,,03/18/2016,"italian Kitchen Riverview Fl","Recreation : Vacation","Recreation","Vacation","",$47.02,$0.00,-$5514.83
"Discover",,U,,03/18/2016,"Sr Tequila","Recreation : Vacation","Recreation","Vacation","",$72.62,$0.00,-$5587.45
"Discover",,U,,03/18/2016,"wet n wild","Recreation : Vacation","Recreation","Vacation","",$156.36,$0.00,-$5743.81
"Discover",,U,,03/19/2016,"Parking disney","Recreation : Vacation","Recreation","Vacation","",$4.00,$0.00,-$5747.81
"Discover",,U,,03/19/2016,"dunkin donuts","Recreation : Vacation","Recreation","Vacation","",$10.24,$0.00,-$5758.05
"Discover",,U,,03/19/2016,"Airport Orlando","Recreation : Vacation","Recreation","Vacation","",$10.60,$0.00,-$5768.65
"Discover",,U,,03/19/2016,"Parking disney","Recreation : Vacation","Recreation","Vacation","",$20.00,$0.00,-$5788.65
"Discover",,U,,03/19/2016,"disney","Recreation : Vacation","Recreation","Vacation","",$30.20,$0.00,-$5818.85
"Discover",,U,,03/19/2016,"Emporium Complex Disney","Recreation : Vacation","Recreation","Vacation","",$41.47,$0.00,-$5860.32
"Discover",,U,,03/19/2016,"carrabbas","Recreation : Vacation","Recreation","Vacation","",$66.54,$0.00,-$5926.86
"Discover",,U,,03/20/2016,"7-eleven","Recreation : Vacation","Recreation","Vacation","",$16.31,$0.00,-$5943.17
"Discover",,U,,03/20/2016,"netflix","Recreation : Entertainment","Recreation","Entertainment","",$16.48,$0.00,-$5959.65
"Discover",,U,,03/20/2016,"Walmart","Recreation : Vacation","Recreation","Vacation","",$40.36,$0.00,-$6000.01
"Discover",,U,,03/20/2016,"Walmart","Housing : Supplies","Hidden Categories","Housing ` Supplies","",$58.37,$0.00,-$6058.38
"Discover",,U,,03/21/2016,"wawa","Recreation : Vacation","Recreation","Vacation","",$8.06,$0.00,-$6066.44
"Discover",,U,,03/21/2016,"Goodson Farms","Recreation : Vacation","Recreation","Vacation","",$12.50,$0.00,-$6078.94
"Discover",,U,,03/21/2016,"Ross Store","Personal : cloths","Personal","cloths","",$21.39,$0.00,-$6100.33
"Discover",,U,,03/21/2016,"Cheveron","Recreation : Vacation","Recreation","Vacation","",$23.96,$0.00,-$6124.29
"Discover",,U,,03/21/2016,"Popis Place Rsukin Fl","Recreation : Vacation","Recreation","Vacation","",$38.58,$0.00,-$6162.87
"Discover",,U,,03/21/2016,"Dollar Rental","Recreation : Vacation","Recreation","Vacation","",$229.33,$0.00,-$6392.20
"Discover",,U,,03/23/2016,"redbox","Recreation : Entertainment","Recreation","Entertainment","",$1.60,$0.00,-$6393.80
"Discover",,U,,03/23/2016,"Raceway GA","Recreation : Vacation","Recreation","Vacation","",$45.32,$0.00,-$6439.12
"Discover",,U,,03/23/2016,"Marathon","Recreation : Vacation","Recreation","Vacation","",$61.66,$0.00,-$6500.78
"Discover",,U,,03/23/2016,"Walmart","Recreation : Vacation","Recreation","Vacation","",$88.78,$0.00,-$6589.56
"Discover",,U,,03/24/2016,"speedway","Recreation : Vacation","Recreation","Vacation","",$14.86,$0.00,-$6604.42
"Discover",,U,,03/24/2016,"Lake Aire RV Park SC","Recreation : Vacation","Recreation","Vacation","",$71.25,$0.00,-$6675.67
"Discover",,U,,03/25/2016,"Camden Garage Charleston","Recreation : Vacation","Recreation","Vacation","",$9.00,$0.00,-$6684.67
"Discover",,U,,03/25/2016,"Charleston Kitchen","Personal : Gifts","Personal","Gifts","",$33.07,$0.00,-$6717.74
"Discover",,U,,03/26/2016,"Food lion","Recreation : Vacation","Recreation","Vacation","",$16.86,$0.00,-$6734.60
"Discover",,U,,03/26/2016,"Brookgreen Gardens","Recreation : Vacation","Recreation","Vacation","",$32.00,$0.00,-$6766.60
"Discover",,U,,03/26/2016,"Myrtle Beach Koa","Recreation : Vacation","Recreation","Vacation","",$44.00,$0.00,-$6810.60
"Discover",,U,,03/26/2016,"Lowess Foods","Recreation : Vacation","Recreation","Vacation","",$44.06,$0.00,-$6854.66
"Discover",,U,,03/26/2016,"Hertz Car Rental","Recreation : Vacation","Recreation","Vacation","",$77.63,$0.00,-$6932.29
"Discover",,U,,03/26/2016,"Myrtle Beach Koa","Recreation : Vacation","Recreation","Vacation","",$103.84,$0.00,-$7036.13
"Discover",,U,,03/27/2016,"Villa Roma","Recreation : Vacation","Recreation","Vacation","",$83.00,$0.00,-$7119.13
"Discover",,U,,03/28/2016,"Brookgreen Gardens","Recreation : Vacation","Recreation","Vacation","",$47.00,$0.00,-$7166.13
"Discover",,U,,03/28/2016,"Drunken Jacks Myrtle beach","Recreation : Vacation","Recreation","Vacation","",$85.13,$0.00,-$7251.26
"Discover",,U,,03/29/2016,"Loves Travel Stops","Recreation : Vacation","Recreation","Vacation","",$28.04,$0.00,-$7279.30
"Discover",,U,,03/29/2016,"Marzonis Moosic PA","Recreation : Vacation","Recreation","Vacation","",$31.08,$0.00,-$7310.38
"Discover",,U,,03/29/2016,"speedway","Recreation : Vacation","Recreation","Vacation","",$60.75,$0.00,-$7371.13
"Discover",,U,,03/30/2016,"Sheetz","Recreation : Vacation","Recreation","Vacation","",$70.65,$0.00,-$7441.78
"Discover",,U,,04/01/2016,"bolton st gas","Transportation : Gas","Transportation","Gas","",$35.00,$0.00,-$7476.78
"Discover",,U,,04/01/2016,"masspike","Transportation : tolls","Transportation","tolls","",$48.33,$0.00,-$7525.11
"Discover",,U,,04/02/2016,"Amazon video","Recreation : Entertainment","Recreation","Entertainment",,$4.99,$0.00,-$7530.10
"Discover",,U,,04/02/2016,"Shell","Transportation : Gas","Transportation","Gas","",$26.15,$0.00,-$7556.25
"Discover",,U,,04/02/2016,"silk road bistro","Food : Restaurants","Food","Restaurants","",$104.10,$0.00,-$7660.35
"Discover",,U,,04/03/2016,"Intuit Turbo tax","Lisa Business : Business expenses","Lisa Business","Business expenses","",$24.99,$0.00,-$7685.34
"Discover",,U,,04/04/2016,"Price Chopper","Food : Groceries","Food","Groceries","",$103.84,$0.00,-$7789.18
"Discover",,U,,04/05/2016,"A.L. Prime","Transportation : Gas","Transportation","Gas","",$17.72,$0.00,-$7806.90
"Discover",,U,,04/06/2016,"Transfer : Dcu Checking",,,,"",$0.00,$3525.50,-$4281.40
"Discover",,U,,04/06/2016,"Tolls","Transportation : tolls","Transportation","tolls","",$6.50,$0.00,-$4287.90
"Discover",,U,,04/06/2016,"Intuit Turbo tax","Personal : Miscellaneous","Personal","Miscellaneous","",$24.99,$0.00,-$4312.89
"Discover",,U,,04/06/2016,"gulf mart","Transportation : Gas","Transportation","Gas","",$26.52,$0.00,-$4339.41
"Discover",,U,,04/07/2016,"reliant medicat","Personal : Doctor, Dentist","Personal","Doctor, Dentist","",$7.41,$0.00,-$4346.82
"Discover",,U,,04/08/2016,"Apple Store","business (bob) : Equipment","Hidden Categories","business (bob) ` Equipment","",$83.94,$0.00,-$4430.76
"Discover",,U,,04/09/2016,"Exxon mobile","Transportation : Gas","Transportation","Gas","",$17.15,$0.00,-$4447.91
"Discover",,U,,04/10/2016,"marlboro wine & spirits","Food : Groceries","Food","Groceries","",$35.18,$0.00,-$4483.09
"Discover",,U,,04/10/2016,"Price Chopper","Food : Groceries","Food","Groceries","",$180.48,$0.00,-$4663.57
"Discover",,U,,04/11/2016,"Marlboro dental","Personal : Doctor, Dentist","Personal","Doctor, Dentist","",$449.00,$0.00,-$5112.57
"Discover",,U,,04/13/2016,"Shell","Transportation : Gas","Transportation","Gas","",$19.60,$0.00,-$5132.17
"Discover",,U,,04/13/2016,"Shell","Transportation : Gas","Transportation","Gas","",$26.24,$0.00,-$5158.41
"Discover",,U,,04/14/2016,"hannaford","Food : Groceries","Food","Groceries","",$64.74,$0.00,-$5223.15
"Discover",,U,,04/15/2016,"linguines","Food : Restaurants","Food","Restaurants","",$30.31,$0.00,-$5253.46
"Discover",,U,,04/15/2016,"B&H Phote","Recreation : Alyssa","Recreation","Alyssa","",$57.94,$0.00,-$5311.40
"Discover",,U,,04/16/2016,"linguines","Food : Restaurants","Food","Restaurants","",$14.93,$0.00,-$5326.33
"Discover",,U,,04/17/2016,"Planet Fitness","Recreation : His","Recreation","His","",$10.00,$0.00,-$5336.33
"Discover",,U,,04/18/2016,"itunes","Recreation : Entertainment","Recreation","Entertainment","",$0.99,$0.00,-$5337.32
"Discover",,U,,04/19/2016,"subway","Food : Restaurants","Food","Restaurants","",$8.34,$0.00,-$5345.66
"Discover",,U,,04/19/2016,"Price Chopper","Food : Groceries","Food","Groceries","",$109.71,$0.00,-$5455.37
"Discover",,U,,04/20/2016,"netflix","Recreation : Entertainment","Recreation","Entertainment","",$16.48,$0.00,-$5471.85
"Discover",,U,,04/20/2016,"Sunoco","Transportation : Gas","Transportation","Gas","",$26.41,$0.00,-$5498.26
"Discover",,U,,04/20/2016,"pho sure","Food : Restaurants","Food","Restaurants","",$42.63,$0.00,-$5540.89
"Discover",,U,,04/20/2016,"masspike","Transportation : tolls","Transportation","tolls","",$48.20,$0.00,-$5589.09
"Discover",,U,,04/22/2016,"Shell","Transportation : Gas","Transportation","Gas","",$20.58,$0.00,-$5609.67
"Discover",,U,,04/22/2016,"Wegmans","Food : Groceries","Food","Groceries","",$35.41,$0.00,-$5645.08
"Discover",,U,,04/23/2016,"Cumberland Farms","Food : Restaurants","Food","Restaurants","",$3.24,$0.00,-$5648.32
"Discover",,U,,04/23/2016,"Hoyt Solomon pond mall","Recreation : Entertainment","Recreation","Entertainment","",$49.80,$0.00,-$5698.12
"Discover",,U,,04/23/2016,"hannaford","Food : Groceries","Food","Groceries","",$51.59,$0.00,-$5749.71
"Discover",,U,,04/25/2016,"itunes","Recreation : Entertainment","Recreation","Entertainment","",$3.18,$0.00,-$5752.89
"Discover",,U,,04/25/2016,"Honey Dew","Food : Groceries","Food","Groceries","",$5.55,$0.00,-$5758.44
"Discover",,U,,04/25/2016,"Saint Vincent","Personal : Doctor, Dentist","Personal","Doctor, Dentist","",$20.00,$0.00,-$5778.44
"Discover",,U,,04/25/2016,"Cumberland Farms","Transportation : Gas","Transportation","Gas","",$27.29,$0.00,-$5805.73
"Discover",,U,,04/25/2016,"sudbury farms","Food : Groceries","Food","Groceries","",$45.15,$0.00,-$5850.88
"Discover",,U,,04/25/2016,"D Jo AXE (RIP OFF ARTIST)","Personal : Miscellaneous","Personal","Miscellaneous","Dumb stuff",$147.00,$0.00,-$5997.88
"Discover",,U,,04/25/2016,"Birchlers Automotive","RV : Maintenance","RV","Maintenance","",$2107.24,$0.00,-$8105.12
"Discover",,U,,04/26/2016,"Basha","Food : Groceries","Food","Groceries","",$53.11,$0.00,-$8158.23
"Discover",,U,,04/26/2016,"stop & shop","Food : Groceries","Food","Groceries","",$59.47,$0.00,-$8217.70
"Discover",,U,,04/26/2016,"SW Air Dallas","Recreation : Vacation","Recreation","Vacation","",$306.96,$0.00,-$8524.66
"Discover",,U,,04/26/2016,"SW Air Dallas","Recreation : Vacation","Recreation","Vacation","",$306.96,$0.00,-$8831.62
"Discover",,U,,04/26/2016,"SW Air Dallas","Recreation : Vacation","Recreation","Vacation","",$306.96,$0.00,-$9138.58
"Discover",,U,,04/27/2016,"shaw's Market","Food : Groceries","Food","Groceries","",$10.34,$0.00,-$9148.92
"Discover",,U,,04/27/2016,"pho sure","Food : Restaurants","Food","Restaurants","",$40.00,$0.00,-$9188.92
"Discover",,U,,04/29/2016,"Shell","Transportation : Gas","Transportation","Gas","",$20.92,$0.00,-$9209.84
"Discover",,U,,04/29/2016,"shutter fly","Recreation : Entertainment","Recreation","Entertainment","",$34.01,$0.00,-$9243.85
"Discover",,U,,04/30/2016,"Peppertree","RV : MISC","RV","MISC","",$35.00,$0.00,-$9278.85
"Discover",,U,,04/30/2016,"Cumberland Farms","RV : gasoline","RV","gasoline","",$100.00,$0.00,-$9378.85
"Discover",,U,,04/30/2016,"travel guard","Recreation : Alyssa","Recreation","Alyssa","",$248.00,$0.00,-$9626.85
"Discover",,U,,05/01/2016,"Uconn","Education : College","Education","College","",$14.31,$0.00,-$9641.16
"Discover",,U,,05/01/2016,"Chucks Margarita Grill","Food : Restaurants","Food","Restaurants","",$65.06,$0.00,-$9706.22
"Discover",,U,,05/01/2016,"BookstoreUconn","Recreation : Entertainment","Recreation","Entertainment","",$80.17,$0.00,-$9786.39
"Discover",,U,,05/02/2016,"uconn Annual giving","Charity : Other","Charity","Other","",$50.00,$0.00,-$9836.39
"Discover",,U,,05/02/2016,"Market bskt","Food : Groceries","Food","Groceries","",$80.58,$0.00,-$9916.97
"Discover",,U,,05/02/2016,"Marlboro dental","Personal : Doctor, Dentist","Personal","Doctor, Dentist","",$280.00,$0.00,-$10196.97
"Discover",,U,,05/03/2016,"walgreens","Personal : Miscellaneous","Personal","Miscellaneous","Ear plugs for work",$17.52,$0.00,-$10214.49
"Discover",,U,,05/03/2016,"Sunoco","Transportation : Gas","Transportation","Gas","",$27.61,$0.00,-$10242.10
"Discover",,U,,05/05/2016,"Francos Trattoria Sudbury","Food : Restaurants","Food","Restaurants","",$8.02,$0.00,-$10250.12
"Discover",,U,,05/05/2016,"Metrowest medical center","Personal : Doctor, Dentist","Personal","Doctor, Dentist",,$10.49,$0.00,-$10260.61
"Discover",,U,,05/05/2016,"speedway","Transportation : Gas","Transportation","Gas","",$18.66,$0.00,-$10279.27
"Discover",,U,,05/05/2016,"Hillside restaurant","Food : Restaurants","Food","Restaurants","",$30.00,$0.00,-$10309.27
"Discover",,U,,05/06/2016,"Transfer : Dcu Checking",,,,"",$0.00,$5112.57,-$5196.70
"Discover",,U,,05/07/2016,"target","Food : Groceries","Food","Groceries","",$32.21,$0.00,-$5228.91
"Discover",,U,,05/07/2016,"Major League Roast beef","Food : Restaurants","Food","Restaurants","",$46.43,$0.00,-$5275.34
"Discover",,U,,05/08/2016,"Exxon mobile","Transportation : Gas","Transportation","Gas","",$29.34,$0.00,-$5304.68
"Discover",,U,,05/08/2016,"stop and shop","Food : Groceries","Food","Groceries","",$41.72,$0.00,-$5346.40
"Discover",,U,,05/08/2016,"masspike","Transportation : tolls","Transportation","tolls","",$45.60,$0.00,-$5392.00
"Discover",,U,,05/09/2016,"subway","Food : Restaurants","Food","Restaurants","",$10.58,$0.00,-$5402.58
"Discover",,U,,05/09/2016,"hannaford","Food : Groceries","Food","Groceries","",$68.69,$0.00,-$5471.27
"Discover",,U,,05/11/2016,"Chipotle","Food : Restaurants","Food","Restaurants","",$25.95,$0.00,-$5497.22
"Discover",,U,,05/12/2016,"dunkin donuts","Recreation : Vacation","Recreation","Vacation","",$10.34,$0.00,-$5507.56
"Discover",,U,,05/12/2016,"Exxon mobile","Transportation : Gas","Transportation","Gas","",$18.64,$0.00,-$5526.20
"Discover",,U,,05/12/2016,"pho sure","Food : Restaurants","Food","Restaurants","",$47.11,$0.00,-$5573.31
"Discover",,U,,05/14/2016,"dunkin donuts","Recreation : Vacation","Recreation","Vacation","",$4.06,$0.00,-$5577.37
"Discover",,U,,05/14/2016,"dunkin donuts","Recreation : Vacation","Recreation","Vacation","",$9.70,$0.00,-$5587.07
"Discover",,U,,05/14/2016,"hannaford","Food : Groceries","Food","Groceries","",$17.42,$0.00,-$5604.49
"Discover",,U,,05/14/2016,"Shell","Transportation : Gas","Transportation","Gas","",$29.40,$0.00,-$5633.89
"Discover",,U,,05/14/2016,"trader Joes","Food : Groceries","Food","Groceries","",$77.67,$0.00,-$5711.56
"Discover",,U,,05/16/2016,"USPS","Housing : Supplies","Hidden Categories","Housing ` Supplies","",$13.04,$0.00,-$5724.60
"Discover",,U,,05/16/2016,"hannaford","Food : Groceries","Food","Groceries","",$26.80,$0.00,-$5751.40
"Discover",,U,,05/17/2016,"Planet Fitness","Recreation : His","Recreation","His","",$10.00,$0.00,-$5761.40
"Discover",,U,,05/17/2016,"speedway","Transportation : Gas","Transportation","Gas","",$20.93,$0.00,-$5782.33
"Discover",,U,,05/17/2016,"Market bskt","Food : Groceries","Food","Groceries","",$78.13,$0.00,-$5860.46
"Discover",,U,,05/18/2016,"itunes","Recreation : Entertainment","Recreation","Entertainment","",$0.99,$0.00,-$5861.45
"Discover",,U,,05/18/2016,"sate grill","Food : Restaurants","Food","Restaurants","",$6.51,$0.00,-$5867.96
"Discover",,U,,05/18/2016,"Dinos Kouzina","Food : Restaurants","Food","Restaurants","",$8.48,$0.00,-$5876.44
"Discover",,U,,05/18/2016,"british Beer Company","Food : Restaurants","Food","Restaurants","",$79.00,$0.00,-$5955.44
"Discover",,U,,05/19/2016,"Gibbet Hill","Food : Restaurants","Food","Restaurants","",$21.00,$0.00,-$5976.44
"Discover",,U,,05/19/2016,"Shell","Transportation : Gas","Transportation","Gas","",$24.08,$0.00,-$6000.52
"Discover",,U,,05/20/2016,"netflix","Recreation : Entertainment","Recreation","Entertainment","",$16.48,$0.00,-$6017.00
"Discover",,U,,05/20/2016,"target","Food : Groceries","Food","Groceries","",$20.00,$0.00,-$6037.00
"Discover",,U,,05/20/2016,"Julio' Liquor","Personal : Gifts","Personal","Gifts","Greg Retirement",$130.60,$0.00,-$6167.60
"Discover",,U,,05/21/2016,"Pizza Post","Food : Restaurants","Food","Restaurants","",$37.13,$0.00,-$6204.73
"Discover",,U,,05/22/2016,"Shell","Transportation : Gas","Transportation","Gas","",$21.70,$0.00,-$6226.43
"Discover",,U,,05/22/2016,"Claiire's","Personal : cloths","Personal","cloths",,$30.81,$0.00,-$6257.24
"Discover",,U,,05/24/2016,"Gulf express","Transportation : Gas","Transportation","Gas","",$29.94,$0.00,-$6287.18
"Discover",,U,,05/25/2016,"dunkin donuts","Food : Restaurants","Food","Restaurants","",$5.65,$0.00,-$6292.83
"Discover",,U,,05/26/2016,"Kendal sq parking","Transportation : Parking","Transportation","Parking","",$8.00,$0.00,-$6300.83
"Discover",,U,,05/26/2016,"dunkin donuts","Food : Restaurants","Food","Restaurants","",$8.10,$0.00,-$6308.93
"Discover",,U,,05/26/2016,"speedway","Transportation : Gas","Transportation","Gas","",$19.33,$0.00,-$6328.26
"Discover",,U,,05/26/2016,"masspike","Transportation : tolls","Transportation","tolls","",$45.85,$0.00,-$6374.11
"Discover",,U,,05/26/2016,"cvs","Personal : Prescriptions, Medicine","Personal","Prescriptions, Medicine","",$47.74,$0.00,-$6421.85
"Discover",,U,,05/26/2016,"Evoo","Food : Restaurants","Food","Restaurants","",$117.37,$0.00,-$6539.22
"Discover",,U,,05/27/2016,"SMG","Personal : Doctor, Dentist","Personal","Doctor, Dentist","",$25.00,$0.00,-$6564.22
"Discover",,U,,05/28/2016,"Freash City Boston","Food : Restaurants","Food","Restaurants","",$7.67,$0.00,-$6571.89
"Discover",,U,,05/28/2016,"Houston Zoo","Food : Restaurants","Food","Restaurants","",$59.85,$0.00,-$6631.74
"Discover",,U,,05/28/2016,"Another Broken Egg","Recreation : Vacation","Recreation","Vacation","",$92.00,$0.00,-$6723.74
"Discover",,U,,05/29/2016,"vacation","Recreation : Vacation","Recreation","Vacation","",$3.75,$0.00,-$6727.49
"Discover",,U,,05/29/2016,"vacation","Recreation : Vacation","Recreation","Vacation","",$9.29,$0.00,-$6736.78
"Discover",,U,,05/29/2016,"gase vacation","Recreation : Vacation","Recreation","Vacation","",$11.03,$0.00,-$6747.81
"Discover",,U,,05/29/2016,"Willies Grill and Icehouse Houston","Recreation : Vacation","Recreation","Vacation","Willies",$15.00,$0.00,-$6762.81
"Discover",,U,,05/29/2016,"bucees","Recreation : Vacation","Recreation","Vacation","",$23.61,$0.00,-$6786.42
"Discover",,U,,05/30/2016,"San Antonio Cruises","Recreation : Vacation","Recreation","Vacation","",$20.00,$0.00,-$6806.42
"Discover",,U,,05/30/2016,"Madhatter Tea house","Recreation : Vacation","Recreation","Vacation","",$29.00,$0.00,-$6835.42
"Discover",,U,,05/30/2016,"Willies Grill and Icehouse Houston","Recreation : Vacation","Recreation","Vacation","",$46.57,$0.00,-$6881.99
"Discover",,U,,05/30/2016,"Casa Rios","Recreation : Vacation","Recreation","Vacation","",$75.41,$0.00,-$6957.40
"Discover",,U,,05/31/2016,"Barry's Pizza","Recreation : Vacation","Recreation","Vacation","",$10.77,$0.00,-$6968.17
"Discover",,U,,05/31/2016,"Barry's Pizza","Recreation : Vacation","Recreation","Vacation","",$14.49,$0.00,-$6982.66
"Discover",,U,,05/31/2016,"Hunans","Recreation : Vacation","Recreation","Vacation","",$19.08,$0.00,-$7001.74
"Discover",,U,,06/01/2016,"Honey Dew","Food : Restaurants","Food","Restaurants","",$5.55,$0.00,-$7007.29
"Discover",,U,,06/01/2016,"Beantown Tacquira","Recreation : Vacation","Recreation","Vacation","",$6.00,$0.00,-$7013.29
"Discover",,U,,06/01/2016,"Torhy's Tacos","Recreation : Vacation","Recreation","Vacation","",$41.95,$0.00,-$7055.24
"Discover",,U,,06/01/2016,"Logan Parking","Transportation : Parking","Transportation","Parking","",$80.00,$0.00,-$7135.24
"Discover",,U,,06/01/2016,"Price Chopper","Food : Groceries","Food","Groceries","",$114.89,$0.00,-$7250.13
"Discover",,U,,06/02/2016,"Southboro autotech","Transportation : Gas","Transportation","Gas","",$30.91,$0.00,-$7281.04
"Discover",,U,,06/02/2016,"Welly Restaurant","Food : Restaurants","Food","Restaurants","",$77.00,$0.00,-$7358.04
"Discover",,U,,06/03/2016,"Friendly icecream","Food : Restaurants","Food","Restaurants","",$10.12,$0.00,-$7368.16
"Discover",,U,,06/03/2016,"circle k","Transportation : Gas","Transportation","Gas","",$18.73,$0.00,-$7386.89
"Discover",,U,,06/04/2016,"Heritge Museums Sandwich","Recreation : Alyssa","Recreation","Alyssa","",$36.00,$0.00,-$7422.89
"Discover",,U,,06/04/2016,"Marshside","Food : Restaurants","Food","Restaurants","",$136.03,$0.00,-$7558.92
"Discover",,U,,06/06/2016,"subway","Food : Restaurants","Food","Restaurants","",$10.58,$0.00,-$7569.50
"Discover",,U,,06/07/2016,"Transfer : Dcu Checking",,,,"",$0.00,$5507.56,-$2061.94
"Discover",,U,,06/07/2016,"Marshall's","Personal : cloths","Personal","cloths","",$7.43,$0.00,-$2069.37
"Discover",,U,,06/07/2016,"Exxon mobile","Transportation : Gas","Transportation","Gas","",$19.26,$0.00,-$2088.63
"Discover",,U,,06/07/2016,"Micheals","Recreation : His","Recreation","His","",$22.96,$0.00,-$2111.59
"Discover",,U,,06/07/2016,"Ocean State Joblot","Housing : Supplies","Hidden Categories","Housing ` Supplies","",$33.09,$0.00,-$2144.68
"Discover",,U,,06/07/2016,"savers marlboro","Personal : cloths","Personal","cloths","",$46.93,$0.00,-$2191.61
"Discover",,U,,06/08/2016,"naxiha","Transportation : Gas","Transportation","Gas","",$30.56,$0.00,-$2222.17
"Discover",,U,,06/08/2016,"Kindles","Food : Restaurants","Food","Restaurants","",$33.10,$0.00,-$2255.27
"Discover",,U,,06/11/2016,"Market bskt","Food : Groceries","Food","Groceries","",$168.45,$0.00,-$2423.72
"Discover",,U,,06/12/2016,"Kays","Food : Restaurants","Food","Restaurants","",$84.80,$0.00,-$2508.52
"Discover",,U,,06/14/2016,"masspike","Transportation : tolls","Transportation","tolls","",$45.40,$0.00,-$2553.92
"Discover",,U,,06/15/2016,"shutter fly","Recreation : Entertainment","Recreation","Entertainment","",$8.15,$0.00,-$2562.07
"Discover",,U,,06/15/2016,"shoe dpt encore","Personal : cloths","Personal","cloths","",$25.00,$0.00,-$2587.07
"Discover",,U,,06/15/2016,"Shell","Transportation : Gas","Transportation","Gas","",$30.27,$0.00,-$2617.34
"Discover",,U,,06/16/2016,"Horse shoe pub","Food : Restaurants","Food","Restaurants","",$42.00,$0.00,-$2659.34
"Discover",,U,,06/17/2016,"Planet Fitness","Recreation : His","Recreation","His","",$10.00,$0.00,-$2669.34
"Discover",,U,,06/17/2016,"Yama Zakura","Food : Restaurants","Food","Restaurants","",$92.84,$0.00,-$2762.18
"Discover",,U,,06/18/2016,"itunes","Recreation : Entertainment","Recreation","Entertainment","",$0.99,$0.00,-$2763.17
"Discover",,U,,06/18/2016,"stop & shop","Food : Groceries","Food","Groceries","",$8.99,$0.00,-$2772.16
"Discover",,U,,06/18/2016,"cvs","Personal : Prescriptions, Medicine","Personal","Prescriptions, Medicine","",$11.04,$0.00,-$2783.20
"Discover",,U,,06/18/2016,"speedway","Transportation : Gas","Transportation","Gas","",$18.76,$0.00,-$2801.96
"Discover",,U,,06/20/2016,"subway","Food : Restaurants","Food","Restaurants","",$10.80,$0.00,-$2812.76
"Discover",,U,,06/20/2016,"netflix","Recreation : Entertainment","Recreation","Entertainment","",$16.48,$0.00,-$2829.24
"Discover",,U,,06/21/2016,"A1 auto","Transportation : Repairs & Maintenance","Transportation","Repairs & Maintenance","",$35.35,$0.00,-$2864.59
"Discover",,U,,06/22/2016,"ms society","Charity : Other","Charity","Other","",$25.00,$0.00,-$2889.59
"Discover",,U,,06/23/2016,"Metrowest medical center","Personal : Doctor, Dentist","Personal","Doctor, Dentist",,$10.49,$0.00,-$2900.08
"Discover",,U,,06/23/2016,"Metrowest medical center","Personal : Doctor, Dentist","Personal","Doctor, Dentist","",$10.49,$0.00,-$2910.57
"Discover",,U,,06/23/2016,"reliant medicat","Personal : Doctor, Dentist","Personal","Doctor, Dentist","",$14.82,$0.00,-$2925.39
"Discover",,U,,06/23/2016,"Metrowest medical center","Personal : Doctor, Dentist","Personal","Doctor, Dentist","",$17.92,$0.00,-$2943.31
"Discover",,U,,06/23/2016,"Shell","Transportation : Gas","Transportation","Gas","",$32.36,$0.00,-$2975.67
"Discover",,U,,06/23/2016,"funky Murphys","Food : Restaurants","Food","Restaurants","",$58.02,$0.00,-$3033.69
"Discover",,U,,06/24/2016,"D Jo AXE (RIP OFF ARTIST)","Personal : Miscellaneous","Personal","Miscellaneous",,$0.00,$147.00,-$2886.69
"Discover",,U,,06/24/2016,"USPS","Housing : Supplies","Hidden Categories","Housing ` Supplies","",$1.57,$0.00,-$2888.26
"Discover",,U,,06/24/2016,"Market bskt","Food : Groceries","Food","Groceries","",$125.19,$0.00,-$3013.45
"Discover",,U,,06/25/2016,"sperry liquor","Food : Groceries","Food","Groceries","",$7.29,$0.00,-$3020.74
"Discover",,U,,06/25/2016,"Shell","Transportation : Gas","Transportation","Gas","",$21.27,$0.00,-$3042.01
"Discover",,U,,06/26/2016,"Amazon video","Recreation : Entertainment","Recreation","Entertainment",,$5.99,$0.00,-$3048.00
"Discover",,U,,06/26/2016,"Simaptico","Food : Restaurants","Food","Restaurants","",$88.25,$0.00,-$3136.25
"Discover",,U,,06/26/2016,"linguines","Food : Restaurants","Food","Restaurants","",$93.00,$0.00,-$3229.25
"Discover",,U,,07/01/2016,"new city ice cream","Food : Restaurants","Food","Restaurants","",$13.50,$0.00,-$3242.75
"Discover",,U,,07/01/2016,"Verril Farm","Food : Groceries","Food","Groceries","",$15.75,$0.00,-$3258.50
"Discover",,U,,07/01/2016,"Shell","Transportation : Gas","Transportation","Gas","",$27.48,$0.00,-$3285.98
"Discover",,U,,07/01/2016,"Market bskt","Food : Groceries","Food","Groceries","",$126.79,$0.00,-$3412.77
"Discover",,U,,07/02/2016,"Amazon video","Recreation : Entertainment","Recreation","Entertainment",,$5.99,$0.00,-$3418.76
"Discover",,U,,07/03/2016,"Castaway gourment Bristol","Food : Restaurants","Food","Restaurants","",$23.00,$0.00,-$3441.76
"Discover",,U,,07/05/2016,"Evoo","Food : Restaurants","Food","Restaurants","",$52.41,$0.00,-$3494.17
"Discover",,U,,07/06/2016,"speedway","Transportation : Gas","Transportation","Gas","",$20.73,$0.00,-$3514.90
"Discover",,U,,07/06/2016,"Shell","Transportation : Gas","Transportation","Gas","",$31.22,$0.00,-$3546.12
"Discover",,U,,07/06/2016,"hannaford","Food : Groceries","Food","Groceries","",$135.61,$0.00,-$3681.73
"Discover",,U,,07/07/2016,"Transfer : Dcu Checking",,,,"",$0.00,$2423.72,-$1258.01
"Discover",,U,,07/07/2016,"mother dirt","Personal : Prescriptions, Medicine","Personal","Prescriptions, Medicine","",$31.24,$0.00,-$1289.25
"Discover",,U,,07/07/2016,"hannaford","Food : Groceries","Food","Groceries","",$34.51,$0.00,-$1323.76
"Discover",,U,,07/07/2016,"masspike","Transportation : tolls","Transportation","tolls","",$47.40,$0.00,-$1371.16
"Discover",,U,,07/10/2016,"Amazon video","Recreation : Entertainment","Recreation","Entertainment",,$0.99,$0.00,-$1372.15
"Discover",,U,,07/11/2016,"Amazon","Recreation : Alyssa","Recreation","Alyssa","",$4.12,$0.00,-$1376.27
"Discover",,U,,07/11/2016,"Amazon","Recreation : Alyssa","Recreation","Alyssa","",$16.49,$0.00,-$1392.76
"Discover",,U,,07/11/2016,"Amazon","Recreation : Alyssa","Recreation","Alyssa","",$29.92,$0.00,-$1422.68
"Discover",,U,,07/11/2016,"Amazon","Recreation : Hers","Recreation","Hers","",$36.98,$0.00,-$1459.66
"Discover",,U,,07/12/2016,"Amazon","Recreation : Hers","Recreation","Hers","",$5.00,$0.00,-$1464.66
"Discover",,U,,07/12/2016,"sudbury farms","Food : Groceries","Food","Groceries","",$11.67,$0.00,-$1476.33
"Discover",,U,,07/12/2016,"trader Joes","Food : Groceries","Food","Groceries","",$22.05,$0.00,-$1498.38
"Discover",,U,,07/12/2016,"shoe dpt encore","Personal : cloths","Personal","cloths","",$54.98,$0.00,-$1553.36
"Discover",,U,,07/13/2016,"dunkin donuts","Food : Restaurants","Food","Restaurants","",$6.18,$0.00,-$1559.54
"Discover",,U,,07/13/2016,"Best Buy","Housing : Supplies","Hidden Categories","Housing ` Supplies","",$13.80,$0.00,-$1573.34
"Discover",,U,,07/13/2016,"speedway","Transportation : Gas","Transportation","Gas","",$19.12,$0.00,-$1592.46
"Discover",,U,,07/13/2016,"Multiple Melomoma","Charity : Other","Charity","Other","Kristen TRY",$50.00,$0.00,-$1642.46
"Discover",,U,,07/13/2016,"hudson house","Food : Restaurants","Food","Restaurants","",$50.30,$0.00,-$1692.76
"Discover",,U,,07/14/2016,"WESTFORD DERMERTOLOGY","Personal : Doctor, Dentist","Personal","Doctor, Dentist","",$35.00,$0.00,-$1727.76
"Discover",,U,,07/15/2016,"Best Buy","Housing : Supplies","Hidden Categories","Housing ` Supplies","",$27.21,$0.00,-$1754.97
"Discover",,U,,07/15/2016,"Shell","Transportation : Gas","Transportation","Gas","",$30.08,$0.00,-$1785.05
"Discover",,U,,07/15/2016,"Dsw","Personal : cloths","Personal","cloths","",$34.96,$0.00,-$1820.01
"Discover",,U,,07/16/2016,"rite aid","Personal : Prescriptions, Medicine","Personal","Prescriptions, Medicine","",$9.86,$0.00,-$1829.87
"Discover",,U,,07/16/2016,"peterson market dennis","Food : Groceries","Food","Groceries","",$14.96,$0.00,-$1844.83
"Discover",,U,,07/16/2016,"sq agway","Housing : Garden","Hidden Categories","Housing ` Garden","",$28.00,$0.00,-$1872.83
"Discover",,U,,07/17/2016,"Price Chopper","Food : Groceries","Food","Groceries",,$61.63,$0.00,-$1934.46
"Discover",,U,,07/18/2016,"itunes","Recreation : Entertainment","Recreation","Entertainment","",$0.99,$0.00,-$1935.45
"Discover",,U,,07/18/2016,"hannaford","Food : Groceries","Food","Groceries","",$3.19,$0.00,-$1938.64
"Discover",,U,,07/18/2016,"sudbury farms","Food : Groceries","Food","Groceries","",$18.46,$0.00,-$1957.10
"Discover",,U,,07/20/2016,"corner grill","Food : Restaurants","Food","Restaurants","",$16.04,$0.00,-$1973.14
"Discover",,U,,07/20/2016,"netflix","Recreation : Entertainment","Recreation","Entertainment","",$16.48,$0.00,-$1989.62
"Discover",,U,,07/20/2016,"Strand theatre","Recreation : Entertainment","Recreation","Entertainment","",$16.50,$0.00,-$2006.12
"Discover",,U,,07/20/2016,"Shell","Transportation : Gas","Transportation","Gas","",$24.61,$0.00,-$2030.73
"Discover",,U,,07/20/2016,"Strand theatre","Food : Restaurants","Food","Restaurants","",$36.34,$0.00,-$2067.07
"Discover",,U,,07/21/2016,"Shell","Transportation : Gas","Transportation","Gas","",$19.01,$0.00,-$2086.08
"Discover",,U,,07/21/2016,"Market bskt","Food : Groceries","Food","Groceries","",$71.77,$0.00,-$2157.85
"Discover",,U,,07/22/2016,"tidewater campground","Recreation : Vacation","Recreation","Vacation","",$111.00,$0.00,-$2268.85
"Discover",,U,,07/23/2016,"hannaford","Food : Groceries","Food","Groceries","",$13.66,$0.00,-$2282.51
"Discover",,U,,07/23/2016,"lupwa 55","Food : Restaurants","Food","Restaurants","",$42.44,$0.00,-$2324.95
"Discover",,U,,07/25/2016,"sudbury farms","Food : Groceries","Food","Groceries","",$16.26,$0.00,-$2341.21
"Discover",,U,,07/25/2016,"Amazon","Recreation : Alyssa","Recreation","Alyssa","",$35.69,$0.00,-$2376.90
"Discover",,U,,07/26/2016,"hannaford","Food : Groceries","Food","Groceries","",$23.27,$0.00,-$2400.17
"Discover",,U,,07/26/2016,"Shell","Transportation : Gas","Transportation","Gas","",$28.29,$0.00,-$2428.46
"Discover",,U,,07/26/2016,"pho dakao","Food : Restaurants","Food","Restaurants","",$35.37,$0.00,-$2463.83
"Discover",,U,,07/27/2016,"educational invovations","Personal : Miscellaneous","Personal","Miscellaneous","Lisa garden club will be reimbursed",$147.50,$0.00,-$2611.33
"Discover",,U,,07/29/2016,"shutter fly","Recreation : Entertainment","Recreation","Entertainment","",$13.99,$0.00,-$2625.32
"Discover",,U,,07/29/2016,"Shell","Transportation : Gas","Transportation","Gas","",$19.10,$0.00,-$2644.42
"Discover",,U,,07/29/2016,"masspike","Transportation : tolls","Transportation","tolls","",$46.60,$0.00,-$2691.02
"Discover",,U,,07/29/2016,"Kindles Pizza","Food : Restaurants","Food","Restaurants","",$77.84,$0.00,-$2768.86
"Discover",,U,,07/30/2016,"Market bskt","Food : Groceries","Food","Groceries","",$31.53,$0.00,-$2800.39
"Discover",,U,,07/31/2016,"Seats pf gloucester","Personal : cloths","Personal","cloths","",$14.99,$0.00,-$2815.38
"Discover",,U,,08/02/2016,"Dsw","Personal : cloths","Personal","cloths","",$0.00,$34.96,-$2780.42
"Discover",,U,,08/02/2016,"Exxon mobile","Transportation : Gas","Transportation","Gas","",$30.79,$0.00,-$2811.21
"Discover",,U,,08/03/2016,"dunkin donuts","Food : Restaurants","Food","Restaurants","",$5.65,$0.00,-$2816.86
"Discover",,U,,08/03/2016,"Chez siam","Food : Restaurants","Food","Restaurants","",$40.00,$0.00,-$2856.86
"Discover",,U,,08/05/2016,"mobile","Transportation : Gas","Transportation","Gas","",$29.21,$0.00,-$2886.07
"Discover",,U,,08/06/2016,"hanaford","Food : Groceries","Food","Groceries","",$17.03,$0.00,-$2903.10
"Discover",,U,,08/06/2016,"shake shack","Food : Restaurants","Food","Restaurants","",$19.67,$0.00,-$2922.77
"Discover",,U,,08/06/2016,"MMA Admissions","Recreation : Entertainment","Recreation","Entertainment","",$30.00,$0.00,-$2952.77
"Discover",,U,,08/06/2016,"hannaford","Food : Groceries","Food","Groceries","",$32.26,$0.00,-$2985.03
"Discover",,U,,08/06/2016,"cafe frida","Food : Restaurants","Food","Restaurants","",$114.19,$0.00,-$3099.22
"Discover",,U,,08/06/2016,"Hotel Belleclaire","Recreation : Vacation","Recreation","Vacation","",$315.62,$0.00,-$3414.84
"Discover",,U,,08/07/2016,"Daisy pughil","Personal : Miscellaneous","Personal","Miscellaneous","",$13.42,$0.00,-$3428.26
"Discover",,U,,08/07/2016,"salem witch museam","Recreation : Entertainment","Recreation","Entertainment","",$44.00,$0.00,-$3472.26
"Discover",,U,,08/07/2016,"turner's seafood","Food : Restaurants","Food","Restaurants","",$136.63,$0.00,-$3608.89
"Discover",,U,,08/08/2016,"Transfer : Dcu Checking",,,,"",$0.00,$1464.66,-$2144.23
"Discover",,U,,08/08/2016,"Cumberland Farms","Transportation : Gas","Transportation","Gas","",$17.90,$0.00,-$2162.13
"Discover",,U,,08/08/2016,"sudbury farms","Food : Groceries","Food","Groceries","",$60.67,$0.00,-$2222.80
"Discover",,U,,08/08/2016,"hanaford","Food : Groceries","Food","Groceries","",$67.39,$0.00,-$2290.19
"Discover",,U,,08/09/2016,"Shell","Transportation : Gas","Transportation","Gas","",$27.65,$0.00,-$2317.84
"Discover",,U,,08/09/2016,"hannaford","Food : Groceries","Food","Groceries","",$54.13,$0.00,-$2371.97
"Discover",,U,,08/11/2016,"Cumberland Farms","Transportation : Gas","Transportation","Gas","",$20.47,$0.00,-$2392.44
"Discover",,U,,08/12/2016,"target","Food : Groceries","Food","Groceries","",$22.83,$0.00,-$2415.27
"Discover",,U,,08/13/2016,"hannaford","Food : Groceries","Food","Groceries","",$24.22,$0.00,-$2439.49
"Discover",,U,,08/13/2016,"Kindles","Food : Restaurants","Food","Restaurants","",$46.84,$0.00,-$2486.33
"Discover",,U,,08/15/2016,"consumer reports","Recreation : Entertainment","Recreation","Entertainment","",$30.00,$0.00,-$2516.33
"Discover",,U,,08/15/2016,"Marlboro dental","Personal : Doctor, Dentist","Personal","Doctor, Dentist","",$149.00,$0.00,-$2665.33
"Discover",,U,,08/15/2016,"Marlboro dental","Personal : Doctor, Dentist","Personal","Doctor, Dentist","",$150.00,$0.00,-$2815.33
"Discover",,U,,08/16/2016,"Big Y","Food : Groceries","Food","Groceries","",$30.10,$0.00,-$2845.43
"Discover",,U,,08/17/2016,"Shell","Transportation : Gas","Transportation","Gas","",$27.80,$0.00,-$2873.23
"Discover",,U,,08/17/2016,"masspike","Transportation : tolls","Transportation","tolls","",$49.96,$0.00,-$2923.19
"Discover",,U,,08/17/2016,"Price Chopper","Food : Groceries","Food","Groceries","",$108.42,$0.00,-$3031.61
"Discover",,U,,08/18/2016,"itunes","Recreation : Entertainment","Recreation","Entertainment","",$0.99,$0.00,-$3032.60
"Discover",,U,,08/18/2016,"Tazza D Oro","Food : Restaurants","Food","Restaurants","",$185.90,$0.00,-$3218.50
"Discover",,U,,08/19/2016,"Hoyt Solomon pond mall","Food : Restaurants","Food","Restaurants","",$12.07,$0.00,-$3230.57
"Discover",,U,,08/19/2016,"Nourse Farm","Food : Groceries","Food","Groceries","",$25.17,$0.00,-$3255.74
"Discover",,U,,08/19/2016,"Hoyt Solomon pond mall","Recreation : Entertainment","Recreation","Entertainment","",$25.20,$0.00,-$3280.94
"Discover",,U,,08/20/2016,"netflix","Recreation : Entertainment","Recreation","Entertainment","",$18.48,$0.00,-$3299.42
"Discover",,U,,08/20/2016,"Flatwave Restaurant","Food : Restaurants","Food","Restaurants","",$37.12,$0.00,-$3336.54
"Discover",,U,,08/20/2016,"Shell","RV : gasoline","RV","gasoline","",$77.22,$0.00,-$3413.76
"Discover",,U,,08/22/2016,"sudbury farms","Food : Groceries","Food","Groceries","",$10.39,$0.00,-$3424.15
"Discover",,U,,08/22/2016,"hannaford","Food : Groceries","Food","Groceries","",$37.12,$0.00,-$3461.27
"Discover",,U,,08/23/2016,"speedway","Transportation : Gas","Transportation","Gas","",$19.20,$0.00,-$3480.47
"Discover",,U,,08/23/2016,"subway","Food : Restaurants","Food","Restaurants","",$20.04,$0.00,-$3500.51
"Discover",,U,,08/23/2016,"Marshall's Garden","Housing : Garden","Hidden Categories","Housing ` Garden","",$20.65,$0.00,-$3521.16
"Discover",,U,,08/24/2016,"Shell","Transportation : Gas","Transportation","Gas","",$29.52,$0.00,-$3550.68
"Discover",,U,,08/25/2016,"Price Chopper","Food : Groceries","Food","Groceries","",$72.01,$0.00,-$3622.69
"Discover",,U,,08/26/2016,"Amazon video","Recreation : Entertainment","Recreation","Entertainment","",$5.99,$0.00,-$3628.68
"Discover",,U,,08/27/2016,"reliant medicat","Personal : Doctor, Dentist","Personal","Doctor, Dentist","",$7.33,$0.00,-$3636.01
"Discover",,U,,08/27/2016,"La tapatia","Food : Restaurants","Food","Restaurants","",$65.09,$0.00,-$3701.10
"Discover",,U,,08/28/2016,"Amazon video","Recreation : Entertainment","Recreation","Entertainment",,$5.99,$0.00,-$3707.09
"Discover",,U,,08/28/2016,"Kathmunddo Kitchen","Food : Restaurants","Food","Restaurants","",$74.16,$0.00,-$3781.25
"Discover",,U,,08/29/2016,"Honey Dew","Food : Restaurants","Food","Restaurants","",$5.77,$0.00,-$3787.02
"Discover",,U,,08/29/2016,"speedway","Transportation : Gas","Transportation","Gas","",$19.75,$0.00,-$3806.77
"Discover",,U,,08/30/2016,"dunkin donuts","Food : Restaurants","Food","Restaurants","",$6.29,$0.00,-$3813.06
"Discover",,U,,08/30/2016,"Tavolino","Food : Restaurants","Food","Restaurants","",$75.08,$0.00,-$3888.14
"Discover",,U,,08/31/2016,"Honey Dew","Food : Restaurants","Food","Restaurants","",$6.39,$0.00,-$3894.53
"Discover",,U,,08/31/2016,"Shell","Transportation : Gas","Transportation","Gas","",$28.66,$0.00,-$3923.19
"Discover",,U,,09/01/2016,"Price Chopper","Food : Groceries","Food","Groceries","",$74.73,$0.00,-$3997.92
"Discover",,U,,09/02/2016,"Shell","Transportation : Gas","Transportation","Gas","",$19.52,$0.00,-$4017.44
"Discover",,U,,09/03/2016,"Norse Farm","Food : Groceries","Food","Groceries","",$11.02,$0.00,-$4028.46
"Discover",,U,,09/04/2016,"hannaford","Food : Groceries","Food","Groceries","",$51.05,$0.00,-$4079.51
"Discover",,U,,09/05/2016,"Home Depot","Housing : Maintenance & Repairs","Hidden Categories","Housing ` Maintenance & Repairs","",$5.57,$0.00,-$4085.08
"Discover",,U,,09/05/2016,"starbucks","Food : Restaurants","Food","Restaurants","",$11.13,$0.00,-$4096.21
"Discover",,U,,09/05/2016,"AC MOORE","Housing : Maintenance & Repairs","Hidden Categories","Housing ` Maintenance & Repairs","",$29.69,$0.00,-$4125.90
"Discover",,U,,09/07/2016,"Transfer : Dcu Checking",,,,"",$0.00,$2371.97,-$1753.93
"Discover",,U,,09/07/2016,"Home Depot","Housing : Maintenance & Repairs","Hidden Categories","Housing ` Maintenance & Repairs","",$47.63,$0.00,-$1801.56
"Discover",,U,,09/08/2016,"Home Depot","Housing : Maintenance & Repairs","Hidden Categories","Housing ` Maintenance & Repairs","",$0.00,$20.18,-$1781.38
"Discover",,U,,09/08/2016,"Price Chopper","Food : Groceries","Food","Groceries","",$16.77,$0.00,-$1798.15
"Discover",,U,,09/08/2016,"Home Depot","Housing : Maintenance & Repairs","Hidden Categories","Housing ` Maintenance & Repairs","",$19.03,$0.00,-$1817.18
"Discover",,U,,09/09/2016,"dunkin donuts","Food : Restaurants","Food","Restaurants","",$5.76,$0.00,-$1822.94
"Discover",,U,,09/10/2016,"Home Depot","Housing : Maintenance & Repairs","Hidden Categories","Housing ` Maintenance & Repairs","",$4.41,$0.00,-$1827.35
"Discover",,U,,09/10/2016,"Home Depot","Housing : Maintenance & Repairs","Hidden Categories","Housing ` Maintenance & Repairs","",$62.52,$0.00,-$1889.87
"Discover",,U,,09/10/2016,"hannaford","Food : Groceries","Food","Groceries","",$86.89,$0.00,-$1976.76
"Discover",,U,,09/11/2016,"Exxon mobile","Transportation : Gas","Transportation","Gas","",$28.21,$0.00,-$2004.97
"Discover",,U,,09/12/2016,"speedway","Transportation : Gas","Transportation","Gas","",$19.02,$0.00,-$2023.99
"Discover",,U,,09/12/2016,"sudbury farms","Food : Groceries","Food","Groceries","",$33.28,$0.00,-$2057.27
"Discover",,U,,09/14/2016,"Madrid","Food : Restaurants","Food","Restaurants","",$36.38,$0.00,-$2093.65
"Discover",,U,,09/14/2016,"masspike","Transportation : tolls","Transportation","tolls","",$45.55,$0.00,-$2139.20
"Discover",,U,,09/14/2016,"American Brain Tumor","Charity : Other","Charity","Other","",$125.00,$0.00,-$2264.20
"Discover",,U,,09/15/2016,"Home Depot","Housing : Maintenance & Repairs","Hidden Categories","Housing ` Maintenance & Repairs","",$16.17,$0.00,-$2280.37
"Discover",,U,,09/15/2016,"pho sure","Food : Restaurants","Food","Restaurants","",$40.00,$0.00,-$2320.37
"Discover",,U,,09/16/2016,"westward orchards Harvard","Food : Groceries","Food","Groceries","",$24.41,$0.00,-$2344.78
"Discover",,U,,09/16/2016,"Market bskt","Food : Groceries","Food","Groceries","",$77.37,$0.00,-$2422.15
"Discover",,U,,09/17/2016,"Cumberland Farms","Transportation : Gas","Transportation","Gas","",$29.13,$0.00,-$2451.28
"Discover",,U,,09/19/2016,"itunes","Recreation : Entertainment","Recreation","Entertainment","",$0.99,$0.00,-$2452.27
"Discover",,U,,09/19/2016,"Price Chopper","Food : Groceries","Food","Groceries","",$36.85,$0.00,-$2489.12
"Discover",,U,,09/20/2016,"speedway","Transportation : Gas","Transportation","Gas","",$17.89,$0.00,-$2507.01
"Discover",,U,,09/20/2016,"netflix","Recreation : Entertainment","Recreation","Entertainment","",$18.48,$0.00,-$2525.49
"Discover",,U,,09/20/2016,"A1 auto","Transportation : Repairs & Maintenance","Transportation","Repairs & Maintenance","",$35.35,$0.00,-$2560.84
"Discover",,U,,09/20/2016,"Harvey BP Londond MFG","Housing : Maintenance & Repairs","Hidden Categories","Housing ` Maintenance & Repairs","",$130.94,$0.00,-$2691.78
"Discover",,U,,09/21/2016,"hannaford","Food : Groceries","Food","Groceries","",$27.83,$0.00,-$2719.61
"Discover",,U,,09/21/2016,"NYA Joes","Food : Restaurants","Food","Restaurants","",$52.42,$0.00,-$2772.03
"Discover",,U,,09/21/2016,"A1 auto","Transportation : Repairs & Maintenance","Transportation","Repairs & Maintenance","",$147.19,$0.00,-$2919.22
"Discover",,U,,09/21/2016,"All Start Carpet Cleaning","Housing : Maintenance & Repairs","Hidden Categories","Housing ` Maintenance & Repairs","",$245.00,$0.00,-$3164.22
"Discover",,U,,09/22/2016,"Shell","Transportation : Gas","Transportation","Gas","",$29.71,$0.00,-$3193.93
"Discover",,U,,09/22/2016,"SMG","Personal : Doctor, Dentist","Personal","Doctor, Dentist","",$35.00,$0.00,-$3228.93
"Discover",,U,,09/23/2016,"Exxon mobile","Transportation : Gas","Transportation","Gas","",$19.26,$0.00,-$3248.19
"Discover",,U,,09/23/2016,"Nourse Farm","Food : Groceries","Food","Groceries",,$28.50,$0.00,-$3276.69
"Discover",,U,,09/24/2016,"spicepepepr garden","Food : Restaurants","Food","Restaurants","",$93.32,$0.00,-$3370.01
"Discover",,U,,09/26/2016,"chipolte","Food : Restaurants","Food","Restaurants","",$15.52,$0.00,-$3385.53
"Discover",,U,,09/26/2016,"sudbury farms","Food : Groceries","Food","Groceries","",$20.97,$0.00,-$3406.50
"Discover",,U,,09/27/2016,"Shell","Transportation : Gas","Transportation","Gas","",$28.54,$0.00,-$3435.04
"Discover",,U,,09/27/2016,"whole foods","Food : Groceries","Food","Groceries","",$49.91,$0.00,-$3484.95
"Discover",,U,,09/29/2016,"Market bskt","Food : Groceries","Food","Groceries","",$115.62,$0.00,-$3600.57
"Discover",,U,,09/30/2016,"Tremont","Food : Restaurants","Food","Restaurants","",$28.00,$0.00,-$3628.57
"Discover",,U,,10/01/2016,"Amazon MktPlace","Recreation : Entertainment","Recreation","Entertainment","",$11.99,$0.00,-$3640.56
"Discover",,U,,10/01/2016,"Peppertree","RV : Campgrounds","RV","Campgrounds","",$27.00,$0.00,-$3667.56
"Discover",,U,,10/01/2016,"Midway Restaurant","Food : Restaurants","Food","Restaurants","",$50.00,$0.00,-$3717.56
"Discover",,U,,10/01/2016,"Chucks Margarita Grill","Food : Restaurants","Food","Restaurants","",$124.88,$0.00,-$3842.44
"Discover",,U,,10/02/2016,"Jamba Juice","Food : Restaurants","Food","Restaurants","",$15.81,$0.00,-$3858.25
"Discover",,U,,10/02/2016,"Cumberland Farms","RV : gasoline","RV","gasoline","",$31.44,$0.00,-$3889.69
"Discover",,U,,10/03/2016,"hannaford","Food : Groceries","Food","Groceries","",$25.93,$0.00,-$3915.62
"Discover",,U,,10/03/2016,"shoe dpt encore","Personal : cloths","Personal","cloths","",$49.98,$0.00,-$3965.60
"Discover",,U,,10/04/2016,"Bertucci","Food : Restaurants","Food","Restaurants","",$33.00,$0.00,-$3998.60
"Discover",,U,,10/05/2016,"Metrowest medical center","Personal : Doctor, Dentist","Personal","Doctor, Dentist",,$10.49,$0.00,-$4009.09
"Discover",,U,,10/05/2016,"cinemagic Merrimack","Recreation : Entertainment","Recreation","Entertainment","",$12.51,$0.00,-$4021.60
"Discover",,U,,10/05/2016,"Shell","Transportation : Gas","Transportation","Gas","",$20.57,$0.00,-$4042.17
"Discover",,U,,10/05/2016,"cinemagic Merrimack","Recreation : Entertainment","Recreation","Entertainment","",$27.75,$0.00,-$4069.92
"Discover",,U,,10/05/2016,"Metrowest medical center","Personal : Doctor, Dentist","Personal","Doctor, Dentist","",$38.31,$0.00,-$4108.23
"Discover",,U,,10/05/2016,"decorex","Housing : Maintenance & Repairs","Hidden Categories","Housing ` Maintenance & Repairs","",$90.00,$0.00,-$4198.23
"Discover",,U,,10/07/2016,"Transfer : Dcu Checking",,,,"",$0.00,$2004.97,-$2193.26
"Discover",,U,,10/08/2016,"vin bin","Food : Groceries","Food","Groceries","",$9.99,$0.00,-$2203.25
"Discover",,U,,10/08/2016,"silk road bistro","Food : Restaurants","Food","Restaurants","",$99.19,$0.00,-$2302.44
"Discover",,U,,10/08/2016,"Metrowest radiology","Personal : Doctor, Dentist","Personal","Doctor, Dentist","",$159.00,$0.00,-$2461.44
"Discover",,U,,10/09/2016,"Plaza astec","Food : Restaurants","Food","Restaurants","",$49.15,$0.00,-$2510.59
"Discover",,U,,10/10/2016,"Shell","Transportation : Gas","Transportation","Gas","",$30.54,$0.00,-$2541.13
"Discover",,U,,10/10/2016,"The HA CAFE STORRS","Food : Restaurants","Food","Restaurants","",$31.50,$0.00,-$2572.63
"Discover",,U,,10/12/2016,"speedway","Transportation : Gas","Transportation","Gas","",$17.19,$0.00,-$2589.82
"Discover",,U,,10/12/2016,"masspike","Transportation : tolls","Transportation","tolls","",$49.90,$0.00,-$2639.72
"Discover",,U,,10/12/2016,"Market bskt","Food : Groceries","Food","Groceries","",$109.87,$0.00,-$2749.59
"Discover",,U,,10/13/2016,"chili basil","Food : Restaurants","Food","Restaurants","",$52.85,$0.00,-$2802.44
"Discover",,U,,10/14/2016,"hannaford","Food : Groceries","Food","Groceries","",$66.46,$0.00,-$2868.90
"Discover",,U,,10/16/2016,"LAZ Parking","Transportation : Parking","Transportation","Parking","",$15.00,$0.00,-$2883.90
"Discover",,U,,10/16/2016,"Trattoria IL Panino","Food : Restaurants","Food","Restaurants","",$133.07,$0.00,-$3016.97
"Discover",,U,,10/17/2016,"Amazon","Recreation : Alyssa","Recreation","Alyssa","",$3.83,$0.00,-$3020.80
"Discover",,U,,10/17/2016,"pho sure","Food : Restaurants","Food","Restaurants","",$42.10,$0.00,-$3062.90
"Discover",,U,,10/18/2016,"itunes","Recreation : Entertainment","Recreation","Entertainment","",$0.99,$0.00,-$3063.89
"Discover",,U,,10/18/2016,"Sunoco","Transportation : Gas","Transportation","Gas","",$24.35,$0.00,-$3088.24
"Discover",,U,,10/20/2016,"foppemas farm","Food : Groceries","Food","Groceries","",$14.97,$0.00,-$3103.21
"Discover",,U,,10/20/2016,"SQ littleman Northbridge Ma","Personal : Gifts","Personal","Gifts","",$17.00,$0.00,-$3120.21
"Discover",,U,,10/20/2016,"netflix","Recreation : Entertainment","Recreation","Entertainment","",$18.48,$0.00,-$3138.69
"Discover",,U,,10/20/2016,"Rebeccas Place","Food : Restaurants","Food","Restaurants","",$31.26,$0.00,-$3169.95
"Discover",,U,,10/22/2016,"speedway","Transportation : Gas","Transportation","Gas","",$19.74,$0.00,-$3189.69
"Discover",,U,,10/22/2016,"vin bin","Food : Groceries","Food","Groceries","",$44.82,$0.00,-$3234.51
"Discover",,U,,10/22/2016,"linguines","Food : Restaurants","Food","Restaurants","",$72.92,$0.00,-$3307.43
"Discover",,U,,10/22/2016,"hannaford","Food : Groceries","Food","Groceries","",$216.28,$0.00,-$3523.71
"Discover",,U,,10/23/2016,"dunkin donuts","Food : Restaurants","Food","Restaurants","",$10.71,$0.00,-$3534.42
"Discover",,U,,10/23/2016,"Amazon","RV : Equipment/Supplies","RV","Equipment/Supplies","",$1172.32,$0.00,-$4706.74
"Discover",,U,,10/24/2016,"dunkin donuts","Food : Restaurants","Food","Restaurants","",$5.72,$0.00,-$4712.46
"Discover",,U,,10/24/2016,"Exxon mobile","Transportation : Gas","Transportation","Gas","",$24.21,$0.00,-$4736.67
"Discover",,U,,10/24/2016,"Amazon","RV : Equipment/Supplies","RV","Equipment/Supplies","",$663.31,$0.00,-$5399.98
"Discover",,U,,10/25/2016,"dunkin donuts","Food : Restaurants","Food","Restaurants","",$4.06,$0.00,-$5404.04
"Discover",,U,,10/25/2016,"Price Chopper","Food : Groceries","Food","Groceries","",$39.10,$0.00,-$5443.14
"Discover",,U,,10/25/2016,"Amazon","RV : Equipment/Supplies","RV","Equipment/Supplies","",$59.16,$0.00,-$5502.30
"Discover",,U,,10/25/2016,"Amazon","RV : Equipment/Supplies","RV","Equipment/Supplies","",$99.80,$0.00,-$5602.10
"Discover",,U,,10/27/2016,"Shell","Transportation : Gas","Transportation","Gas","",$26.33,$0.00,-$5628.43
"Discover",,U,,10/27/2016,"hillside grill","Food : Restaurants","Food","Restaurants","",$30.57,$0.00,-$5659.00
"Discover",,U,,10/27/2016,"Shell","RV : gasoline","RV","gasoline","",$77.97,$0.00,-$5736.97
"Discover",,U,,10/27/2016,"Breathe Wellness","Recreation : Entertainment","Recreation","Entertainment","",$140.00,$0.00,-$5876.97
"Discover",,U,,10/27/2016,"Amazon","Personal : Gifts","Personal","Gifts","",$229.48,$0.00,-$6106.45
"Discover",,U,,10/27/2016,"Sullivan","RV : Maintenance","RV","Maintenance","",$656.25,$0.00,-$6762.70
"Discover",,U,,10/29/2016,"Hillary Victory Fund","Personal : Gifts","Personal","Gifts","Political contributions",$50.00,$0.00,-$6812.70
"Discover",,U,,10/31/2016,"Exxon mobile","Transportation : Gas","Transportation","Gas","",$21.23,$0.00,-$6833.93
"Discover",,U,,10/31/2016,"linguines","Food : Restaurants","Food","Restaurants","",$27.71,$0.00,-$6861.64
"Discover",,U,,11/01/2016,"Panera Bread","Food : Restaurants","Food","Restaurants","",$11.81,$0.00,-$6873.45
"Discover",,U,,11/02/2016,"hannaford","Food : Groceries","Food","Groceries","",$82.65,$0.00,-$6956.10
"Discover",,U,,11/03/2016,"Hillary Victory Fund","Personal : Gifts","Personal","Gifts","",$25.00,$0.00,-$6981.10
"Discover",,U,,11/03/2016,"Ocean State Joblot","Housing : Supplies","Hidden Categories","Housing ` Supplies","",$29.38,$0.00,-$7010.48
"Discover",,U,,11/03/2016,"Uconn","Recreation : Entertainment","Recreation","Entertainment","",$76.00,$0.00,-$7086.48
"Discover",,U,,11/04/2016,"Cumberland Farms","RV : gasoline","RV","gasoline","",$22.73,$0.00,-$7109.21
"Discover",,U,,11/04/2016,"katmandu Kitchen","Food : Restaurants","Food","Restaurants","",$87.23,$0.00,-$7196.44
"Discover",,U,,11/05/2016,"cap-marlboro","Transportation : Repairs & Maintenance","Transportation","Repairs & Maintenance","",$6.14,$0.00,-$7202.58
"Discover",,U,,11/05/2016,"Pho Bowl","Food : Restaurants","Food","Restaurants","With HUNG E",$50.00,$0.00,-$7252.58
"Discover",,U,,11/06/2016,"Hillary Victory Fund","Personal : Gifts","Personal","Gifts","political",$25.00,$0.00,-$7277.58
"Discover",,U,,11/06/2016,"chipolte","Food : Restaurants","Food","Restaurants","",$44.62,$0.00,-$7322.20
"Discover",,U,,11/07/2016,"Transfer : Dcu Checking",,,,"",$0.00,$2622.53,-$4699.67
"Discover",,U,,11/08/2016,"Market bskt","Food : Groceries","Food","Groceries","",$21.99,$0.00,-$4721.66
"Discover",,U,,11/09/2016,"speedway","Transportation : Gas","Transportation","Gas","",$13.56,$0.00,-$4735.22
"Discover",,U,,11/10/2016,"dunkin donuts","Food : Restaurants","Food","Restaurants","",$5.86,$0.00,-$4741.08
"Discover",,U,,11/10/2016,"hannaford","Food : Groceries","Food","Groceries","",$125.61,$0.00,-$4866.69
"Discover",,U,,11/12/2016,"Shell","Transportation : Gas","Transportation","Gas","",$19.64,$0.00,-$4886.33
"Discover",,U,,11/12/2016,"Reins Deli","Food : Restaurants","Food","Restaurants","",$45.90,$0.00,-$4932.23
"Discover",,U,,11/13/2016,"Roadside Forest Hills","Food : Restaurants","Food","Restaurants","",$33.94,$0.00,-$4966.17
"Discover",,U,,11/14/2016,"Shell","RV : gasoline","RV","gasoline","",$29.90,$0.00,-$4996.07
"Discover",,U,,11/14/2016,"A1 auto","Transportation : Repairs & Maintenance","Transportation","Repairs & Maintenance","",$212.01,$0.00,-$5208.08
"Discover",,U,,11/15/2016,"R.V.s R Us","RV : Maintenance","RV","Maintenance","",$386.04,$0.00,-$5594.12
"Discover",,U,,11/16/2016,"reg of motor vehicles","Transportation : Registration","Transportation","Registration","",$50.00,$0.00,-$5644.12
"Discover",,U,,11/17/2016,"savers marlboro","Personal : cloths","Personal","cloths","",$17.16,$0.00,-$5661.28
"Discover",,U,,11/17/2016,"villatoro","Food : Restaurants","Food","Restaurants","",$22.94,$0.00,-$5684.22
"Discover",,U,,11/17/2016,"American Brain Tumor","Charity : Other","Charity","Other","",$50.00,$0.00,-$5734.22
"Discover",,U,,11/18/2016,"itunes","Recreation : Entertainment","Recreation","Entertainment","",$0.99,$0.00,-$5735.21
"Discover",,U,,11/20/2016,"netflix","Recreation : Entertainment","Recreation","Entertainment","",$18.48,$0.00,-$5753.69
"Discover",,U,,11/20/2016,"Hilltop Restaurant","Food : Restaurants","Food","Restaurants","connecticut",$115.74,$0.00,-$5869.43
"Discover",,U,,11/21/2016,"starbucks","Food : Restaurants","Food","Restaurants","",$4.59,$0.00,-$5874.02
"Discover",,U,,11/21/2016,"AMC CHOCE CAFE ALBANY","Food : Restaurants","Food","Restaurants","",$5.38,$0.00,-$5879.40
"Discover",,U,,11/21/2016,"Shell","Transportation : Gas","Transportation","Gas","",$17.70,$0.00,-$5897.10
"Discover",,U,,11/21/2016,"Smartpak Equine","Recreation : Alyssa Horse","Recreation","Alyssa Horse","",$41.44,$0.00,-$5938.54
"Discover",,U,,11/21/2016,"Walmart","RV : Equipment/Supplies","RV","Equipment/Supplies","",$82.94,$0.00,-$6021.48
"Discover",,U,,11/23/2016,"Movers Guide Memphis","Recreation : Vacation","Recreation","Vacation","",$1.00,$0.00,-$6022.48
"Discover",,U,,11/23/2016,"Oliver Ormans","Food : Restaurants","Food","Restaurants","",$25.00,$0.00,-$6047.48
"Discover",,U,,11/23/2016,"sav on yarmouth","Transportation : Gas","Transportation","Gas","",$30.00,$0.00,-$6077.48
"Discover",,U,,11/23/2016,"Price Chopper","Food : Groceries","Food","Groceries","",$46.74,$0.00,-$6124.22
"Discover",,U,,11/25/2016,"La tapatia","Food : Restaurants","Food","Restaurants","",$37.03,$0.00,-$6161.25
"Discover",,U,,11/25/2016,"hannaford","Food : Groceries","Food","Groceries","",$90.32,$0.00,-$6251.57
"Discover",,U,,11/25/2016,"Best Buy","business (bob) : Equipment","Hidden Categories","business (bob) ` Equipment","BOB COMPUTER",$1062.49,$0.00,-$7314.06
"Discover",,U,,11/26/2016,"google storage","business (bob) : computer","Hidden Categories","business (bob) ` computer","",$1.99,$0.00,-$7316.05
"Discover",,U,,11/26/2016,"speedway","Transportation : Gas","Transportation","Gas","",$19.34,$0.00,-$7335.39
"Discover",,U,,11/26/2016,"a taste of vietnam","Food : Restaurants","Food","Restaurants","",$90.10,$0.00,-$7425.49
"Discover",,U,,11/26/2016,"PR Running","Personal : cloths","Personal","cloths","",$107.99,$0.00,-$7533.48
"Discover",,U,,11/27/2016,"villatoro","Food : Restaurants","Food","Restaurants","",$31.47,$0.00,-$7564.95
"Discover",,U,,11/27/2016,"bella Costa","Food : Restaurants","Food","Restaurants","",$132.82,$0.00,-$7697.77
"Discover",,U,,11/28/2016,"Berlin Liquor","Food : Groceries","Food","Groceries","",$10.29,$0.00,-$7708.06
"Discover",,U,,11/28/2016,"Cumberland Farms","Transportation : Gas","Transportation","Gas","",$26.82,$0.00,-$7734.88
"Discover",,U,,11/28/2016,"Bertucci","Food : Restaurants","Food","Restaurants","",$41.72,$0.00,-$7776.60
"Discover",,U,,12/01/2016,"hannaford","Food : Groceries","Food","Groceries","",$29.48,$0.00,-$7806.08
"Discover",,U,,12/01/2016,"Officemax","Housing : Supplies","Hidden Categories","Housing ` Supplies","",$37.18,$0.00,-$7843.26
"Discover",,U,,12/04/2016,"Home Depot","Housing : Maintenance & Repairs","Hidden Categories","Housing ` Maintenance & Repairs","",$269.48,$0.00,-$8112.74
"Discover",,U,,12/05/2016,"sav on camp","Transportation : Gas","Transportation","Gas","",$27.31,$0.00,-$8140.05
"Discover",,U,,12/06/2016,"Smartpak Equine","Recreation : Alyssa Horse","Recreation","Alyssa Horse","",$0.00,$52.01,-$8088.04
"Discover",,U,,12/07/2016,"Transfer : Dcu Checking",,,,"",$0.00,$4866.69,-$3221.35
"Discover",,U,,12/07/2016,"Shell","RV : gasoline","RV","gasoline","",$30.03,$0.00,-$3251.38
"Discover",,U,,12/07/2016,"Rebeccas Place","Food : Restaurants","Food","Restaurants","",$31.53,$0.00,-$3282.91
"Discover",,U,,12/08/2016,"villatoro","Food : Restaurants","Food","Restaurants","",$19.86,$0.00,-$3302.77
"Discover",,U,,12/08/2016,"Price Chopper","Food : Groceries","Food","Groceries","",$26.76,$0.00,-$3329.53
"Discover",,U,,12/09/2016,"A.L. Prime","Transportation : Gas","Transportation","Gas","",$18.47,$0.00,-$3348.00
"Discover",,U,,12/09/2016,"sperry liquor","Food : Groceries","Food","Groceries","",$23.98,$0.00,-$3371.98
"Discover",,U,,12/10/2016,"QUAN CHINESE KITCHEN","Food : Restaurants","Food","Restaurants","dennis Ma",$40.50,$0.00,-$3412.48
"Discover",,U,,12/10/2016,"LLBE AN DIRECT","Personal : cloths","Personal","cloths","",$54.00,$0.00,-$3466.48
"Discover",,U,,12/11/2016,"stop & shop","Food : Groceries","Food","Groceries","Dennis Ma",$135.37,$0.00,-$3601.85
"Discover",,U,,12/12/2016,"The UPS Store","Housing : Supplies","Hidden Categories","Housing ` Supplies","",$8.71,$0.00,-$3610.56
"Discover",,U,,12/12/2016,"Barnes and Noble","Personal : Gifts","Personal","Gifts","",$59.43,$0.00,-$3669.99
"Discover",,U,,12/13/2016,"USPS","Housing : Supplies","Hidden Categories","Housing ` Supplies","",$5.64,$0.00,-$3675.63
"Discover",,U,,12/13/2016,"Cumberland Farms","Transportation : Gas","Transportation","Gas","",$13.21,$0.00,-$3688.84
"Discover",,U,,12/13/2016,"Kays","Food : Restaurants","Food","Restaurants","RI",$30.40,$0.00,-$3719.24
"Discover",,U,,12/13/2016,"Columbia Sportswear","Personal : cloths","Personal","cloths","",$53.94,$0.00,-$3773.18
"Discover",,U,,12/14/2016,"Cafe Al Fresco","Food : Restaurants","Food","Restaurants","Brewster",$35.32,$0.00,-$3808.50
"Discover",,U,,12/14/2016,"Marshall's","Personal : cloths","Personal","cloths","",$66.70,$0.00,-$3875.20
"Discover",,U,,12/14/2016,"stop & shop","Food : Groceries","Food","Groceries","dennis",$143.17,$0.00,-$4018.37
"Discover",,U,,12/15/2016,"Nancies Candy","Personal : Gifts","Personal","Gifts","",$9.95,$0.00,-$4028.32
"Discover",,U,,12/15/2016,"advanced autoparts","RV : Maintenance","RV","Maintenance","",$10.61,$0.00,-$4038.93
"Discover",,U,,12/15/2016,"Nancies Candy","Personal : Gifts","Personal","Gifts","",$75.61,$0.00,-$4114.54
"Discover",,U,,12/15/2016,"Parma","Food : Restaurants","Food","Restaurants","dennis",$76.16,$0.00,-$4190.70
"Discover",,U,,12/16/2016,"Exxon mobile","Food : Restaurants","Food","Restaurants","",$4.38,$0.00,-$4195.08
"Discover",,U,,12/16/2016,"speedway","Transportation : Gas","Transportation","Gas","",$17.45,$0.00,-$4212.53
"Discover",,U,,12/16/2016,"Storenvy","business (bob) : computer","Hidden Categories","business (bob) ` computer","",$31.98,$0.00,-$4244.51
"Discover",,U,,12/16/2016,"Marshall's","Personal : cloths","Personal","cloths","",$51.80,$0.00,-$4296.31
"Discover",,U,,12/16/2016,"RIng Brothers Market place","Food : Groceries","Food","Groceries","",$73.41,$0.00,-$4369.72
"Discover",,U,,12/18/2016,"itunes","Recreation : Entertainment","Recreation","Entertainment","",$0.99,$0.00,-$4370.71
"Discover",,U,,12/18/2016,"dunkin donuts","Food : Restaurants","Food","Restaurants","",$6.49,$0.00,-$4377.20
"Discover",,U,,12/18/2016,"Exxon mobile","Food : Restaurants","Food","Restaurants","",$21.76,$0.00,-$4398.96
"Discover",,U,,12/18/2016,"Amazon","RV : Equipment/Supplies","RV","Equipment/Supplies","",$152.95,$0.00,-$4551.91
"Discover",,U,,12/18/2016,"Delfino","Food : Restaurants","Food","Restaurants","Karina Birthday Dinner",$350.16,$0.00,-$4902.07
"Discover",,U,,12/19/2016,"Marshall's","Personal : cloths","Personal","cloths","",$66.25,$0.00,-$4968.32
"Discover",,U,,12/19/2016,"RIng Brothers Market place","Food : Groceries","Food","Groceries","Dennis",$98.67,$0.00,-$5066.99
"Discover",,U,,12/20/2016,"netflix","Recreation : Entertainment","Recreation","Entertainment","",$9.99,$0.00,-$5076.98
"Discover",,U,,12/20/2016,"stop & shop","Food : Groceries","Food","Groceries","dennis",$108.93,$0.00,-$5185.91
"Discover",,U,,12/21/2016,"bass river mercentile","Personal : Gifts","Personal","Gifts","",$13.53,$0.00,-$5199.44
"Discover",,U,,12/21/2016,"Go Calendars","Personal : Gifts","Personal","Gifts","",$15.93,$0.00,-$5215.37
"Discover",,U,,12/21/2016,"Hot Topic","Personal : Miscellaneous","Personal","Miscellaneous","",$19.58,$0.00,-$5234.95
"Discover",,U,,12/21/2016,"shoe dpt encore","Personal : cloths","Personal","cloths","",$19.97,$0.00,-$5254.92
"Discover",,U,,12/21/2016,"Hoyt cape code","Recreation : Entertainment","Recreation","Entertainment","",$33.00,$0.00,-$5287.92
"Discover",,U,,12/21/2016,"Robert B OUR CO","Housing : Maintenance & Repairs","Hidden Categories","Housing ` Maintenance & Repairs","32 longfellow septic issues",$355.00,$0.00,-$5642.92
"Discover",,U,,12/22/2016,"Aunties Ice cream","Food : Restaurants","Food","Restaurants","",$10.48,$0.00,-$5653.40
"Discover",,U,,12/22/2016,"Fein Things","Personal : Gifts","Personal","Gifts","",$20.08,$0.00,-$5673.48
"Discover",,U,,12/22/2016,"HOUSTON SPCA","Charity : Other","Charity","Other","",$25.00,$0.00,-$5698.48
"Discover",,U,,12/22/2016,"labelles General Store","Personal : Gifts","Personal","Gifts","",$29.72,$0.00,-$5728.20
"Discover",,U,,12/22/2016,"stop & shop","Food : Groceries","Food","Groceries","",$30.93,$0.00,-$5759.13
"Discover",,U,,12/23/2016,"Marshall's","Personal : cloths","Personal","cloths","",$0.00,$20.17,-$5738.96
"Discover",,U,,12/23/2016,"USPS","Housing : Supplies","Hidden Categories","Housing ` Supplies","",$13.64,$0.00,-$5752.60
"Discover",,U,,12/23/2016,"stop & shop","Food : Groceries","Food","Groceries","",$32.26,$0.00,-$5784.86
"Discover",,U,,12/23/2016,"Hoyt cape code","Recreation : Entertainment","Recreation","Entertainment","",$33.00,$0.00,-$5817.86
"Discover",,U,,12/23/2016,"Royall II restaurant Yarmouth","Food : Restaurants","Food","Restaurants","",$75.00,$0.00,-$5892.86
"Discover",,U,,12/23/2016,"Yoga Center of cape code","Personal : Fitness","Personal","Fitness","",$80.00,$0.00,-$5972.86
"Discover",,U,,12/24/2016,"speedway","Transportation : Gas","Transportation","Gas","",$14.26,$0.00,-$5987.12
"Discover",,U,,12/24/2016,"IZONE GROUP CHARLTON MA","Personal : cloths","Personal","cloths","",$31.86,$0.00,-$6018.98
"Discover",,U,,12/26/2016,"google storage","business (bob) : computer","Hidden Categories","business (bob) ` computer","",$1.99,$0.00,-$6020.97
"Discover",,U,,12/26/2016,"Jetblue","Recreation : Vacation","Recreation","Vacation","",$151.10,$0.00,-$6172.07
"Discover",,U,,12/27/2016,"tvhdw Dennis","Housing : Maintenance & Repairs","Hidden Categories","Housing ` Maintenance & Repairs","",$7.72,$0.00,-$6179.79
"Discover",,U,,12/27/2016,"stop & shop","Food : Groceries","Food","Groceries","",$44.56,$0.00,-$6224.35
"Discover",,U,,12/27/2016,"Amazon","RV : Equipment/Supplies","RV","Equipment/Supplies","",$62.69,$0.00,-$6287.04
"Discover",,U,,12/28/2016,"Barnes and Noble","Personal : Gifts","Personal","Gifts","",$0.00,$1.30,-$6285.74
"Discover",,U,,12/28/2016,"speedway","Transportation : Gas","Transportation","Gas","",$19.83,$0.00,-$6305.57
"Discover",,U,,12/28/2016,"Miami Everglades RV","RV : Campgrounds","RV","Campgrounds","",$60.00,$0.00,-$6365.57
"Discover",,U,,12/28/2016,"arturos Restaurant","Food : Restaurants","Food","Restaurants","",$152.00,$0.00,-$6517.57
"Discover",,U,,12/29/2016,"gulf mart","Food : Restaurants","Food","Restaurants","",$3.80,$0.00,-$6521.37
"Discover",,U,,12/29/2016,"AAII","Education : Investing","Education","Investing","",$29.00,$0.00,-$6550.37
"Discover",,U,,12/29/2016,"LLBE AN DIRECT","Personal : cloths","Personal","cloths","",$37.81,$0.00,-$6588.18
"Discover",,U,,12/29/2016,"Roche Brothers","Food : Groceries","Food","Groceries","",$140.89,$0.00,-$6729.07
"Discover",,U,,12/30/2016,"Go Calendars","Personal : Gifts","Personal","Gifts","",$4.24,$0.00,-$6733.31
"Discover",,U,,12/30/2016,"Hopkinton wine & spirits","Food : Groceries","Food","Groceries","",$14.99,$0.00,-$6748.30
"Discover",,U,,12/30/2016,"verc enterprise","Transportation : Gas","Transportation","Gas","",$22.58,$0.00,-$6770.88
"Discover",,U,,12/30/2016,"The Paper Store","Personal : Gifts","Personal","Gifts","",$24.23,$0.00,-$6795.11
"Discover",,U,,12/30/2016,"silk road bistro","Food : Restaurants","Food","Restaurants","",$93.15,$0.00,-$6888.26
"Discover",,U,,12/31/2016,"walgreens","Personal : Miscellaneous","Personal","Miscellaneous","",$12.73,$0.00,-$6900.99
"Discover",,U,,12/31/2016,"whole foods","Food : Groceries","Food","Groceries","",$21.77,$0.00,-$6922.76
"Discover",,U,,12/31/2016,"AHI Restaurant Newton","Food : Restaurants","Food","Restaurants","",$120.15,$0.00,-$7042.91
"Discover",,U,,01/01/2017,"cvs","Personal : Prescriptions, Medicine","Personal","Prescriptions, Medicine","",$27.35,$0.00,-$7070.26
"Discover",,U,,01/01/2017,"WPCHRG","business (bob) : computer","Hidden Categories","business (bob) ` computer","??",$35.88,$0.00,-$7106.14
"Discover",,U,,01/01/2017,"SUnoco Bellingham","RV : gasoline","RV","gasoline","",$83.09,$0.00,-$7189.23
"Discover",,U,,01/01/2017,"LLBE AN DIRECT","Personal : cloths","Personal","cloths","",$118.99,$0.00,-$7308.22
"Discover",,U,,01/02/2017,"dunkin donuts","Food : Restaurants","Food","Restaurants","",$4.73,$0.00,-$7312.95
"Discover",,U,,01/02/2017,"McDonalds","Food : Restaurants","Food","Restaurants","",$21.00,$0.00,-$7333.95
"Discover",,U,,01/03/2017,"cinnabon","business (bob) : Real Estate","Hidden Categories","business (bob) ` Real Estate","",$7.36,$0.00,-$7341.31
"Discover",,U,,01/03/2017,"Phillips Aberdeen MD","Food : Restaurants","Food","Restaurants","",$16.09,$0.00,-$7357.40
"Discover",,U,,01/03/2017,"Walmart","Food : Groceries","Food","Groceries","RICHMOND VA",$20.09,$0.00,-$7377.49
"Discover",,U,,01/03/2017,"Curroto Aberdeen","Food : Restaurants","Food","Restaurants","Maryland",$25.72,$0.00,-$7403.21
"Discover",,U,,01/03/2017,"Sunoco","RV : gasoline","RV","gasoline","Cherry Hill NJ",$87.27,$0.00,-$7490.48
"Discover",,U,,01/04/2017,"Walmart","Food : Groceries","Food","Groceries","",$2.81,$0.00,-$7493.29
"Discover",,U,,01/04/2017,"Shell","Food : Restaurants","Food","Restaurants","",$13.86,$0.00,-$7507.15
"Discover",,U,,01/04/2017,"Briarcliff RV resort","RV : Campgrounds","RV","Campgrounds","",$51.95,$0.00,-$7559.10
"Discover",,U,,01/04/2017,"Shell","RV : gasoline","RV","gasoline","stoney creek va",$84.87,$0.00,-$7643.97
"Discover",,U,,01/05/2017,"Briarcliff RV resort","RV : Campgrounds","RV","Campgrounds","",$51.55,$0.00,-$7695.52
"Discover",,U,,01/05/2017,"Nacho Hippo","Food : Restaurants","Food","Restaurants","Myrtle Beach with Uncle Mike and Debbie",$108.54,$0.00,-$7804.06
"Discover",,U,,01/06/2017,"Cheveron","Transportation : Gas","Transportation","Gas","",$20.65,$0.00,-$7824.71
"Discover",,U,,01/06/2017,"KOA Savannah","RV : Campgrounds","RV","Campgrounds","",$38.00,$0.00,-$7862.71
"Discover",,U,,01/06/2017,"Brookgreen Gardens","Recreation : Entertainment","Recreation","Entertainment","",$48.00,$0.00,-$7910.71
"Discover",,U,,01/06/2017,"circle k","RV : gasoline","RV","gasoline","",$69.66,$0.00,-$7980.37
"Discover",,U,,01/06/2017,"The vault","Food : Restaurants","Food","Restaurants","With Alyssa friend",$132.34,$0.00,-$8112.71
"Discover",,U,,01/07/2017,"Vending machine","Food : Restaurants","Food","Restaurants","FL",$21.50,$0.00,-$8134.21
"Discover",,U,,01/07/2017,"Sumpass","RV : Tolls","RV","Tolls","bought sunpass",$25.00,$0.00,-$8159.21
"Discover",,U,,01/07/2017,"Chevron","RV : gasoline","RV","gasoline","georgia",$94.99,$0.00,-$8254.20
"Discover",,U,,01/08/2017,"Prime Empanada","Food : Restaurants","Food","Restaurants","Empanada near Gloria Viscosi",$24.61,$0.00,-$8278.81
"Discover",,U,,01/08/2017,"Pilot","RV : gasoline","RV","gasoline","Saint Lucie FL",$54.71,$0.00,-$8333.52
"Discover",,U,,01/08/2017,"winn-dixie","Food : Groceries","Food","Groceries","",$115.14,$0.00,-$8448.66
"Discover",,U,,01/08/2017,"Miami Everglades RV","RV : Campgrounds","RV","Campgrounds","",$333.24,$0.00,-$8781.90
"Discover",,U,,01/09/2017,"Transfer : Dcu Checking",,,,"",$0.00,$3610.56,-$5171.34
"Discover",,U,,01/09/2017,"Hoake Chat","Recreation : Entertainment","Recreation","Entertainment","",$75.74,$0.00,-$5247.08
"Discover",,U,,01/10/2017,"Everglades VC","Personal : Miscellaneous","Personal","Miscellaneous","",$10.65,$0.00,-$5257.73
"Discover",,U,,01/10/2017,"Shell","Transportation : Gas","Transportation","Gas","",$17.16,$0.00,-$5274.89
"Discover",,U,,01/10/2017,"Everglades VC","Personal : Miscellaneous","Personal","Miscellaneous","",$20.84,$0.00,-$5295.73
"Discover",,U,,01/10/2017,"Soriano Brothers","Food : Restaurants","Food","Restaurants","homestead FL",$36.77,$0.00,-$5332.50
"Discover",,U,,01/10/2017,"Evergades NP","Recreation : Entertainment","Recreation","Entertainment","National Parks Pass",$80.00,$0.00,-$5412.50
"Discover",,U,,01/11/2017,"Camellia Street Grill","Food : Restaurants","Food","Restaurants","",$89.41,$0.00,-$5501.91
"Discover",,U,,01/11/2017,"Evergades NP","Recreation : Entertainment","Recreation","Entertainment","",$111.30,$0.00,-$5613.21
"Discover",,U,,01/12/2017,"Coral Castle Homestead FL","Recreation : Entertainment","Recreation","Entertainment","Interesting Place designed by a forlorn immigrant whose sweetheart broke their engagement went with Alyssa and Lisa",$48.15,$0.00,-$5661.36
"Discover",,U,,01/12/2017,"Crust Miami","Food : Restaurants","Food","Restaurants","",$129.00,$0.00,-$5790.36
"Discover",,U,,01/13/2017,"Walmart","Food : Groceries","Food","Groceries","",$5.86,$0.00,-$5796.22
"Discover",,U,,01/13/2017,"Exxon mobile","Transportation : Gas","Transportation","Gas","",$17.31,$0.00,-$5813.53
"Discover",,U,,01/13/2017,"Key Largo Chocolates","Food : Restaurants","Food","Restaurants","",$18.54,$0.00,-$5832.07
"Discover",,U,,01/13/2017,"Corall Reef Park Key Largo","Recreation : Entertainment","Recreation","Entertainment","With Alyssa",$31.18,$0.00,-$5863.25
"Discover",,U,,01/13/2017,"Walmart","Food : Groceries","Food","Groceries","(Split 1/2) ",$54.00,$0.00,-$6060.68
"Discover",,U,,01/13/2017,"Walmart","RV : Equipment/Supplies","RV","Equipment/Supplies","(Split 2/2) ",$143.43,$0.00,-$6060.68
"Discover",,U,,01/14/2017,"Miami Everglades RV","RV : Campgrounds","RV","Campgrounds","",$17.38,$0.00,-$6078.06
"Discover",,U,,01/14/2017,"SUn Pass","RV : Tolls","RV","Tolls","",$25.00,$0.00,-$6103.06
"Discover",,U,,01/14/2017,"CALUSA BLUEWAY10901 PALM BEACH BLVD, FL 33905","Recreation : Entertainment","Recreation","Entertainment","Kayaking with Manatee and Alyssa and Lisa",$26.50,$0.00,-$6129.56
"Discover",,U,,01/14/2017,"Griffen U-Gas","RV : gasoline","RV","gasoline","",$28.21,$0.00,-$6157.77
"Discover",,U,,01/14/2017,"Griffen U-Gas","RV : gasoline","RV","gasoline","",$50.00,$0.00,-$6207.77
"Discover",,U,,01/14/2017,"Gufl View","RV : Campgrounds","RV","Campgrounds","",$76.68,$0.00,-$6284.45
"Discover",,U,,01/14/2017,"Leroys Southern","Food : Restaurants","Food","Restaurants","With Lisa and Alyssa",$156.61,$0.00,-$6441.06
"Discover",,U,,01/15/2017,"Wilder Ricecreek","RV : Campgrounds","RV","Campgrounds","",$42.75,$0.00,-$6483.81
"Discover",,U,,01/15/2017,"Wilder Ricecreek","RV : Campgrounds","RV","Campgrounds","",$250.00,$0.00,-$6733.81
"Discover",,U,,01/17/2017,"redbox","Recreation : Entertainment","Recreation","Entertainment","",$1.61,$0.00,-$6735.42
"Discover",,U,,01/17/2017,"USPS","RV : Equipment/Supplies","RV","Equipment/Supplies","",$22.26,$0.00,-$6757.68
"Discover",,U,,01/17/2017,"Lightfoot LTD","Education : College","Education","College","Animation Supplies",$70.09,$0.00,-$6827.77
"Discover",,U,,01/17/2017,"winn-dixie","Food : Groceries","Food","Groceries","",$201.01,$0.00,-$7028.78
"Discover",,U,,01/18/2017,"itunes","Recreation : Entertainment","Recreation","Entertainment","",$0.99,$0.00,-$7029.77
"Discover",,U,,01/19/2017,"Murphys","Transportation : Gas","Transportation","Gas","",$19.31,$0.00,-$7049.08
"Discover",,U,,01/19/2017,"Nv Salon and Spa","Personal : Miscellaneous","Personal","Miscellaneous","Haircut",$48.00,$0.00,-$7097.08
"Discover",,U,,01/19/2017,"Circles","Food : Restaurants","Food","Restaurants","Dinner WIth John and Joe",$178.41,$0.00,-$7275.49
"Discover",,U,,01/20/2017,"Latin Bistro Riverview","Food : Restaurants","Food","Restaurants","This was the place that had just opened - family run nice people though food was only so-so",$21.36,$0.00,-$7296.85
"Discover",,U,,01/21/2017,"Edy's Main St","Food : Restaurants","Food","Restaurants","Lisa and I stopped for Ice Cream",$11.13,$0.00,-$7307.98
"Discover",,U,,01/21/2017,"First Watch Restaurant","Food : Restaurants","Food","Restaurants","Womens March - Jean, Joey and (Forgot name)",$32.57,$0.00,-$7340.55
"Discover",,U,,01/22/2017,"redbox","Recreation : Entertainment","Recreation","Entertainment","",$1.61,$0.00,-$7342.16
"Discover",,U,,01/22/2017,"winn-dixie","Food : Groceries","Food","Groceries","",$5.99,$0.00,-$7348.15
"Discover",,U,,01/22/2017,"winn-dixie","Food : Groceries","Food","Groceries","",$19.18,$0.00,-$7367.33
"Discover",,U,,01/22/2017,"Cracker Barrel","Food : Restaurants","Food","Restaurants","",$26.76,$0.00,-$7394.09
"Discover",,U,,01/23/2017,"redbox","Recreation : Entertainment","Recreation","Entertainment","",$1.61,$0.00,-$7395.70
"Discover",,U,,01/23/2017,"circle k","Transportation : Gas","Transportation","Gas","",$15.48,$0.00,-$7411.18
"Discover",,U,,01/23/2017,"Wilder Ricecreek","RV : Campgrounds","RV","Campgrounds","",$128.25,$0.00,-$7539.43
"Discover",,U,,01/23/2017,"Walmart","Food : Groceries","Food","Groceries","(Split 1/2) ",$100.00,$0.00,-$7721.87
"Discover",,U,,01/23/2017,"Walmart","RV : Equipment/Supplies","RV","Equipment/Supplies","(Split 2/2) ",$82.44,$0.00,-$7721.87
"Discover",,U,,01/25/2017,"Goodson Farms","Food : Restaurants","Food","Restaurants","Shortcake with Donna Hays (moms Neighbor)",$28.00,$0.00,-$7749.87
"Discover",,U,,01/26/2017,"google storage","business (bob) : computer","Hidden Categories","business (bob) ` computer","",$1.99,$0.00,-$7751.86
"Discover",,U,,01/26/2017,"Myakka River State Park","RV : Campgrounds","RV","Campgrounds","We liked this place.",$29.12,$0.00,-$7780.98
"Discover",,U,,01/26/2017,"Marathon","RV : gasoline","RV","gasoline","",$75.00,$0.00,-$7855.98
"Discover",,U,,01/27/2017,"starbucks","Food : Restaurants","Food","Restaurants","I think I went here to work",$6.26,$0.00,-$7862.24
"Discover",,U,,01/27/2017,"Sun N Shade RV Punta Korda","RV : Campgrounds","RV","Campgrounds","Dave, Sandi and Tim and Duncan (dog)",$284.23,$0.00,-$8146.47
"Discover",,U,,01/28/2017,"Lee County Fair","Personal : Gifts","Personal","Gifts","Ask Liusa",$16.00,$0.00,-$8162.47
"Discover",,U,,01/28/2017,"Uconn","Education : College","Education","College","Art Fees?",$870.00,$0.00,-$9032.47
"Discover",,U,,01/29/2017,"Less County Fair","Personal : Gifts","Personal","Gifts","ask lisa",$16.00,$0.00,-$9048.47
"Discover",,U,,01/29/2017,"Love's","Transportation : Gas","Transportation","Gas","",$17.43,$0.00,-$9065.90
"Discover",,U,,01/29/2017,"Walmart","Food : Groceries","Food","Groceries","",$77.51,$0.00,-$9143.41
"Discover",,U,,01/30/2017,"redbox","Recreation : Entertainment","Recreation","Entertainment","",$1.61,$0.00,-$9145.02
"Discover",,U,,01/30/2017,"Intuit Payroll","Lisa Business : Business expenses","Lisa Business","Business expenses","??",$15.93,$0.00,-$9160.95
"Discover",,U,,01/30/2017,"Walmart","RV : Equipment/Supplies","RV","Equipment/Supplies","",$101.08,$0.00,-$9262.03
"Discover",,U,,01/31/2017,"Intuit Payroll","Lisa Business : Business expenses","Lisa Business","Business expenses","??",$15.93,$0.00,-$9277.96
"Discover",,U,,02/01/2017,"Mucho Taco","Food : Restaurants","Food","Restaurants","Near North Trail RV",$18.82,$0.00,-$9296.78
"Discover",,U,,02/01/2017,"cvs","Personal : Prescriptions, Medicine","Personal","Prescriptions, Medicine","",$35.00,$0.00,-$9331.78
"Discover",,U,,02/01/2017,"Sun N Shade RV Punta Korda","RV : Campgrounds","RV","Campgrounds","",$121.34,$0.00,-$9453.12
"Discover",,U,,02/02/2017,"speedway","Transportation : Gas","Transportation","Gas","",$9.08,$0.00,-$9462.20
"Discover",,U,,02/02/2017,"Exxon mobile","Transportation : Gas","Transportation","Gas","",$20.34,$0.00,-$9482.54
"Discover",,U,,02/02/2017,"publix","Food : Groceries","Food","Groceries","",$23.48,$0.00,-$9506.02
"Discover",,U,,02/02/2017,"Capt Eddies Seafood","Food : Restaurants","Food","Restaurants","Dinner with DICK and GAIL",$110.71,$0.00,-$9616.73
"Discover",,U,,02/03/2017,"redbox","Recreation : Entertainment","Recreation","Entertainment","",$1.61,$0.00,-$9618.34
"Discover",,U,,02/03/2017,"Walmart","Food : Groceries","Food","Groceries","(Split 1/2) ",$100.00,$0.00,-$9770.10
"Discover",,U,,02/03/2017,"Walmart","RV : Equipment/Supplies","RV","Equipment/Supplies","(Split 2/2) ",$51.76,$0.00,-$9770.10
"Discover",,U,,02/03/2017,"Wilder Clearwater","RV : Campgrounds","RV","Campgrounds","",$350.00,$0.00,-$10120.10
"Discover",,U,,02/06/2017,"USPS","RV : Equipment/Supplies","RV","Equipment/Supplies","",$9.80,$0.00,-$10129.90
"Discover",,U,,02/06/2017,"Mucho Taco","Food : Restaurants","Food","Restaurants","",$26.62,$0.00,-$10156.52
"Discover",,U,,02/06/2017,"Sams RV club","RV : clubs","RV","clubs","",$50.00,$0.00,-$10206.52
"Discover",,U,,02/06/2017,"Suburban Extended Stay","RV : MISC","RV","MISC","Hotel while waiting for RV",$109.89,$0.00,-$10316.41
"Discover",,U,,02/06/2017,"Sams RV club","RV : clubs","RV","clubs","",$109.95,$0.00,-$10426.36
"Discover",,U,,02/07/2017,"Transfer : Dcu Checking",,,,"",$0.00,$5742.21,-$4684.15
"Discover",,U,,02/07/2017,"Northtrail RV","RV : Equipment/Supplies","RV","Equipment/Supplies","",$0.00,$180.20,-$4503.95
"Discover",,U,,02/07/2017,"41 Diner Fort Myers FL","Food : Restaurants","Food","Restaurants","",$32.00,$0.00,-$4535.95
"Discover",,U,,02/07/2017,"Stan Winston School","Education : College","Education","College","",$215.40,$0.00,-$4751.35
"Discover",,U,,02/07/2017,"Northtrail RV","RV : Equipment/Supplies","RV","Equipment/Supplies","",$217.87,$0.00,-$4969.22
"Discover",,U,,02/09/2017,"Stan Winston School","Education : College","Education","College","",$0.00,$215.40,-$4753.82
"Discover",,U,,02/09/2017,"Marathon","Transportation : Gas","Transportation","Gas","",$6.75,$0.00,-$4760.57
"Discover",,U,,02/09/2017,"Camping world","RV : Equipment/Supplies","RV","Equipment/Supplies","",$47.67,$0.00,-$4808.24
"Discover",,U,,02/09/2017,"Walmart","Food : Groceries","Food","Groceries","",$122.97,$0.00,-$4931.21
"Discover",,U,,02/09/2017,"Amazon","RV : Equipment/Supplies","RV","Equipment/Supplies","DROP HITCH",$129.67,$0.00,-$5060.88
"Discover",,U,,02/10/2017,"7-eleven","Transportation : Gas","Transportation","Gas","",$19.89,$0.00,-$5080.77
"Discover",,U,,02/11/2017,"Amazon","Personal : nom-prescription medication","Personal","nom-prescription medication","Excema Creme",$37.54,$0.00,-$5118.31
"Discover",,U,,02/11/2017,"Bruno's Of Brooklyn Fort Myers","Food : Restaurants","Food","Restaurants","We enjoyed this place - but specials were Really Expensive",$133.00,$0.00,-$5251.31
"Discover",,U,,02/12/2017,"Walmart","Food : Groceries","Food","Groceries","",$0.00,$10.57,-$5240.74
"Discover",,U,,02/12/2017,"redbox","Recreation : Entertainment","Recreation","Entertainment","",$1.59,$0.00,-$5242.33
"Discover",,U,,02/12/2017,"Edison Ford Summer Homes","Recreation : Entertainment","Recreation","Entertainment","Bought Faimily Pass with reciprical benefits",$40.00,$0.00,-$5282.33
"Discover",,U,,02/12/2017,"publix","Food : Groceries","Food","Groceries","",$44.55,$0.00,-$5326.88
"Discover",,U,,02/12/2017,"Edison Ford Summer Homes","Recreation : Entertainment","Recreation","Entertainment","",$45.00,$0.00,-$5371.88
"Discover",,U,,02/12/2017,"Walmart","Food : Groceries","Food","Groceries","",$76.61,$0.00,-$5448.49
"Discover",,U,,02/13/2017,"Walmart","Food : Groceries","Food","Groceries","",$0.00,$5.75,-$5442.74
"Discover",,U,,02/13/2017,"redbox","Recreation : Entertainment","Recreation","Entertainment","",$1.59,$0.00,-$5444.33
"Discover",,U,,02/13/2017,"Mango Bay beach & Surf","Personal : cloths","Personal","cloths","hat",$10.59,$0.00,-$5454.92
"Discover",,U,,02/13/2017,"kilwins FT myers Beach","Personal : cloths","Personal","cloths","",$12.88,$0.00,-$5467.80
"Discover",,U,,02/13/2017,"publix","Food : Groceries","Food","Groceries","",$22.40,$0.00,-$5490.20
"Discover",,U,,02/13/2017,"Wilder Fort Myers","RV : Campgrounds","RV","Campgrounds","",$350.00,$0.00,-$5840.20
"Discover",,U,,02/14/2017,"redbox","Recreation : Entertainment","Recreation","Entertainment","",$1.59,$0.00,-$5841.79
"Discover",,U,,02/14/2017,"echo","Recreation : Entertainment","Recreation","Entertainment","Echo - teaches people how to do sustainable farming in poor areas of the world",$36.02,$0.00,-$5877.81
"Discover",,U,,02/14/2017,"carrabbas","Food : Restaurants","Food","Restaurants","Valentines Dinner",$72.31,$0.00,-$5950.12
"Discover",,U,,02/15/2017,"publix","Food : Groceries","Food","Groceries","",$17.94,$0.00,-$5968.06
"Discover",,U,,02/15/2017,"echo","Personal : cloths","Personal","cloths","t-shirts",$24.99,$0.00,-$5993.05
"Discover",,U,,02/17/2017,"redbox","Recreation : Entertainment","Recreation","Entertainment","",$1.59,$0.00,-$5994.64
"Discover",,U,,02/17/2017,"Exxon mobile","Transportation : Gas","Transportation","Gas","",$18.89,$0.00,-$6013.53
"Discover",,U,,02/18/2017,"cvs","Personal : Prescriptions, Medicine","Personal","Prescriptions, Medicine","",$13.77,$0.00,-$6027.30
"Discover",,U,,02/18/2017,"Sunny's","Food : Restaurants","Food","Restaurants","Good Local Breakfast place",$23.06,$0.00,-$6050.36
"Discover",,U,,02/18/2017,"SUn Pass","RV : Tolls","RV","Tolls","",$25.00,$0.00,-$6075.36
"Discover",,U,,02/18/2017,"publix","Food : Groceries","Food","Groceries","",$68.51,$0.00,-$6143.87
"Discover",,U,,02/19/2017,"redbox","Recreation : Entertainment","Recreation","Entertainment","",$1.59,$0.00,-$6145.46
"Discover",,U,,02/19/2017,"Farmers Market Restaurant","Food : Restaurants","Food","Restaurants","Southern Style food Country Fried Steak - and 4 different sides - a lot of food",$46.51,$0.00,-$6191.97
"Discover",,U,,02/20/2017,"alico liquor","Food : Groceries","Food","Groceries","",$31.79,$0.00,-$6223.76
"Discover",,U,,02/20/2017,"publix","Food : Groceries","Food","Groceries","",$42.39,$0.00,-$6266.15
"Discover",,U,,02/21/2017,"Walmart","RV : Equipment/Supplies","RV","Equipment/Supplies","",$8.55,$0.00,-$6274.70
"Discover",,U,,02/21/2017,"Mix Grill","Food : Restaurants","Food","Restaurants","",$26.80,$0.00,-$6301.50
"Discover",,U,,02/22/2017,"itunes","Recreation : Entertainment","Recreation","Entertainment","",$0.99,$0.00,-$6302.49
"Discover",,U,,02/23/2017,"Savannas Recreation Fort Pierce","RV : Campgrounds","RV","Campgrounds","Fl County Park - Very nice - kayaked here - would stay again can stay for months",$56.30,$0.00,-$6358.79
"Discover",,U,,02/23/2017,"Southwest Airlines","Recreation : Vacation","Recreation","Vacation","Alyssa Spring break",$412.88,$0.00,-$6771.67
"Discover",,U,,02/25/2017,"Savannas Recreation Fort Pierce","RV : Campgrounds","RV","Campgrounds","1400 E Midway Rd, Fort Pierce, FL 34982",$56.30,$0.00,-$6827.97
"Discover",,U,,02/26/2017,"google storage","business (bob) : computer","Hidden Categories","business (bob) ` computer","",$1.99,$0.00,-$6829.96
"Discover",,U,,02/26/2017,"7-eleven","Transportation : Gas","Transportation","Gas","",$17.37,$0.00,-$6847.33
"Discover",,U,,02/26/2017,"State Parks Reservations","RV : Campgrounds","RV","Campgrounds","Reservation fee for stay at Bayou Segnette State park in New New Orleans",$26.00,$0.00,-$6873.33
"Discover",,U,,02/26/2017,"Adventure Seafood","Food : Groceries","Food","Groceries","Really nice people who had nice fish market - BUT REALLY EXPENSIVE",$48.88,$0.00,-$6922.21
"Discover",,U,,02/28/2017,"Ace hardware","RV : Equipment/Supplies","RV","Equipment/Supplies","Cooking propane",$7.48,$0.00,-$6929.69
"Discover",,U,,02/28/2017,"publix","Food : Groceries","Food","Groceries","",$14.02,$0.00,-$6943.71
"Discover",,U,,02/28/2017,"Aldi","Food : Groceries","Food","Groceries","",$25.37,$0.00,-$6969.08
"Discover",,U,,02/28/2017,"Thrify Spec Products Melbourne","Food : Groceries","Food","Groceries","Cool store new Satelite beach - BAD EGGS",$65.65,$0.00,-$7034.73
"Discover",,U,,03/01/2017,"dunkin donuts","Food : Restaurants","Food","Restaurants","",$10.09,$0.00,-$7044.82
"Discover",,U,,03/01/2017,"Tree of Life","Food : Restaurants","Food","Restaurants","HUGE CUBAN SANDWICHES",$26.47,$0.00,-$7071.29
"Discover",,U,,03/02/2017,"Dotties Restaurant Palm Bay","Food : Restaurants","Food","Restaurants","While waiting for Palm Bay ford to look at rig - which they didn't",$17.12,$0.00,-$7088.41
"Discover",,U,,03/02/2017,"Nicky Ds Pizza","Food : Restaurants","Food","Restaurants","Take out with Patricia",$47.78,$0.00,-$7136.19
"Discover",,U,,03/02/2017,"Sunoco","RV : gasoline","RV","gasoline","",$100.00,$0.00,-$7236.19
"Discover",,U,,03/02/2017,"Old Mill Stream RV Park","RV : Campgrounds","RV","Campgrounds","Near Patricia",$129.00,$0.00,-$7365.19
"Discover",,U,,03/03/2017,"All Alex GTH","Recreation : Entertainment","Recreation","Entertainment","",$11.00,$0.00,-$7376.19
"Discover",,U,,03/04/2017,"Sunoco","Transportation : Gas","Transportation","Gas","",$17.36,$0.00,-$7393.55
"Discover",,U,,03/04/2017,"Amazon","Lisa Business : Misc","Lisa Business","Misc","amazon membership",$49.00,$0.00,-$7442.55
"Discover",,U,,03/04/2017,"Applebees","Food : Restaurants","Food","Restaurants","WIth Jenny and Todd",$53.90,$0.00,-$7496.45
"Discover",,U,,03/05/2017,"pho noodles","Food : Restaurants","Food","Restaurants","",$36.49,$0.00,-$7532.94
"Discover",,U,,03/05/2017,"Walmart","RV : Equipment/Supplies","RV","Equipment/Supplies","",$65.01,$0.00,-$7597.95
"Discover",,U,,03/05/2017,"Exxon mobile","RV : gasoline","RV","gasoline","",$100.00,$0.00,-$7697.95
"Discover",,U,,03/06/2017,"redbox","Recreation : Entertainment","Recreation","Entertainment","",$1.61,$0.00,-$7699.56
"Discover",,U,,03/06/2017,"Walmart","Food : Groceries","Food","Groceries","",$19.64,$0.00,-$7719.20
"Discover",,U,,03/06/2017,"avalon Landing RB Park Milton","RV : Campgrounds","RV","Campgrounds","",$189.50,$0.00,-$7908.70
"Discover",,U,,03/07/2017,"Transfer : Dcu Checking",,,,"",$0.00,$5251.31,-$2657.39
"Discover",,U,,03/07/2017,"redbox","Recreation : Entertainment","Recreation","Entertainment","",$1.61,$0.00,-$2659.00
"Discover",,U,,03/08/2017,"redbox","Recreation : Entertainment","Recreation","Entertainment","",$1.61,$0.00,-$2660.61
"Discover",,U,,03/08/2017,"Walmart","Food : Groceries","Food","Groceries","(Split 1/2) ",$80.00,$0.00,-$2779.98
"Discover",,U,,03/08/2017,"Walmart","Housing : Supplies","Hidden Categories","Housing ` Supplies","(Split 2/2) ",$39.37,$0.00,-$2779.98
"Discover",,U,,03/09/2017,"Gulf Orange Beach Fl","Food : Restaurants","Food","Restaurants","",$13.31,$0.00,-$2793.29
"Discover",,U,,03/09/2017,"Shell","Transportation : Gas","Transportation","Gas","",$18.56,$0.00,-$2811.85
"Discover",,U,,03/09/2017,"Myfloweres","Personal : Gifts","Personal","Gifts","Flowers for rose",$51.03,$0.00,-$2862.88
"Discover",,U,,03/10/2017,"redbox","Recreation : Entertainment","Recreation","Entertainment","",$1.65,$0.00,-$2864.53
"Discover",,U,,03/10/2017,"winn-dixie","Food : Groceries","Food","Groceries","",$55.48,$0.00,-$2920.01
"Discover",,U,,03/10/2017,"raceway","RV : gasoline","RV","gasoline","",$99.00,$0.00,-$3019.01
"Discover",,U,,03/11/2017,"redbox","Recreation : Entertainment","Recreation","Entertainment","",$1.65,$0.00,-$3020.66
"Discover",,U,,03/11/2017,"bellingrath Gardens","Recreation : Entertainment","Recreation","Entertainment","",$26.00,$0.00,-$3046.66
"Discover",,U,,03/11/2017,"Amazon","Lisa Business : Business expenses","Lisa Business","Business expenses","TURbotax",$69.00,$0.00,-$3115.66
"Discover",,U,,03/12/2017,"Blind Mule","Food : Restaurants","Food","Restaurants","Super friendly waitress wants to own the place",$77.40,$0.00,-$3193.06
"Discover",,U,,03/14/2017,"SW Air Dallas","Recreation : Vacation","Recreation","Vacation","New Orleans - alyssa cancelled weather",$0.00,$412.88,-$2780.18
"Discover",,U,,03/14/2017,"cvs","Personal : Prescriptions, Medicine","Personal","Prescriptions, Medicine","",$26.57,$0.00,-$2806.75
"Discover",,U,,03/14/2017,"piggy wigly","Food : Groceries","Food","Groceries","",$37.41,$0.00,-$2844.16
"Discover",,U,,03/14/2017,"Start Parks Reservation","RV : Campgrounds","RV","Campgrounds","",$260.00,$0.00,-$3104.16
"Discover",,U,,03/15/2017,"Rays","Food : Restaurants","Food","Restaurants","New Orleans - NON-tourist whole in the wal restaurant in New Orleans",$25.08,$0.00,-$3129.24
"Discover",,U,,03/16/2017,"Amazon","Education : College","Education","College","Art Supplies",$21.78,$0.00,-$3151.02
"Discover",,U,,03/16/2017,"cvs","Personal : Prescriptions, Medicine","Personal","Prescriptions, Medicine","",$56.16,$0.00,-$3207.18
"Discover",,U,,03/16/2017,"Walmart","Food : Groceries","Food","Groceries","(Split 1/2) ",$70.00,$0.00,-$3334.06
"Discover",,U,,03/16/2017,"Walmart","RV : Equipment/Supplies","RV","Equipment/Supplies","(Split 2/2) ",$56.88,$0.00,-$3334.06
"Discover",,U,,03/17/2017,"Exxon mobile","Transportation : Gas","Transportation","Gas","",$15.90,$0.00,-$3349.96
"Discover",,U,,03/17/2017,"Save the children","Charity : Other","Charity","Other","Hunger relief",$50.00,$0.00,-$3399.96
"Discover",,U,,03/17/2017,"Dry Dock Cafe","Food : Restaurants","Food","Restaurants","Restaurant near Ferry to new orleans - Crawfish and Pasta YUMMM",$59.95,$0.00,-$3459.91
"Discover",,U,,03/18/2017,"itunes","Recreation : Entertainment","Recreation","Entertainment","",$0.99,$0.00,-$3460.90
"Discover",,U,,03/18/2017,"winn-dixie","RV : Equipment/Supplies","RV","Equipment/Supplies","Distilled water",$1.09,$0.00,-$3461.99
"Discover",,U,,03/18/2017,"redbox","Recreation : Entertainment","Recreation","Entertainment","",$1.65,$0.00,-$3463.64
"Discover",,U,,03/19/2017,"redbox","Recreation : Entertainment","Recreation","Entertainment","",$1.65,$0.00,-$3465.29
"Discover",,U,,03/19/2017,"winn-dixie","Food : Groceries","Food","Groceries","",$10.91,$0.00,-$3476.20
"Discover",,U,,03/19/2017,"city park Gift Shop","Personal : Gifts","Personal","Gifts","",$12.00,$0.00,-$3488.20
"Discover",,U,,03/20/2017,"Maison New Orleans","Food : Restaurants","Food","Restaurants","",$50.00,$0.00,-$3538.20
"Discover",,U,,03/21/2017,"cvs","Personal : Prescriptions, Medicine","Personal","Prescriptions, Medicine","",$18.04,$0.00,-$3556.24
"Discover",,U,,03/21/2017,"SQ cocoally","Personal : cloths","Personal","cloths","Alyssa Shirt",$33.02,$0.00,-$3589.26
"Discover",,U,,03/22/2017,"sani-star RV DUMP","RV : Campgrounds","RV","Campgrounds","",$5.00,$0.00,-$3594.26
"Discover",,U,,03/22/2017,"winn-dixie","Food : Groceries","Food","Groceries","",$64.11,$0.00,-$3658.37
"Discover",,U,,03/23/2017,"ENILWORHT FUEL","Transportation : Gas","Transportation","Gas","",$16.85,$0.00,-$3675.22
"Discover",,U,,03/23/2017,"","Education : College","Education","College","",$20.49,$0.00,-$3695.71
"Discover",,U,,03/23/2017,"THE MARKET CAFE","Food : Restaurants","Food","Restaurants","WITH MARTA",$30.53,$0.00,-$3726.24
"Discover",,U,,03/23/2017,"EAT NEW ORLEANS","Food : Restaurants","Food","Restaurants","WITH MARTA",$105.80,$0.00,-$3832.04
"Discover",,U,,03/24/2017,"Sipirt Wine","Food : Restaurants","Food","Restaurants","WIne with Merna and Brian",$20.87,$0.00,-$3852.91
"Discover",,U,,03/24/2017,"Blossom Florist","Personal : Gifts","Personal","Gifts","Flowers from mom",$59.79,$0.00,-$3912.70
"Discover",,U,,03/24/2017,"Abyssinia","Food : Restaurants","Food","Restaurants","Ethopian food with Merna and Brian",$82.67,$0.00,-$3995.37
"Discover",,U,,03/25/2017,"Clark 3843","Transportation : Gas","Transportation","Gas","",$17.99,$0.00,-$4013.36
"Discover",,U,,03/26/2017,"segnette Bayou","RV : Campgrounds","RV","Campgrounds","",$0.00,$20.00,-$3993.36
"Discover",,U,,03/26/2017,"google storage","business (bob) : computer","Hidden Categories","business (bob) ` computer","",$1.99,$0.00,-$3995.35
"Discover",,U,,03/26/2017,"segnette Bayou","RV : Campgrounds","RV","Campgrounds","Had to pay again thanks to DIXIE RV",$40.65,$0.00,-$4036.00
"Discover",,U,,03/26/2017,"Walmart","Food : Groceries","Food","Groceries","",$66.34,$0.00,-$4102.34
"Discover",,U,,03/26/2017,"Love's","RV : gasoline","RV","gasoline","",$98.34,$0.00,-$4200.68
"Discover",,U,,03/27/2017,"parking","Transportation : Parking","Transportation","Parking","",$4.00,$0.00,-$4204.68
"Discover",,U,,03/27/2017,"Holiday Travel Park","RV : Campgrounds","RV","Campgrounds","",$38.70,$0.00,-$4243.38
"Discover",,U,,03/27/2017,"Ruby Falls","Recreation : Entertainment","Recreation","Entertainment","",$43.59,$0.00,-$4286.97
"Discover",,U,,03/27/2017,"Sweet Water Forest Campground","RV : Campgrounds","RV","Campgrounds","",$80.00,$0.00,-$4366.97
"Discover",,U,,03/27/2017,"Murphys","RV : gasoline","RV","gasoline","",$86.33,$0.00,-$4453.30
"Discover",,U,,03/27/2017,"Alleia Restaurant","Food : Restaurants","Food","Restaurants","",$95.00,$0.00,-$4548.30
"Discover",,U,,03/28/2017,"redbox","Recreation : Entertainment","Recreation","Entertainment","",$1.59,$0.00,-$4549.89
"Discover",,U,,03/28/2017,"Famous ANthonys","Food : Restaurants","Food","Restaurants","",$21.93,$0.00,-$4571.82
"Discover",,U,,03/28/2017,"DSCC","Personal : Gifts","Personal","Gifts","politics",$25.00,$0.00,-$4596.82
"Discover",,U,,03/28/2017,"Shannadoah Supermarket","Food : Groceries","Food","Groceries","",$46.44,$0.00,-$4643.26
"Discover",,U,,03/28/2017,"Marathon","RV : gasoline","RV","gasoline","",$66.69,$0.00,-$4709.95
"Discover",,U,,03/29/2017,"Shennadoah supermarket","Food : Groceries","Food","Groceries","",$5.27,$0.00,-$4715.22
"Discover",,U,,03/29/2017,"Exxon mobile","Transportation : Gas","Transportation","Gas","",$10.39,$0.00,-$4725.61
"Discover",,U,,03/29/2017,"Amazon","RV : Equipment/Supplies","RV","Equipment/Supplies","",$18.66,$0.00,-$4744.27
"Discover",,U,,03/29/2017,"Food lion","Food : Groceries","Food","Groceries","",$28.10,$0.00,-$4772.37
"Discover",,U,,03/29/2017,"SMileys Fuel","RV : gasoline","RV","gasoline","",$50.00,$0.00,-$4822.37
"Discover",,U,,03/29/2017,"AMazon Surge protector","RV : Equipment/Supplies","RV","Equipment/Supplies","",$355.00,$0.00,-$5177.37
"Discover",,U,,03/30/2017,"Allentown Rest","Food : Restaurants","Food","Restaurants","",$1.50,$0.00,-$5178.87
"Discover",,U,,03/30/2017,"Amazon","RV : Equipment/Supplies","RV","Equipment/Supplies","",$28.41,$0.00,-$5207.28
"Discover",,U,,03/30/2017,"Blaze Pizza","Food : Restaurants","Food","Restaurants","",$40.68,$0.00,-$5247.96
"Discover",,U,,03/30/2017,"Amazon","RV : Equipment/Supplies","RV","Equipment/Supplies","",$45.50,$0.00,-$5293.46
"Discover",,U,,03/30/2017,"Pilot","RV : gasoline","RV","gasoline","",$75.00,$0.00,-$5368.46
"Discover",,U,,03/30/2017,"BP","RV : gasoline","RV","gasoline","",$100.00,$0.00,-$5468.46
"Discover",,U,,03/31/2017,"AC MOORE","Education : College","Education","College","Art supplies",$34.00,$0.00,-$5502.46
"Discover",,U,,03/31/2017,"Bertucci","Food : Restaurants","Food","Restaurants","",$94.43,$0.00,-$5596.89
"Discover",,U,,04/01/2017,"Mansfield Movie","Recreation : Entertainment","Recreation","Entertainment","",$17.25,$0.00,-$5614.14
"Discover",,U,,04/01/2017,"Mansfield Movie","Recreation : Entertainment","Recreation","Entertainment","",$37.50,$0.00,-$5651.64
"Discover",,U,,04/01/2017,"Walmart","Food : Groceries","Food","Groceries","",$82.49,$0.00,-$5734.13
"Discover",,U,,04/01/2017,"Uconn Danial Hale","RV : Hotel","RV","Hotel","ICY conditions didn't want to drive",$251.85,$0.00,-$5985.98
"Discover",,U,,04/02/2017,"Sweet Water Forest Campground","RV : Campgrounds","RV","Campgrounds","",$21.00,$0.00,-$6006.98
"Discover",,U,,04/02/2017,"Sweet Water Forest Campground","RV : Campgrounds","RV","Campgrounds","",$235.00,$0.00,-$6241.98
"Discover",,U,,04/03/2017,"Amazon","RV : Equipment/Supplies","RV","Equipment/Supplies","",$17.41,$0.00,-$6259.39
"Discover",,U,,04/03/2017,"peterson market dennis","Food : Groceries","Food","Groceries","",$19.29,$0.00,-$6278.68
"Discover",,U,,04/03/2017,"peterson market dennis","Food : Groceries","Food","Groceries","",$25.82,$0.00,-$6304.50
"Discover",,U,,04/04/2017,"Capecod Farms","Transportation : Gas","Transportation","Gas","",$20.95,$0.00,-$6325.45
"Discover",,U,,04/05/2017,"peterson market dennis","Food : Groceries","Food","Groceries","",$8.81,$0.00,-$6334.26
"Discover",,U,,04/05/2017,"Amazon MktPlace","RV : Equipment/Supplies","RV","Equipment/Supplies","??",$30.36,$0.00,-$6364.62
"Discover",,U,,04/05/2017,"dennis public market","Food : Groceries","Food","Groceries","",$31.82,$0.00,-$6396.44
"Discover",,U,,04/05/2017,"Cape cod trunk","RV : Maintenance","RV","Maintenance","",$240.74,$0.00,-$6637.18
"Discover",,U,,04/06/2017,"Transfer : Dcu Checking",,,,"",$0.00,$3193.06,-$3444.12
"Discover",,U,,04/06/2017,"minuteman campground","RV : Campgrounds","RV","Campgrounds","",$56.00,$0.00,-$3500.12
"Discover",,U,,04/06/2017,"stop & shop","Food : Groceries","Food","Groceries","",$66.21,$0.00,-$3566.33
"Discover",,U,,04/07/2017,"intuit","Personal : Miscellaneous","Personal","Miscellaneous","Tax electronic filing",$24.99,$0.00,-$3591.32
"Discover",,U,,04/07/2017,"autocare","Transportation : Repairs & Maintenance","Transportation","Repairs & Maintenance","",$35.00,$0.00,-$3626.32
"Discover",,U,,04/07/2017,"monroe motors","Transportation : Repairs & Maintenance","Transportation","Repairs & Maintenance","ASK LISA WHY 2?",$35.00,$0.00,-$3661.32
"Discover",,U,,04/07/2017,"Marshside East","Food : Restaurants","Food","Restaurants","",$99.73,$0.00,-$3761.05
"Discover",,U,,04/07/2017,"stop & shop","Food : Groceries","Food","Groceries","",$135.37,$0.00,-$3896.42
"Discover",,U,,04/08/2017,"USPS","RV : Equipment/Supplies","RV","Equipment/Supplies","",$9.39,$0.00,-$3905.81
"Discover",,U,,04/09/2017,"redbox","Recreation : Entertainment","Recreation","Entertainment","",$1.60,$0.00,-$3907.41
"Discover",,U,,04/09/2017,"ZLotnick gas","Transportation : Gas","Transportation","Gas","",$15.00,$0.00,-$3922.41
"Discover",,U,,04/09/2017,"Sweet Water Forest Campground","RV : Campgrounds","RV","Campgrounds","",$40.00,$0.00,-$3962.41
"Discover",,U,,04/09/2017,"Sweet Water Forest Campground","RV : Campgrounds","RV","Campgrounds","",$80.00,$0.00,-$4042.41
"Discover",,U,,04/09/2017,"Exxon mobile","RV : gasoline","RV","gasoline","",$100.00,$0.00,-$4142.41
"Discover",,U,,04/09/2017,"Walmart","Food : Groceries","Food","Groceries","",$102.94,$0.00,-$4245.35
"Discover",,U,,04/11/2017,"Rose Mattei","Personal : Gifts","Personal","Gifts","",$50.00,$0.00,-$4295.35
"Discover",,U,,04/12/2017,"Shell Store","Food : Restaurants","Food","Restaurants","",$6.29,$0.00,-$4301.64
"Discover",,U,,04/12/2017,"Shell","Transportation : Gas","Transportation","Gas","",$17.17,$0.00,-$4318.81
"Discover",,U,,04/12/2017,"Maharaja Indian","Food : Restaurants","Food","Restaurants","",$47.31,$0.00,-$4366.12
"Discover",,U,,04/12/2017,"Texax bbq","Food : Restaurants","Food","Restaurants","",$78.25,$0.00,-$4444.37
"Discover",,U,,04/12/2017,"Rose Mattei","Personal : Gifts","Personal","Gifts","",$100.00,$0.00,-$4544.37
"Discover",,U,,04/12/2017,"Micheals","Education : College","Education","College","Art Supplies",$112.51,$0.00,-$4656.88
"Discover",,U,,04/13/2017,"Walmart","Food : Groceries","Food","Groceries","",$82.06,$0.00,-$4738.94
"Discover",,U,,04/13/2017,"Willimantic Brewing","Food : Restaurants","Food","Restaurants","",$270.07,$0.00,-$5009.01
"Discover",,U,,04/14/2017,"Walmart","RV : Equipment/Supplies","RV","Equipment/Supplies","(Split 1/2) Screen Room",$80.00,$0.00,-$5178.91
"Discover",,U,,04/14/2017,"Walmart","Food : Groceries","Food","Groceries","(Split 2/2) Screen Room",$89.90,$0.00,-$5178.91
"Discover",,U,,04/15/2017,"peterson market dennis","Food : Groceries","Food","Groceries","",$28.68,$0.00,-$5207.59
"Discover",,U,,04/16/2017,"Caple Cod farms","Transportation : Gas","Transportation","Gas","",$21.60,$0.00,-$5229.19
"Discover",,U,,04/17/2017,"Walmart","Food : Groceries","Food","Groceries","",$34.06,$0.00,-$5263.25
"Discover",,U,,04/18/2017,"town of brookline","Transportation : Parking","Transportation","Parking",,$2.50,$0.00,-$5265.75
"Discover",,U,,04/18/2017,"LAZ Parking","Transportation : Parking","Transportation","Parking","",$2.99,$0.00,-$5268.74
"Discover",,U,,04/18/2017,"gulf mart","Transportation : Gas","Transportation","Gas","",$14.90,$0.00,-$5283.64
"Discover",,U,,04/18/2017,"stop & shop","Food : Groceries","Food","Groceries","",$161.18,$0.00,-$5444.82
"Discover",,U,,04/19/2017,"St James School","Personal : Miscellaneous","Personal","Miscellaneous","books",$14.75,$0.00,-$5459.57
"Discover",,U,,04/19/2017,"Ganko Brookline","Food : Restaurants","Food","Restaurants","Robert Near Karina",$16.91,$0.00,-$5476.48
"Discover",,U,,04/19/2017,"Wireless zone","RV : Equipment/Supplies","RV","Equipment/Supplies","Stuff for lisa's phone",$26.55,$0.00,-$5503.03
"Discover",,U,,04/19/2017,"Wireless zone","RV : Equipment/Supplies","RV","Equipment/Supplies","Stuff for lIsa's phone",$26.55,$0.00,-$5529.58
"Discover",,U,,04/19/2017,"shoe dpt encore","Personal : cloths","Personal","cloths","",$44.98,$0.00,-$5574.56
"Discover",,U,,04/20/2017,"pain D'avignon","Food : Restaurants","Food","Restaurants","",$18.74,$0.00,-$5593.30
"Discover",,U,,04/20/2017,"Exxon mobile","Transportation : Gas","Transportation","Gas","",$22.61,$0.00,-$5615.91
"Discover",,U,,04/20/2017,"target","Food : Groceries","Food","Groceries","",$41.55,$0.00,-$5657.46
"Discover",,U,,04/20/2017,"Peppertree","RV : Campgrounds","RV","Campgrounds","",$550.00,$0.00,-$6207.46
"Discover",,U,,04/20/2017,"Marlboro dental","Personal : Doctor, Dentist","Personal","Doctor, Dentist","",$869.00,$0.00,-$7076.46
"Discover",,U,,04/21/2017,"Genos","Food : Restaurants","Food","Restaurants","",$56.33,$0.00,-$7132.79
"Discover",,U,,04/22/2017,"Cost Plus","Personal : Gifts","Personal","Gifts","Hung Journal",$5.77,$0.00,-$7138.56
"Discover",,U,,04/22/2017,"trader Joes","Food : Groceries","Food","Groceries","",$30.64,$0.00,-$7169.20
"Discover",,U,,04/22/2017,"Christmas Tree Shop","RV : Equipment/Supplies","RV","Equipment/Supplies","Party goods for grad party",$119.19,$0.00,-$7288.39
"Discover",,U,,04/23/2017,"speedway","Transportation : Gas","Transportation","Gas","",$19.70,$0.00,-$7308.09
"Discover",,U,,04/24/2017,"Price Chopper","Food : Groceries","Food","Groceries","",$102.25,$0.00,-$7410.34
"Discover",,U,,04/25/2017,"shutter fly","Personal : Miscellaneous","Personal","Miscellaneous","Alyssa Yearbook",$12.21,$0.00,-$7422.55
"Discover",,U,,04/25/2017,"Walmart","Food : Groceries","Food","Groceries","",$166.64,$0.00,-$7589.19
"Discover",,U,,04/26/2017,"google storage","business (bob) : computer","Hidden Categories","business (bob) ` computer","",$1.99,$0.00,-$7591.18
"Discover",,U,,04/26/2017,"Walmart","RV : Equipment/Supplies","RV","Equipment/Supplies","Screen Room",$168.16,$0.00,-$7759.34
"Discover",,U,,04/27/2017,"target","Food : Groceries","Food","Groceries","",$6.96,$0.00,-$7766.30
"Discover",,U,,04/27/2017,"Exxon mobile","Transportation : Gas","Transportation","Gas","",$20.12,$0.00,-$7786.42
"Discover",,U,,04/27/2017,"Price Chopper","Food : Groceries","Food","Groceries","",$60.46,$0.00,-$7846.88
"Discover",,U,,04/27/2017,"A1 auto","Transportation : Repairs & Maintenance","Transportation","Repairs & Maintenance","New Tires",$540.91,$0.00,-$8387.79
"Discover",,U,,04/28/2017,"redbox","Recreation : Entertainment","Recreation","Entertainment","",$1.60,$0.00,-$8389.39
"Discover",,U,,04/29/2017,"Walmart","Food : Groceries","Food","Groceries","",$53.61,$0.00,-$8443.00
"Discover",,U,,05/01/2017,"redbox","Recreation : Entertainment","Recreation","Entertainment","",$1.59,$0.00,-$8444.59
"Discover",,U,,05/01/2017,"speedway","Transportation : Gas","Transportation","Gas","",$21.28,$0.00,-$8465.87
"Discover",,U,,05/01/2017,"Walmart","Food : Groceries","Food","Groceries","",$23.86,$0.00,-$8489.73
"Discover",,U,,05/02/2017,"Logan Parking","Transportation : Parking","Transportation","Parking","",$3.00,$0.00,-$8492.73
"Discover",,U,,05/02/2017,"Cumberland Farms","Transportation : Gas","Transportation","Gas","",$21.35,$0.00,-$8514.08
"Discover",,U,,05/02/2017,"Dr Kofos","Personal : Doctor, Dentist","Personal","Doctor, Dentist",,$85.00,$0.00,-$8599.08
"Discover",,U,,05/02/2017,"Chucks Margarita Grill","Food : Restaurants","Food","Restaurants","Lisa, Alyssa, Chelsea, Chelseas friend, Isabel",$188.97,$0.00,-$8788.05
"Discover",,U,,05/03/2017,"Micheals","Education : College","Education","College","",$0.00,$55.89,-$8732.16
"Discover",,U,,05/03/2017,"Papa Gino's","Food : Restaurants","Food","Restaurants","",$5.93,$0.00,-$8738.09
"Discover",,U,,05/03/2017,"Mansfield Movie","Recreation : Entertainment","Recreation","Entertainment",,$17.50,$0.00,-$8755.59
"Discover",,U,,05/03/2017,"Micheals","Education : College","Education","College","",$29.58,$0.00,-$8785.17
"Discover",,U,,05/03/2017,"savvy","Personal : cloths","Personal","cloths","",$31.64,$0.00,-$8816.81
"Discover",,U,,05/03/2017,"Amazon","Recreation : Alyssa Horse","Recreation","Alyssa Horse","",$32.50,$0.00,-$8849.31
"Discover",,U,,05/04/2017,"redbox","Recreation : Entertainment","Recreation","Entertainment","",$1.60,$0.00,-$8850.91
"Discover",,U,,05/04/2017,"Walmart","RV : Equipment/Supplies","RV","Equipment/Supplies","",$259.12,$0.00,-$9110.03
"Discover",,U,,05/05/2017,"Moe's","Food : Restaurants","Food","Restaurants","",$11.68,$0.00,-$9121.71
"Discover",,U,,05/05/2017,"Midway Restaurant","Food : Restaurants","Food","Restaurants","Alyssa Party",$51.15,$0.00,-$9172.86
"Discover",,U,,05/05/2017,"spirit shop","Food : Groceries","Food","Groceries","Liquor for ALyssa Party",$58.14,$0.00,-$9231.00
"Discover",,U,,05/06/2017,"Stix and Stones","Personal : Gifts","Personal","Gifts","Alyssa Flowers",$16.96,$0.00,-$9247.96
"Discover",,U,,05/06/2017,"Cumberland Farms","Transportation : Gas","Transportation","Gas","",$21.07,$0.00,-$9269.03
"Discover",,U,,05/06/2017,"Hilltop Restaurant","Food : Restaurants","Food","Restaurants","Alyssa Party",$423.66,$0.00,-$9692.69
"Discover",,U,,05/07/2017,"redbox","Recreation : Entertainment","Recreation","Entertainment","",$1.60,$0.00,-$9694.29
"Discover",,U,,05/07/2017,"dunkin donuts","Food : Restaurants","Food","Restaurants","",$17.70,$0.00,-$9711.99
"Discover",,U,,05/07/2017,"marlboro wine & spirits","Food : Groceries","Food","Groceries","Alyssa Party",$49.36,$0.00,-$9761.35
"Discover",,U,,05/07/2017,"hannaford","Food : Groceries","Food","Groceries","",$179.22,$0.00,-$9940.57
"Discover",,U,,05/07/2017,"Plum tomatoe","Food : Restaurants","Food","Restaurants","Alyssa Party",$346.71,$0.00,-$10287.28
"Discover",,U,,05/08/2017,"Transfer : Dcu Checking",,,,"",$0.00,$4473.60,-$5813.68
"Discover",,U,,05/08/2017,"Walmart","RV : Equipment/Supplies","RV","Equipment/Supplies","",$0.00,$89.02,-$5724.66
"Discover",,U,,05/08/2017,"redbox","Recreation : Entertainment","Recreation","Entertainment","",$1.60,$0.00,-$5726.26
"Discover",,U,,05/08/2017,"cvs","Personal : Prescriptions, Medicine","Personal","Prescriptions, Medicine","",$11.62,$0.00,-$5737.88
"Discover",,U,,05/08/2017,"ZLotnick gas","Transportation : Gas","Transportation","Gas","",$19.44,$0.00,-$5757.32
"Discover",,U,,05/08/2017,"Walmart","RV : Equipment/Supplies","RV","Equipment/Supplies","",$24.29,$0.00,-$5781.61
"Discover",,U,,05/10/2017,"Gulf express","Transportation : Gas","Transportation","Gas","",$20.28,$0.00,-$5801.89
"Discover",,U,,05/10/2017,"SICHUAN GOURMENT","Food : Restaurants","Food","Restaurants","",$46.02,$0.00,-$5847.91
"Discover",,U,,05/11/2017,"redbox","Recreation : Entertainment","Recreation","Entertainment","",$1.60,$0.00,-$5849.51
"Discover",,U,,05/12/2017,"redbox","Recreation : Entertainment","Recreation","Entertainment","",$1.60,$0.00,-$5851.11
"Discover",,U,,05/12/2017,"Kathmunddo Kitchen","Food : Restaurants","Food","Restaurants","",$104.11,$0.00,-$5955.22
"Discover",,U,,05/13/2017,"Brueggers Bagel","Food : Restaurants","Food","Restaurants","",$12.30,$0.00,-$5967.52
"Discover",,U,,05/13/2017,"Gulf express","Transportation : Gas","Transportation","Gas","",$19.34,$0.00,-$5986.86
"Discover",,U,,05/13/2017,"Mike's Fruit","Food : Groceries","Food","Groceries","",$40.00,$0.00,-$6026.86
"Discover",,U,,05/13/2017,"Peppertree","RV : Campgrounds","RV","Campgrounds","",$94.50,$0.00,-$6121.36
"Discover",,U,,05/13/2017,"Exxon mobile","RV : gasoline","RV","gasoline","",$100.00,$0.00,-$6221.36
"Discover",,U,,05/13/2017,"minuteman campground","RV : Campgrounds","RV","Campgrounds","",$392.00,$0.00,-$6613.36
"Discover",,U,,05/14/2017,"dunkin donuts","Food : Restaurants","Food","Restaurants","",$3.09,$0.00,-$6616.45
"Discover",,U,,05/14/2017,"cvs","Personal : Prescriptions, Medicine","Personal","Prescriptions, Medicine","",$10.01,$0.00,-$6626.46
"Discover",,U,,05/14/2017,"speedway","Transportation : Gas","Transportation","Gas","",$12.20,$0.00,-$6638.66
"Discover",,U,,05/14/2017,"kmart","RV : Equipment/Supplies","RV","Equipment/Supplies","",$49.09,$0.00,-$6687.75
"Discover",,U,,05/14/2017,"corriander","Food : Restaurants","Food","Restaurants","",$50.00,$0.00,-$6737.75
"Discover",,U,,05/15/2017,"redbox","Recreation : Entertainment","Recreation","Entertainment","",$1.59,$0.00,-$6739.34
"Discover",,U,,05/15/2017,"kimballs","Food : Restaurants","Food","Restaurants","icecream",$15.57,$0.00,-$6754.91
"Discover",,U,,05/15/2017,"Market bskt","Food : Groceries","Food","Groceries","",$133.21,$0.00,-$6888.12
"Discover",,U,,05/16/2017,"verc enterprise","Food : Restaurants","Food","Restaurants","",$1.99,$0.00,-$6890.11
"Discover",,U,,05/16/2017,"minuteman campground","RV : Equipment/Supplies","RV","Equipment/Supplies","firewood",$5.25,$0.00,-$6895.36
"Discover",,U,,05/16/2017,"cafe fresh bagels","Food : Restaurants","Food","Restaurants","",$17.00,$0.00,-$6912.36
"Discover",,U,,05/16/2017,"verc enterprise","Transportation : Gas","Transportation","Gas","",$17.85,$0.00,-$6930.21
"Discover",,U,,05/17/2017,"itunes","Recreation : Entertainment","Recreation","Entertainment","",$0.99,$0.00,-$6931.20
"Discover",,U,,05/17/2017,"eps grad images","Education : College","Education","College","",$4.17,$0.00,-$6935.37
"Discover",,U,,05/17/2017,"stop & shop","Food : Groceries","Food","Groceries","",$53.29,$0.00,-$6988.66
"Discover",,U,,05/17/2017,"minuteman campground","RV : Campgrounds","RV","Campgrounds","",$224.00,$0.00,-$7212.66
"Discover",,U,,05/18/2017,"HST PHarmacy","Personal : Prescriptions, Medicine","Personal","Prescriptions, Medicine","ASK LISA",$25.00,$0.00,-$7237.66
"Discover",,U,,05/18/2017,"compass tavern","Food : Restaurants","Food","Restaurants","Deal and and Drinks",$26.00,$0.00,-$7263.66
"Discover",,U,,05/18/2017,"Walmart","RV : Equipment/Supplies","RV","Equipment/Supplies","",$75.47,$0.00,-$7339.13
"Discover",,U,,05/18/2017,"Childrends Dentistry","Personal : Doctor, Dentist","Personal","Doctor, Dentist","",$122.74,$0.00,-$7461.87
"Discover",,U,,05/18/2017,"Bocadas Tapas","Food : Restaurants","Food","Restaurants","ANN NEIL",$130.61,$0.00,-$7592.48
"Discover",,U,,05/19/2017,"Shell","Transportation : Gas","Transportation","Gas","",$15.64,$0.00,-$7608.12
"Discover",,U,,05/19/2017,"CLASSIQUE CONSIGNMENT","Personal : cloths","Personal","cloths","",$34.00,$0.00,-$7642.12
"Discover",,U,,05/19/2017,"Market bskt","Food : Groceries","Food","Groceries","",$57.37,$0.00,-$7699.49
"Discover",,U,,05/20/2017,"Price Chopper","Food : Groceries","Food","Groceries","",$20.96,$0.00,-$7720.45
"Discover",,U,,05/20/2017,"IYA Sushi and Noodle S. Hadley","Food : Restaurants","Food","Restaurants","",$45.95,$0.00,-$7766.40
"Discover",,U,,05/21/2017,"NEW ORIENTAL MARKET","Food : Groceries","Food","Groceries","",$12.47,$0.00,-$7778.87
"Discover",,U,,05/21/2017,"Market bskt","Food : Groceries","Food","Groceries","",$35.81,$0.00,-$7814.68
"Discover",,U,,05/22/2017,"redbox","Recreation : Entertainment","Recreation","Entertainment","",$1.59,$0.00,-$7816.27
"Discover",,U,,05/22/2017,"minuteman campground","RV : Campgrounds","RV","Campgrounds","",$4.77,$0.00,-$7821.04
"Discover",,U,,05/22/2017,"NEW ORIENTAL MARKET","Food : Groceries","Food","Groceries","",$8.48,$0.00,-$7829.52
"Discover",,U,,05/22/2017,"cvs","Personal : Prescriptions, Medicine","Personal","Prescriptions, Medicine","",$18.20,$0.00,-$7847.72
"Discover",,U,,05/23/2017,"starbucks","Food : Restaurants","Food","Restaurants","",$8.99,$0.00,-$7856.71
"Discover",,U,,05/23/2017,"Wegmans","Food : Groceries","Food","Groceries","",$12.83,$0.00,-$7869.54
"Discover",,U,,05/23/2017,"Shell","Transportation : Gas","Transportation","Gas","",$21.94,$0.00,-$7891.48
"Discover",,U,,05/23/2017,"SHOWCASE","Recreation : Entertainment","Recreation","Entertainment","",$25.50,$0.00,-$7916.98
"Discover",,U,,05/23/2017,"Childrends Dentistry","Personal : Doctor, Dentist","Personal","Doctor, Dentist","",$590.00,$0.00,-$8506.98
"Discover",,U,,05/24/2017,"kimballs","Food : Restaurants","Food","Restaurants","",$10.43,$0.00,-$8517.41
"Discover",,U,,05/24/2017,"Market bskt","Food : Groceries","Food","Groceries","",$41.51,$0.00,-$8558.92
"Discover",,U,,05/26/2017,"google storage","business (bob) : computer","Hidden Categories","business (bob) ` computer","",$1.99,$0.00,-$8560.91
"Discover",,U,,05/26/2017,"Hyannis country Garden","Housing : Garden","Hidden Categories","Housing ` Garden","",$27.93,$0.00,-$8588.84
"Discover",,U,,05/26/2017,"stop & shop","Food : Groceries","Food","Groceries","",$63.50,$0.00,-$8652.34
"Discover",,U,,05/26/2017,"barberas Bike","Recreation : His","Recreation","His","BIke and BIke supplies",$123.25,$0.00,-$8775.59
"Discover",,U,,05/27/2017,"trader Joes","Food : Groceries","Food","Groceries","",$6.35,$0.00,-$8781.94
"Discover",,U,,05/27/2017,"speedway","Transportation : Gas","Transportation","Gas","",$18.83,$0.00,-$8800.77
"Discover",,U,,05/27/2017,"Gerardos Cupcakes","Food : Groceries","Food","Groceries","Food for Hung Le Party",$19.99,$0.00,-$8820.76
"Discover",,U,,05/27/2017,"EMS","Personal : Gifts","Personal","Gifts","Gift for Hung",$31.82,$0.00,-$8852.58
"Discover",,U,,05/28/2017,"Benny's","RV : Equipment/Supplies","RV","Equipment/Supplies","Cleaning stuff",$16.98,$0.00,-$8869.56
"Discover",,U,,05/28/2017,"stop & shop","Food : Groceries","Food","Groceries","",$28.46,$0.00,-$8898.02
"Discover",,U,,05/28/2017,"Amazon","Recreation : Alyssa","Recreation","Alyssa","??",$32.98,$0.00,-$8931.00
"Discover",,U,,05/28/2017,"Achor hardware","RV : Equipment/Supplies","RV","Equipment/Supplies","cleaning stuff",$38.23,$0.00,-$8969.23
"Discover",,U,,05/28/2017,"Hart farm Nursery","Personal : Gifts","Personal","Gifts","GIFTS for mom?",$93.45,$0.00,-$9062.68
"Discover",,U,,05/29/2017,"Sweet Water Forest Campground","RV : Campgrounds","RV","Campgrounds","",$876.00,$0.00,-$9938.68
"Discover",,U,,05/30/2017,"redbox","Recreation : Entertainment","Recreation","Entertainment","",$1.59,$0.00,-$9940.27
"Discover",,U,,05/30/2017,"star harwich","Food : Groceries","Food","Groceries","",$202.38,$0.00,-$10142.65
"Discover",,U,,05/31/2017,"Shell","Transportation : Gas","Transportation","Gas","",$19.93,$0.00,-$10162.58
"Discover",,U,,05/31/2017,"stop & shop","Food : Groceries","Food","Groceries","",$21.24,$0.00,-$10183.82
"Discover",,U,,05/31/2017,"advanced autoparts","Transportation : Repairs & Maintenance","Transportation","Repairs & Maintenance","Headlights",$42.49,$0.00,-$10226.31
"Discover",,U,,06/01/2017,"cvs","Personal : Prescriptions, Medicine","Personal","Prescriptions, Medicine","",$0.00,$25.97,-$10200.34
"Discover",,U,,06/01/2017,"Amazon","Recreation : Alyssa","Recreation","Alyssa","",$0.00,$11.99,-$10188.35
"Discover",,U,,06/01/2017,"Entertainment Cinemas","Recreation : Entertainment","Recreation","Entertainment","",$8.75,$0.00,-$10197.10
"Discover",,U,,06/02/2017,"Beef Barn","Food : Restaurants","Food","Restaurants","With Mom and Dad",$50.80,$0.00,-$10247.90
"Discover",,U,,06/03/2017,"Harwich Home Improvment","RV : Equipment/Supplies","RV","Equipment/Supplies","",$6.56,$0.00,-$10254.46
"Discover",,U,,06/03/2017,"star market","Food : Groceries","Food","Groceries","",$72.97,$0.00,-$10327.43
"Discover",,U,,06/04/2017,"speedway","Transportation : Gas","Transportation","Gas","",$20.20,$0.00,-$10347.63
"Discover",,U,,06/04/2017,"trader Joes","Food : Groceries","Food","Groceries","",$51.77,$0.00,-$10399.40
"Discover",,U,,06/05/2017,"Ocean State Joblot","Food : Groceries","Food","Groceries","",$31.54,$0.00,-$10430.94
"Discover",,U,,06/05/2017,"Benny's","RV : Equipment/Supplies","RV","Equipment/Supplies","",$50.96,$0.00,-$10481.90
"Discover",,U,,06/06/2017,"Entertainment Cinemas","Recreation : Entertainment","Recreation","Entertainment",,$32.25,$0.00,-$10514.15
"Discover",,U,,06/07/2017,"Transfer : Dcu Checking",,,,"",$0.00,$5847.91,-$4666.24
"Discover",,U,,06/07/2017,"stop & shop","Food : Groceries","Food","Groceries","",$136.88,$0.00,-$4803.12
"Discover",,U,,06/08/2017,"Marine Specialist","Personal : cloths","Personal","cloths","",$28.29,$0.00,-$4831.41
"Discover",,U,,06/08/2017,"Canteen restaurant","Food : Restaurants","Food","Restaurants","",$61.60,$0.00,-$4893.01
"Discover",,U,,06/09/2017,"Amazon","RV : Equipment/Supplies","RV","Equipment/Supplies","",$8.97,$0.00,-$4901.98
"Discover",,U,,06/09/2017,"cvs","Personal : Prescriptions, Medicine","Personal","Prescriptions, Medicine","",$33.20,$0.00,-$4935.18
"Discover",,U,,06/09/2017,"stop & shop","Food : Groceries","Food","Groceries","",$77.15,$0.00,-$5012.33
"Discover",,U,,06/09/2017,"Naked Oyster","Food : Restaurants","Food","Restaurants","",$132.48,$0.00,-$5144.81
"Discover",,U,,06/10/2017,"Amazon","RV : Equipment/Supplies","RV","Equipment/Supplies","",$7.99,$0.00,-$5152.80
"Discover",,U,,06/10/2017,"Shell","Transportation : Gas","Transportation","Gas","",$20.98,$0.00,-$5173.78
"Discover",,U,,06/10/2017,"Jollybean cafe","Food : Restaurants","Food","Restaurants","Great Breakfast place in industrial park",$26.26,$0.00,-$5200.04
"Discover",,U,,06/10/2017,"Tucks Candy","Food : Restaurants","Food","Restaurants","",$26.68,$0.00,-$5226.72
"Discover",,U,,06/10/2017,"Amazon","RV : Equipment/Supplies","RV","Equipment/Supplies","",$142.13,$0.00,-$5368.85
"Discover",,U,,06/11/2017,"lobster land","Food : Restaurants","Food","Restaurants","",$194.09,$0.00,-$5562.94
"Discover",,U,,06/12/2017,"Buckies Biscotti","Food : Restaurants","Food","Restaurants","Iced Coffee",$3.21,$0.00,-$5566.15
"Discover",,U,,06/13/2017,"Shell","Transportation : Gas","Transportation","Gas","",$19.70,$0.00,-$5585.85
"Discover",,U,,06/13/2017,"Roche Brothers","Food : Groceries","Food","Groceries","",$56.14,$0.00,-$5641.99
"Discover",,U,,06/15/2017,"Allandale Farm","Personal : Gifts","Personal","Gifts","Plants",$29.00,$0.00,-$5670.99
"Discover",,U,,06/15/2017,"Sophia's Groto","Food : Restaurants","Food","Restaurants","",$229.82,$0.00,-$5900.81
"Discover",,U,,06/16/2017,"redbox","Recreation : Entertainment","Recreation","Entertainment","",$1.59,$0.00,-$5902.40
"Discover",,U,,06/16/2017,"Local Flavor","Food : Restaurants","Food","Restaurants","",$21.15,$0.00,-$5923.55
"Discover",,U,,06/16/2017,"stop & shop","Food : Groceries","Food","Groceries","",$72.80,$0.00,-$5996.35
"Discover",,U,,06/17/2017,"itunes","Recreation : Entertainment","Recreation","Entertainment","",$0.99,$0.00,-$5997.34
"Discover",,U,,06/17/2017,"Ocean State Joblot","Personal : cloths","Personal","cloths","(Split 1/3) ",$50.00,$0.00,-$6131.09
"Discover",,U,,06/17/2017,"Ocean State Joblot","Food : Groceries","Food","Groceries","(Split 2/3) ",$30.00,$0.00,-$6131.09
"Discover",,U,,06/17/2017,"Ocean State Joblot","RV : Equipment/Supplies","RV","Equipment/Supplies","(Split 3/3) ",$53.75,$0.00,-$6131.09
"Discover",,U,,06/18/2017,"stop & shop","Food : Groceries","Food","Groceries","",$33.27,$0.00,-$6164.36
"Discover",,U,,06/19/2017,"Stewarts","Transportation : Gas","Transportation","Gas","",$19.79,$0.00,-$6184.15
"Discover",,U,,06/19/2017,"Exxon mobile","RV : gasoline","RV","gasoline","",$100.00,$0.00,-$6284.15
"Discover",,U,,06/20/2017,"hannaford","Food : Groceries","Food","Groceries","(Split 1/2) ",$100.00,$0.00,-$6447.74
"Discover",,U,,06/20/2017,"hannaford","Personal : nom-prescription medication","Personal","nom-prescription medication","(Split 2/2) ",$63.59,$0.00,-$6447.74
"Discover",,U,,06/21/2017,"Joe's Brooklyn pizza","Food : Restaurants","Food","Restaurants","",$17.36,$0.00,-$6465.10
"Discover",,U,,06/21/2017,"Ox and Stone","Food : Restaurants","Food","Restaurants","cricket",$57.52,$0.00,-$6522.62
"Discover",,U,,06/21/2017,"Exxon mobile","RV : gasoline","RV","gasoline","",$100.00,$0.00,-$6622.62
"Discover",,U,,06/22/2017,"Sunoco","RV : gasoline","RV","gasoline","",$100.00,$0.00,-$6722.62
"Discover",,U,,06/23/2017,"Maple Lakes","RV : Campgrounds","RV","Campgrounds","",$40.50,$0.00,-$6763.12
"Discover",,U,,06/24/2017,"Krogers","Food : Groceries","Food","Groceries","",$128.39,$0.00,-$6891.51
"Discover",,U,,06/24/2017,"BP","RV : gasoline","RV","gasoline","",$140.49,$0.00,-$7032.00
"Discover",,U,,06/25/2017,"Passport America","RV : clubs","RV","clubs","",$49.00,$0.00,-$7081.00
"Discover",,U,,06/25/2017,"Ohio State Park","RV : Campgrounds","RV","Campgrounds","",$65.00,$0.00,-$7146.00
"Discover",,U,,06/26/2017,"Walmart","RV : Equipment/Supplies","RV","Equipment/Supplies","",$0.00,$46.36,-$7099.64
"Discover",,U,,06/26/2017,"google storage","business (bob) : computer","Hidden Categories","business (bob) ` computer","",$1.99,$0.00,-$7101.63
"Discover",,U,,06/26/2017,"redbox","Recreation : Entertainment","Recreation","Entertainment","",$3.20,$0.00,-$7104.83
"Discover",,U,,06/26/2017,"Wilminto Ace Hdw","RV : Equipment/Supplies","RV","Equipment/Supplies","",$10.24,$0.00,-$7115.07
"Discover",,U,,06/26/2017,"BP","Transportation : Gas","Transportation","Gas","",$18.58,$0.00,-$7133.65
"Discover",,U,,06/26/2017,"Walmart","Food : Groceries","Food","Groceries","",$76.33,$0.00,-$7209.98
"Discover",,U,,06/27/2017,"Red Barn","Food : Restaurants","Food","Restaurants","",$1.60,$0.00,-$7211.58
"Discover",,U,,06/27/2017,"Krogers","Food : Groceries","Food","Groceries","",$33.77,$0.00,-$7245.35
"Discover",,U,,06/27/2017,"Ohio State Park","RV : Campgrounds","RV","Campgrounds","",$36.00,$0.00,-$7281.35
"Discover",,U,,06/28/2017,"cinci zoo","Recreation : Entertainment","Recreation","Entertainment","",$37.00,$0.00,-$7318.35
"Discover",,U,,06/28/2017,"general Denver Hotel","Food : Restaurants","Food","Restaurants","",$41.69,$0.00,-$7360.04
"Discover",,U,,06/28/2017,"Ohio State Park","RV : Campgrounds","RV","Campgrounds","",$65.00,$0.00,-$7425.04
"Discover",,U,,06/28/2017,"Krogers","Food : Groceries","Food","Groceries","",$90.98,$0.00,-$7516.02
"Discover",,U,,06/29/2017,"Ohio State Park","RV : Campgrounds","RV","Campgrounds","",$0.00,$29.00,-$7487.02
"Discover",,U,,06/29/2017,"United Dairy Farmers","Transportation : Gas","Transportation","Gas","",$17.79,$0.00,-$7504.81
"Discover",,U,,06/29/2017,"Applebees","Food : Restaurants","Food","Restaurants","Lisa Landa, Damon and Britney",$95.47,$0.00,-$7600.28
"Discover",,U,,06/29/2017,"jungle jims","Food : Groceries","Food","Groceries","Shopping with Damon Lisa Britney",$106.29,$0.00,-$7706.57
"Discover",,U,,06/29/2017,"Suncounty direct","Recreation : Alyssa","Recreation","Alyssa","Flight to MIN",$198.20,$0.00,-$7904.77
"Discover",,U,,06/30/2017,"Stoney Ridge KOA","RV : Campgrounds","RV","Campgrounds","Where we met Russell and Lindsey and Dinner with Antonia and Marshal",$44.00,$0.00,-$7948.77
"Discover",,U,,07/02/2017,"Doc Pierces","Food : Restaurants","Food","Restaurants","Merna, Brian and grand daughter Sonya",$14.00,$0.00,-$7962.77
"Discover",,U,,07/02/2017,"Pilot","RV : gasoline","RV","gasoline","",$69.84,$0.00,-$8032.61
"Discover",,U,,07/02/2017,"Doc Pierces","Food : Restaurants","Food","Restaurants","Merna, Brian and grand daughter Sonya",$71.88,$0.00,-$8104.49
"Discover",,U,,07/03/2017,"Bamber Superette","Food : Groceries","Food","Groceries","Cool italian market in Mishawaks - cannolis",$53.64,$0.00,-$8158.13
"Discover",,U,,07/04/2017,"Escapees RV Club","RV : clubs","RV","clubs","",$49.95,$0.00,-$8208.08
"Discover",,U,,07/04/2017,"Krogers","Food : Groceries","Food","Groceries","",$85.05,$0.00,-$8293.13
"Discover",,U,,07/05/2017,"Yoders","RV : Equipment/Supplies","RV","Equipment/Supplies","",$5.87,$0.00,-$8299.00
"Discover",,U,,07/05/2017,"Bwb Retail","RV : Equipment/Supplies","RV","Equipment/Supplies","",$8.54,$0.00,-$8307.54
"Discover",,U,,07/05/2017,"Yoders","RV : Equipment/Supplies","RV","Equipment/Supplies","",$10.85,$0.00,-$8318.39
"Discover",,U,,07/05/2017,"Yoders","Personal : cloths","Personal","cloths","Bob Hat Lisa Shoes",$51.32,$0.00,-$8369.71
"Discover",,U,,07/05/2017,"Shipwana Auction","Food : Restaurants","Food","Restaurants","lunch Lisa with Merna , Brian Sonya in Shipwanns near auction",$59.72,$0.00,-$8429.43
"Discover",,U,,07/05/2017,"cenex","RV : gasoline","RV","gasoline","",$91.85,$0.00,-$8521.28
"Discover",,U,,07/05/2017,"Dandinos","Food : Restaurants","Food","Restaurants","dinner with Merna, Brian and Sonya (when we couldn't get into the dinner in Goshen)",$101.86,$0.00,-$8623.14
"Discover",,U,,07/06/2017,"Transfer : Dcu Checking",,,,"",$0.00,$5562.94,-$3060.20
"Discover",,U,,07/06/2017,"Escapees RV Club","RV : clubs","RV","clubs","",$0.00,$10.00,-$3050.20
"Discover",,U,,07/06/2017,"Bowl of pho","Food : Restaurants","Food","Restaurants","While waiting for iphone to be fixed.",$17.96,$0.00,-$3068.16
"Discover",,U,,07/06/2017,"Italian Village","Food : Restaurants","Food","Restaurants","Ate at bar in Chicago - Monicatta for me Chicken marsailler for lisa cheses cake for desert",$72.18,$0.00,-$3140.34
"Discover",,U,,07/06/2017,"applestore","Housing : Phone & Internet","Hidden Categories","Housing ` Phone & Internet","Phone repair",$138.03,$0.00,-$3278.37
"Discover",,U,,07/08/2017,"McDonalds","Food : Restaurants","Food","Restaurants","We had to Pee and bathroom was for paying customers so we got coffees",$5.63,$0.00,-$3284.00
"Discover",,U,,07/08/2017,"Metra","Transportation : Public","Transportation","Public","Train into Chicago - weekend pass $8 each - great deal",$16.00,$0.00,-$3300.00
"Discover",,U,,07/08/2017,"taste of chicago","Food : Restaurants","Food","Restaurants","At Grant Park in Chicago",$20.00,$0.00,-$3320.00
"Discover",,U,,07/09/2017,"Bluebox Cafe","Food : Restaurants","Food","Restaurants","Mr Who Themed Cafe/Deli in ELGIN - nice place, good food, beautiful day by rivef",$26.29,$0.00,-$3346.29
"Discover",,U,,07/10/2017,"Exxon mobile","Transportation : Gas","Transportation","Gas","",$18.56,$0.00,-$3364.85
"Discover",,U,,07/10/2017,"Perros Pizza","Food : Restaurants","Food","Restaurants","Deep Dish Pizza - Strip mall takeout place really - Acidic sauce and uncooked onions - crust was nice",$40.54,$0.00,-$3405.39
"Discover",,U,,07/10/2017,"Field Museum","Recreation : Entertainment","Recreation","Entertainment","Didn't leave enough time - Jurassic park exhibit disappointing",$74.00,$0.00,-$3479.39
"Discover",,U,,07/11/2017,"redbox","Recreation : Entertainment","Recreation","Entertainment","",$1.58,$0.00,-$3480.97
"Discover",,U,,07/12/2017,"AGP Propage","RV : propane","RV","propane","",$47.24,$0.00,-$3528.21
"Discover",,U,,07/13/2017,"redbox","Recreation : Entertainment","Recreation","Entertainment","City of Z - good Move",$1.58,$0.00,-$3529.79
"Discover",,U,,07/13/2017,"Pauls Pelmeni","Food : Restaurants","Food","Restaurants","Cheap eats - great dumblins",$19.00,$0.00,-$3548.79
"Discover",,U,,07/13/2017,"Walmart","RV : Equipment/Supplies","RV","Equipment/Supplies","scale etc",$20.89,$0.00,-$3569.68
"Discover",,U,,07/13/2017,"St Pausl East RV","RV : Campgrounds","RV","Campgrounds","Down payment on stay near miniapolis",$53.57,$0.00,-$3623.25
"Discover",,U,,07/14/2017,"Brink Loung","Food : Restaurants","Food","Restaurants","Dan and Faith Show",$13.50,$0.00,-$3636.75
"Discover",,U,,07/14/2017,"Brink Lounge","Food : Restaurants","Food","Restaurants","",$14.50,$0.00,-$3651.25
"Discover",,U,,07/14/2017,"zu zu","Food : Restaurants","Food","Restaurants","Cool restaurant near zoo in madison",$26.00,$0.00,-$3677.25
"Discover",,U,,07/15/2017,"redbox","Recreation : Entertainment","Recreation","Entertainment","",$1.58,$0.00,-$3678.83
"Discover",,U,,07/16/2017,"speedway","Transportation : Gas","Transportation","Gas","",$11.08,$0.00,-$3689.91
"Discover",,U,,07/16/2017,"speedway","RV : gasoline","RV","gasoline","",$100.00,$0.00,-$3789.91
"Discover",,U,,07/16/2017,"St Pausl East RV","RV : Campgrounds","RV","Campgrounds","",$214.26,$0.00,-$4004.17
"Discover",,U,,07/17/2017,"itunes","Recreation : Entertainment","Recreation","Entertainment","",$0.99,$0.00,-$4005.16
"Discover",,U,,07/17/2017,"redbox","Recreation : Entertainment","Recreation","Entertainment","",$1.61,$0.00,-$4006.77
"Discover",,U,,07/17/2017,"trader Joes","Food : Groceries","Food","Groceries","",$7.11,$0.00,-$4013.88
"Discover",,U,,07/17/2017,"Best Buy","business (bob) : Equipment","Hidden Categories","business (bob) ` Equipment","",$19.27,$0.00,-$4033.15
"Discover",,U,,07/17/2017,"cub food","Food : Groceries","Food","Groceries","",$44.50,$0.00,-$4077.65
"Discover",,U,,07/17/2017,"St Pausl East RV","RV : Campgrounds","RV","Campgrounds","",$53.57,$0.00,-$4131.22
"Discover",,U,,07/17/2017,"trader Joes","Food : Groceries","Food","Groceries","",$120.76,$0.00,-$4251.98
"Discover",,U,,07/18/2017,"Guitar Denter","Recreation : His","Recreation","His","Guitar picks",$9.63,$0.00,-$4261.61
"Discover",,U,,07/20/2017,"chipolte","Food : Restaurants","Food","Restaurants","",$25.92,$0.00,-$4287.53
"Discover",,U,,07/21/2017,"Walmart","Food : Groceries","Food","Groceries","",$1.27,$0.00,-$4288.80
"Discover",,U,,07/21/2017,"River Oasis Cafe","Food : Restaurants","Food","Restaurants","Hangover Burger - me, Breakfast Burrito - Alyssa, Garlic cheese mushroom burger Lisa",$46.30,$0.00,-$4335.10
"Discover",,U,,07/21/2017,"Pan Mass Challenge","Charity : Other","Charity","Other","Don Brutvan Bike Ride",$51.13,$0.00,-$4386.23
"Discover",,U,,07/22/2017,"Walmart","RV : Equipment/Supplies","RV","Equipment/Supplies","",$0.00,$19.09,-$4367.14
"Discover",,U,,07/22/2017,"redbox","Recreation : Entertainment","Recreation","Entertainment","",$1.61,$0.00,-$4368.75
"Discover",,U,,07/22/2017,"Amazon","Recreation : Entertainment","Recreation","Entertainment","Film not returned",$11.99,$0.00,-$4380.74
"Discover",,U,,07/22/2017,"Mills Gas","Transportation : Gas","Transportation","Gas","",$16.53,$0.00,-$4397.27
"Discover",,U,,07/22/2017,"Walmart","RV : Equipment/Supplies","RV","Equipment/Supplies","",$19.09,$0.00,-$4416.36
"Discover",,U,,07/22/2017,"Walmart","Food : Groceries","Food","Groceries","",$29.76,$0.00,-$4446.12
"Discover",,U,,07/22/2017,"Pilot","RV : gasoline","RV","gasoline","",$75.00,$0.00,-$4521.12
"Discover",,U,,07/23/2017,"laundry","RV : Laundry","RV","Laundry","",$8.00,$0.00,-$4529.12
"Discover",,U,,07/24/2017,"grand theatre","Recreation : Entertainment","Recreation","Entertainment","",$30.75,$0.00,-$4559.87
"Discover",,U,,07/24/2017,"Walmart","RV : Equipment/Supplies","RV","Equipment/Supplies","(Split 1/2) ",$20.00,$0.00,-$4600.61
"Discover",,U,,07/24/2017,"Walmart","Food : Groceries","Food","Groceries","(Split 2/2) ",$20.74,$0.00,-$4600.61
"Discover",,U,,07/24/2017,"Bismark  park","RV : Campgrounds","RV","Campgrounds","",$44.00,$0.00,-$4644.61
"Discover",,U,,07/24/2017,"Cemex","RV : gasoline","RV","gasoline","",$100.00,$0.00,-$4744.61
"Discover",,U,,07/25/2017,"redbox","Recreation : Entertainment","Recreation","Entertainment","",$1.60,$0.00,-$4746.21
"Discover",,U,,07/25/2017,"Fireflour","Food : Restaurants","Food","Restaurants","Pizza in Bismark ND",$55.48,$0.00,-$4801.69
"Discover",,U,,07/25/2017,"dan's supermarket","Food : Groceries","Food","Groceries","",$101.71,$0.00,-$4903.40
"Discover",,U,,07/26/2017,"google storage","business (bob) : computer","Hidden Categories","business (bob) ` computer","",$1.99,$0.00,-$4905.39
"Discover",,U,,07/26/2017,"Medievals Tavern Regent","business (bob) : Real Estate","Hidden Categories","business (bob) ` Real Estate","",$18.00,$0.00,-$4923.39
"Discover",,U,,07/26/2017,"cenex","RV : gasoline","RV","gasoline","",$100.00,$0.00,-$5023.39
"Discover",,U,,07/27/2017,"Medora Musical","Recreation : Entertainment","Recreation","Entertainment","",$45.10,$0.00,-$5068.49
"Discover",,U,,07/28/2017,"Badlands Pizza","Food : Restaurants","Food","Restaurants","Emphasis on BAD  - this pizza was not good in Medora",$47.00,$0.00,-$5115.49
"Discover",,U,,07/29/2017,"Burning Hills Emporium","Food : Restaurants","Food","Restaurants","Ice Cream",$4.00,$0.00,-$5119.49
"Discover",,U,,07/29/2017,"Little Missour club","Food : Restaurants","Food","Restaurants","Beers and drinks listend to band with women in red dress will Olivia",$24.00,$0.00,-$5143.49
"Discover",,U,,07/30/2017,"Medora Convience","Food : Groceries","Food","Groceries","Drinks and had to buy ice cream to meet $5 minimum",$6.22,$0.00,-$5149.71
"Discover",,U,,07/30/2017,"Maltese burgers","Food : Restaurants","Food","Restaurants","So-so burgers  - Medora food is not good",$18.11,$0.00,-$5167.82
"Discover",,U,,07/30/2017,"Medora Convience","Transportation : Gas","Transportation","Gas","Little station in Medora",$21.99,$0.00,-$5189.81
"Discover",,U,,07/30/2017,"Hearlland RV","RV : Campgrounds","RV","Campgrounds","",$32.00,$0.00,-$5221.81
"Discover",,U,,07/31/2017,"Gary and Jacks","RV : gasoline","RV","gasoline","",$73.03,$0.00,-$5294.84
"Discover",,U,,07/31/2017,"Hearlland RV","RV : Campgrounds","RV","Campgrounds","",$95.18,$0.00,-$5390.02
"Discover",,U,,07/31/2017,"Walmart","Food : Groceries","Food","Groceries","",$123.05,$0.00,-$5513.07
"Discover",,U,,07/31/2017,"Buffalo Gap","RV : Campgrounds","RV","Campgrounds","Long Dirt Road (owned by women who use to work for DEC)  GPS tired to send us on crazy road",$123.60,$0.00,-$5636.67
"Discover",,U,,08/01/2017,"Black hills Iinstitute","Recreation : Entertainment","Recreation","Entertainment","Dino museum  hills city SD",$20.99,$0.00,-$5657.66
"Discover",,U,,08/01/2017,"Hubcap diner","Food : Restaurants","Food","Restaurants","In Hill City",$60.98,$0.00,-$5718.64
"Discover",,U,,08/02/2017,"Coolidge Store","Food : Restaurants","Food","Restaurants","",$10.90,$0.00,-$5729.54
"Discover",,U,,08/02/2017,"crazy horse","Recreation : Entertainment","Recreation","Entertainment","Bus ride at crazy horse",$12.00,$0.00,-$5741.54
"Discover",,U,,08/02/2017,"Custer State Park","Recreation : Entertainment","Recreation","Entertainment","Custer state park",$20.00,$0.00,-$5761.54
"Discover",,U,,08/02/2017,"Coolidge Store","Transportation : Gas","Transportation","Gas","",$22.23,$0.00,-$5783.77
"Discover",,U,,08/02/2017,"crazy horse","Recreation : Entertainment","Recreation","Entertainment","Crazy horse sculpture",$28.00,$0.00,-$5811.77
"Discover",,U,,08/02/2017,"Windcave NP","Recreation : Entertainment","Recreation","Entertainment","Cave tour",$30.00,$0.00,-$5841.77
"Discover",,U,,08/03/2017,"Walls Drug","RV : Equipment/Supplies","RV","Equipment/Supplies","Caribina",$4.86,$0.00,-$5846.63
"Discover",,U,,08/03/2017,"Exxon mobile","Transportation : Gas","Transportation","Gas","",$15.41,$0.00,-$5862.04
"Discover",,U,,08/03/2017,"Roys's black Hills","Recreation : Entertainment","Recreation","Entertainment","Drive-in Movies Planet of the Apes",$16.00,$0.00,-$5878.04
"Discover",,U,,08/04/2017,"Coffee cup","RV : gasoline","RV","gasoline","",$100.00,$0.00,-$5978.04
"Discover",,U,,08/05/2017,"Wyoming Dino Center","Recreation : Entertainment","Recreation","Entertainment","",$30.00,$0.00,-$6008.04
"Discover",,U,,08/05/2017,"Foutains of youth RV park","RV : Campgrounds","RV","Campgrounds","Camp ground with hot spring pool - pretty cool in a hot way",$46.20,$0.00,-$6054.24
"Discover",,U,,08/05/2017,"Bangog Restaurante","Food : Restaurants","Food","Restaurants","",$61.78,$0.00,-$6116.02
"Discover",,U,,08/06/2017,"Transfer : Dcu Checking",,,,"",$0.00,$3436.36,-$2679.66
"Discover",,U,,08/06/2017,"Exxon mobile","RV : gasoline","RV","gasoline","",$54.26,$0.00,-$2733.92
"Discover",,U,,08/07/2017,"Dornans TETON","Transportation : Gas","Transportation","Gas","Gas in MOOSE entrance to TETON",$23.73,$0.00,-$2757.65
"Discover",,U,,08/07/2017,"Dornans TETON","Food : Restaurants","Food","Restaurants","Sandwiches after hiking String lake",$26.25,$0.00,-$2783.90
"Discover",,U,,08/07/2017,"WIldlife ART museum","Recreation : Entertainment","Recreation","Entertainment","Art museum near jackson statues outside, the great animal photos, Warhol",$42.00,$0.00,-$2825.90
"Discover",,U,,08/07/2017,"Albertsons","RV : Equipment/Supplies","RV","Equipment/Supplies","(Split 1/2) ",$49.00,$0.00,-$3103.89
"Discover",,U,,08/07/2017,"Albertsons","Food : Groceries","Food","Groceries","(Split 2/2) ",$228.99,$0.00,-$3103.89
"Discover",,U,,08/08/2017,"Stone Drug","Food : Groceries","Food","Groceries","ice",$2.00,$0.00,-$3105.89
"Discover",,U,,08/08/2017,"Stone Drug","Personal : nom-prescription medication","Personal","nom-prescription medication","Oxygen for lisa",$13.53,$0.00,-$3119.42
"Discover",,U,,08/09/2017,"Dornans Gas","Transportation : Gas","Transportation","Gas","",$16.28,$0.00,-$3135.70
"Discover",,U,,08/10/2017,"Jenny Lake boating","Recreation : Entertainment","Recreation","Entertainment","Boat back from hiking lake Jenny and seeing falls",$27.00,$0.00,-$3162.70
"Discover",,U,,08/11/2017,"Pinky Gs","Food : Restaurants","Food","Restaurants","Pretty good white pizza in Jackson",$31.00,$0.00,-$3193.70
"Discover",,U,,08/11/2017,"Jackson Rodeo","Recreation : Entertainment","Recreation","Entertainment","Rodio in Jackson with Alyssa (sheep russling was my favorite with barrel racing also)",$35.00,$0.00,-$3228.70
"Discover",,U,,08/12/2017,"Shervins","Transportation : Gas","Transportation","Gas","",$10.17,$0.00,-$3238.87
"Discover",,U,,08/12/2017,"Mavericks","Transportation : Gas","Transportation","Gas","",$11.42,$0.00,-$3250.29
"Discover",,U,,08/12/2017,"Ace hardware","RV : Equipment/Supplies","RV","Equipment/Supplies","Mouse supplies",$22.09,$0.00,-$3272.38
"Discover",,U,,08/12/2017,"Exprells Lube","Transportation : Repairs & Maintenance","Transportation","Repairs & Maintenance","Oil change",$57.20,$0.00,-$3329.58
"Discover",,U,,08/13/2017,"starbucks","Food : Restaurants","Food","Restaurants","Iced coffee - so we could use wifi",$3.62,$0.00,-$3333.20
"Discover",,U,,08/13/2017,"Albertsons","Food : Groceries","Food","Groceries","",$123.78,$0.00,-$3456.98
"Discover",,U,,08/14/2017,"Gas","Transportation : Gas","Transportation","Gas","",$16.52,$0.00,-$3473.50
"Discover",,U,,08/15/2017,"consumer reports","Recreation : Entertainment","Recreation","Entertainment","",$35.00,$0.00,-$3508.50
"Discover",,U,,08/15/2017,"American Brain Tumor","Charity : Other","Charity","Other","",$250.00,$0.00,-$3758.50
"Discover",,U,,08/16/2017,"Gas","Transportation : Gas","Transportation","Gas","",$15.49,$0.00,-$3773.99
"Discover",,U,,08/16/2017,"Grant Genereal","Personal : Miscellaneous","Personal","Miscellaneous","??? ASK LISA",$28.36,$0.00,-$3802.35
"Discover",,U,,08/17/2017,"Albertsons","Food : Groceries","Food","Groceries","",$168.93,$0.00,-$3971.28
"Discover",,U,,08/19/2017,"Dornans","Food : Groceries","Food","Groceries","Hamburger buns",$6.57,$0.00,-$3977.85
"Discover",,U,,08/19/2017,"Haagan-daz","Food : Restaurants","Food","Restaurants","",$20.66,$0.00,-$3998.51
"Discover",,U,,08/19/2017,"Teton County","RV : MISC","RV","MISC","Showers and Swin at rec center in Jackson",$21.00,$0.00,-$4019.51
"Discover",,U,,08/19/2017,"Dornans","Food : Groceries","Food","Groceries","Hamburgers",$25.95,$0.00,-$4045.46
"Discover",,U,,08/19/2017,"Dornans","Transportation : Gas","Transportation","Gas","",$27.35,$0.00,-$4072.81
"Discover",,U,,08/19/2017,"The Indian","Food : Restaurants","Food","Restaurants","Anniversary",$92.00,$0.00,-$4164.81
"Discover",,U,,08/22/2017,"redbox","Recreation : Entertainment","Recreation","Entertainment","",$1.59,$0.00,-$4166.40
"Discover",,U,,08/22/2017,"Walmart","Personal : cloths","Personal","cloths","Sunglasses Alyssa",$4.01,$0.00,-$4170.41
"Discover",,U,,08/22/2017,"USPS","Housing : Supplies","Hidden Categories","Housing ` Supplies","",$8.50,$0.00,-$4178.91
"Discover",,U,,08/22/2017,"morenitas","Food : Restaurants","Food","Restaurants","Idaho falls - Good mexican place",$33.64,$0.00,-$4212.55
"Discover",,U,,08/22/2017,"Walmart","Food : Groceries","Food","Groceries","",$47.18,$0.00,-$4259.73
"Discover",,U,,08/22/2017,"Alpine gas","RV : gasoline","RV","gasoline","",$95.00,$0.00,-$4354.73
"Discover",,U,,08/23/2017,"Walmart","Food : Groceries","Food","Groceries","",$12.68,$0.00,-$4367.41
"Discover",,U,,08/23/2017,"Gas","Transportation : Gas","Transportation","Gas","",$18.80,$0.00,-$4386.21
"Discover",,U,,08/23/2017,"Walmart","Food : Groceries","Food","Groceries","",$37.97,$0.00,-$4424.18
"Discover",,U,,08/24/2017,"Lincoln Rd RV","RV : Campgrounds","RV","Campgrounds","Outside of Helena MT",$45.00,$0.00,-$4469.18
"Discover",,U,,08/24/2017,"safeway fuel","RV : gasoline","RV","gasoline","",$80.97,$0.00,-$4550.15
"Discover",,U,,08/25/2017,"Great Norhern Carosual","Recreation : Entertainment","Recreation","Entertainment","",$4.50,$0.00,-$4554.65
"Discover",,U,,08/25/2017,"Bob' valley Market","Food : Groceries","Food","Groceries","",$10.78,$0.00,-$4565.43
"Discover",,U,,08/25/2017,"Lincoln Rd RV","RV : Campgrounds","RV","Campgrounds","",$45.00,$0.00,-$4610.43
"Discover",,U,,08/25/2017,"Steves Cafe","Food : Restaurants","Food","Restaurants","Breakfast Helena",$48.95,$0.00,-$4659.38
"Discover",,U,,08/26/2017,"google storage","business (bob) : computer","Hidden Categories","business (bob) ` computer","",$1.99,$0.00,-$4661.37
"Discover",,U,,08/26/2017,"Glaceir Meadow Rv Park","RV : Campgrounds","RV","Campgrounds","Nice older couple ran park, met two canadains Ray and Don? - had a disk golf course at park",$48.50,$0.00,-$4709.87
"Discover",,U,,08/26/2017,"Glacier Family Foods","RV : gasoline","RV","gasoline","",$94.76,$0.00,-$4804.63
"Discover",,U,,08/27/2017,"Glaceir Meadow Rv Park","RV : Campgrounds","RV","Campgrounds","",$48.50,$0.00,-$4853.13
"Discover",,U,,08/27/2017,"e-ZPass","RV : Tolls","RV","Tolls","Screwed by onread toll",$67.45,$0.00,-$4920.58
"Discover",,U,,08/28/2017,"Glacier Highlands west","Transportation : Gas","Transportation","Gas","",$22.72,$0.00,-$4943.30
"Discover",,U,,08/28/2017,"Teeples","Food : Groceries","Food","Groceries","",$41.60,$0.00,-$4984.90
"Discover",,U,,08/28/2017,"Glacier Meadows RV Park","RV : propane","RV","propane","",$48.40,$0.00,-$5033.30
"Discover",,U,,08/30/2017,"cenex","Transportation : Gas","Transportation","Gas","",$19.45,$0.00,-$5052.75
"Discover",,U,,09/01/2017,"Jellystone Rv Park","RV : Campgrounds","RV","Campgrounds","Campground Near Missoula - we like mousuola",$52.95,$0.00,-$5105.70
"Discover",,U,,09/02/2017,"IWFF ROXY","Recreation : Entertainment","Recreation","Entertainment","Movies for Lisa and Alyssa (Henson movie)  Mossoula MT",$16.00,$0.00,-$5121.70
"Discover",,U,,09/02/2017,"Town Pump","Transportation : Gas","Transportation","Gas","",$20.67,$0.00,-$5142.37
"Discover",,U,,09/02/2017,"Book Exchange","Recreation : Entertainment","Recreation","Entertainment","Guitar books, alyssa book",$35.03,$0.00,-$5177.40
"Discover",,U,,09/03/2017,"redbox","Recreation : Entertainment","Recreation","Entertainment","",$1.63,$0.00,-$5179.03
"Discover",,U,,09/03/2017,"Gaosoline","RV : gasoline","RV","gasoline","",$95.00,$0.00,-$5274.03
"Discover",,U,,09/04/2017,"Spokane Parking","Transportation : Parking","Transportation","Parking","Parking at spokan river front pigout fest, music, falls - no carousel (being moved)",$5.00,$0.00,-$5279.03
"Discover",,U,,09/04/2017,"Rosauers","Food : Groceries","Food","Groceries","Great steaks cheap - nice friendly  woman at meat counter",$23.11,$0.00,-$5302.14
"Discover",,U,,09/05/2017,"Exxon mobile","RV : gasoline","RV","gasoline","",$96.36,$0.00,-$5398.50
"Discover",,U,,09/05/2017,"Tall Chief","RV : Campgrounds","RV","Campgrounds","Falls City Near Seattle - Better than expected nice lot - wooded -with club house",$286.08,$0.00,-$5684.58
"Discover",,U,,09/06/2017,"Transfer : Dcu Checking",,,,"",$0.00,$3162.70,-$2521.88
"Discover",,U,,09/06/2017,"redbox","Recreation : Entertainment","Recreation","Entertainment","",$1.63,$0.00,-$2523.51
"Discover",,U,,09/06/2017,"","Transportation : Parking","Transportation","Parking","",$5.00,$0.00,-$2528.51
"Discover",,U,,09/06/2017,"Albertsons","Food : Groceries","Food","Groceries","",$108.00,$0.00,-$2636.51
"Discover",,U,,09/08/2017,"redbox","Recreation : Entertainment","Recreation","Entertainment","",$1.63,$0.00,-$2638.14
"Discover",,U,,09/08/2017,"parking","Transportation : Parking","Transportation","Parking","",$5.00,$0.00,-$2643.14
"Discover",,U,,09/08/2017,"SpaceNeedle","Recreation : Entertainment","Recreation","Entertainment","Seattle Chihuli museum and space needle",$119.70,$0.00,-$2762.84
"Discover",,U,,09/09/2017,"redbox","Recreation : Entertainment","Recreation","Entertainment","",$1.65,$0.00,-$2764.49
"Discover",,U,,09/09/2017,"Cheveron","Transportation : Gas","Transportation","Gas","",$24.69,$0.00,-$2789.18
"Discover",,U,,09/09/2017,"safeway groceries","Food : Groceries","Food","Groceries","",$103.10,$0.00,-$2892.28
"Discover",,U,,09/11/2017,"Museeum of Pop","Recreation : Entertainment","Recreation","Entertainment","",$5.00,$0.00,-$2897.28
"Discover",,U,,09/11/2017,"Museeum of Pop","Recreation : Entertainment","Recreation","Entertainment","Cool music setup where you could play along with songs and neat fantasy section",$10.00,$0.00,-$2907.28
"Discover",,U,,09/12/2017,"safeway fuel","RV : gasoline","RV","gasoline","",$125.00,$0.00,-$3032.28
"Discover",,U,,09/13/2017,"Exxon mobile","Transportation : Gas","Transportation","Gas","",$24.75,$0.00,-$3057.03
"Discover",,U,,09/13/2017,"Metrowest medical center","Personal : Doctor, Dentist","Personal","Doctor, Dentist","",$370.84,$0.00,-$3427.87
"Discover",,U,,09/14/2017,"Cliffdroppers","Food : Restaurants","Food","Restaurants","Packwood burger place outside Mt Rainier",$38.92,$0.00,-$3466.79
"Discover",,U,,09/15/2017,"Fischer Randal Supermarket","Food : Groceries","Food","Groceries","",$14.54,$0.00,-$3481.33
"Discover",,U,,09/15/2017,"Fire Mountain","Personal : Gifts","Personal","Gifts","Gift for DAD",$27.00,$0.00,-$3508.33
"Discover",,U,,09/16/2017,"Cove RV","RV : Campgrounds","RV","Campgrounds","",$65.69,$0.00,-$3574.02
"Discover",,U,,09/17/2017,"itunes","Recreation : Entertainment","Recreation","Entertainment","",$0.71,$0.00,-$3574.73
"Discover",,U,,09/17/2017,"Cheveron","Transportation : Gas","Transportation","Gas","",$20.50,$0.00,-$3595.23
"Discover",,U,,09/17/2017,"Walmart","Food : Groceries","Food","Groceries","(Split 1/2) ",$120.00,$0.00,-$3760.80
"Discover",,U,,09/17/2017,"Walmart","RV : Equipment/Supplies","RV","Equipment/Supplies","(Split 2/2) ",$45.57,$0.00,-$3760.80
"Discover",,U,,09/17/2017,"Jetblue","Transportation : Air/train/bus/etc","Transportation","Air/train/bus/etc","",$481.39,$0.00,-$4242.19
"Discover",,U,,09/18/2017,"Union 76","Transportation : Gas","Transportation","Gas","",$17.67,$0.00,-$4259.86
"Discover",,U,,09/18/2017,"Pllymouth Brockton","Transportation : Air/train/bus/etc","Transportation","Air/train/bus/etc","Lisa Bus to from airport to visit dad",$49.00,$0.00,-$4308.86
"Discover",,U,,09/18/2017,"Cove RV","RV : Campgrounds","RV","Campgrounds","",$287.04,$0.00,-$4595.90
"Discover",,U,,09/19/2017,"peterson market dennis","Food : Groceries","Food","Groceries","",$10.87,$0.00,-$4606.77
"Discover",,U,,09/19/2017,"rite aid","Personal : Prescriptions, Medicine","Personal","Prescriptions, Medicine","",$30.98,$0.00,-$4637.75
"Discover",,U,,09/20/2017,"Gas","Transportation : Gas","Transportation","Gas","",$15.85,$0.00,-$4653.60
"Discover",,U,,09/20/2017,"tin Brick","Food : Restaurants","Food","Restaurants","Pizza in Port Townsend - Great Town",$29.29,$0.00,-$4682.89
"Discover",,U,,09/22/2017,"Hillbottom Rest","Food : Restaurants","Food","Restaurants","GREAT TIRIMUSU!!!  Port Townsend",$14.99,$0.00,-$4697.88
"Discover",,U,,09/23/2017,"consigning women","Personal : cloths","Personal","cloths","Brewster Ma",$20.00,$0.00,-$4717.88
"Discover",,U,,09/23/2017,"Mirron Hair salon","Personal : Miscellaneous","Personal","Miscellaneous","Hair cut - REALLY",$95.33,$0.00,-$4813.21
"Discover",,U,,09/24/2017,"Gas","Transportation : Gas","Transportation","Gas","Sequim WA",$15.51,$0.00,-$4828.72
"Discover",,U,,09/24/2017,"Wal-mart","Food : Groceries","Food","Groceries","(Split 1/2) ",$80.00,$0.00,-$4930.54
"Discover",,U,,09/24/2017,"Wal-mart","RV : Equipment/Supplies","RV","Equipment/Supplies","(Split 2/2) ",$21.82,$0.00,-$4930.54
"Discover",,U,,09/25/2017,"starbucks","Food : Restaurants","Food","Restaurants","Just for wifi - while waiting to pick up lisa at airport",$2.70,$0.00,-$4933.24
"Discover",,U,,09/25/2017,"","Transportation : Air/train/bus/etc","Transportation","Air/train/bus/etc","Lisa Transport to see DAD",$2.75,$0.00,-$4935.99
"Discover",,U,,09/25/2017,"starbucks","Food : Restaurants","Food","Restaurants","Lisa on way back from cape",$9.52,$0.00,-$4945.51
"Discover",,U,,09/25/2017,"Mariias Pastery","Food : Restaurants","Food","Restaurants","",$18.00,$0.00,-$4963.51
"Discover",,U,,09/25/2017,"Pizsaz pissa","Food : Restaurants","Food","Restaurants","Federal Way WA (greek pizza with alyssa)",$30.00,$0.00,-$4993.51
"Discover",,U,,09/26/2017,"google storage","business (bob) : computer","Hidden Categories","business (bob) ` computer","",$1.99,$0.00,-$4995.50
"Discover",,U,,09/26/2017,"Union 76","Transportation : Gas","Transportation","Gas","",$22.77,$0.00,-$5018.27
"Discover",,U,,09/26/2017,"sea Js cafe townsend","Food : Restaurants","Food","Restaurants","Good fish and Chips in one of our favorite towns",$43.64,$0.00,-$5061.91
"Discover",,U,,09/28/2017,"Walmart","Food : Groceries","Food","Groceries","",$37.67,$0.00,-$5099.58
"Discover",,U,,09/28/2017,"Walmart","RV : Equipment/Supplies","RV","Equipment/Supplies","(Split 1/2) ",$20.00,$0.00,-$5140.61
"Discover",,U,,09/28/2017,"Walmart","Food : Groceries","Food","Groceries","(Split 2/2) ",$21.03,$0.00,-$5140.61
"Discover",,U,,09/28/2017,"butchart Gardens","Recreation : Entertainment","Recreation","Entertainment","",$82.36,$0.00,-$5222.97
"Discover",,U,,09/28/2017,"Black ball ferry","Recreation : Entertainment","Recreation","Entertainment","Ferry to Victoria BC",$111.00,$0.00,-$5333.97
"Discover",,U,,09/30/2017,"Thrifway","Food : Groceries","Food","Groceries","(Split 1/2) ",$22.00,$0.00,-$5365.56
"Discover",,U,,09/30/2017,"Thrifway","RV : Equipment/Supplies","RV","Equipment/Supplies","(Split 2/2) Mouse stuff",$9.59,$0.00,-$5365.56
"Discover",,U,,09/30/2017,"Forks RV PARK","RV : Campgrounds","RV","Campgrounds","",$52.67,$0.00,-$5418.23
"Discover",,U,,10/01/2017,"Trhiftway","Food : Groceries","Food","Groceries","",$12.58,$0.00,-$5430.81
"Discover",,U,,10/01/2017,"thriftway","Food : Groceries","Food","Groceries","FOrks Grocery, cloths hardware - great store",$16.24,$0.00,-$5447.05
"Discover",,U,,10/01/2017,"thriftway","Food : Groceries","Food","Groceries","",$24.00,$0.00,-$5471.05
"Discover",,U,,10/01/2017,"thriftway","Food : Groceries","Food","Groceries","",$26.36,$0.00,-$5497.41
"Discover",,U,,10/02/2017,"USPS","RV : Equipment/Supplies","RV","Equipment/Supplies","Stamps postage",$6.40,$0.00,-$5503.81
"Discover",,U,,10/02/2017,"Shell","Transportation : Gas","Transportation","Gas","",$24.62,$0.00,-$5528.43
"Discover",,U,,10/02/2017,"Trhiftway","Food : Groceries","Food","Groceries","",$24.62,$0.00,-$5553.05
"Discover",,U,,10/02/2017,"thriftway","RV : Equipment/Supplies","RV","Equipment/Supplies","(Split 1/2) ",$15.00,$0.00,-$5602.94
"Discover",,U,,10/02/2017,"thriftway","Food : Groceries","Food","Groceries","(Split 2/2) ",$34.89,$0.00,-$5602.94
"Discover",,U,,10/03/2017,"thriftway","Food : Groceries","Food","Groceries","",$7.48,$0.00,-$5610.42
"Discover",,U,,10/03/2017,"thriftway","Food : Groceries","Food","Groceries","",$10.42,$0.00,-$5620.84
"Discover",,U,,10/03/2017,"thriftway","Food : Groceries","Food","Groceries","",$50.41,$0.00,-$5671.25
"Discover",,U,,10/04/2017,"thriftway","Food : Groceries","Food","Groceries","",$9.50,$0.00,-$5680.75
"Discover",,U,,10/04/2017,"Three rivers resort","Food : Restaurants","Food","Restaurants","",$52.02,$0.00,-$5732.77
"Discover",,U,,10/05/2017,"thriftway","Recreation : Entertainment","Recreation","Entertainment","",$6.99,$0.00,-$5739.76
"Discover",,U,,10/05/2017,"thriftway","Food : Groceries","Food","Groceries","",$15.25,$0.00,-$5755.01
"Discover",,U,,10/06/2017,"Transfer : Dcu Checking",,,,"",$0.00,$2907.28,-$2847.73
"Discover",,U,,10/06/2017,"chinook pharmacy","Personal : nom-prescription medication","Personal","nom-prescription medication","",$5.49,$0.00,-$2853.22
"Discover",,U,,10/06/2017,"Forks 101 RV Park","RV : Campgrounds","RV","Campgrounds","",$16.63,$0.00,-$2869.85
"Discover",,U,,10/06/2017,"thriftway","Recreation : Entertainment","Recreation","Entertainment","",$25.60,$0.00,-$2895.45
"Discover",,U,,10/06/2017,"Forks 101 RV Park","RV : Campgrounds","RV","Campgrounds","",$33.26,$0.00,-$2928.71
"Discover",,U,,10/06/2017,"RMV","Transportation : Registration","Transportation","Registration","RV",$50.00,$0.00,-$2978.71
"Discover",,U,,10/06/2017,"RMV","Transportation : Registration","Transportation","Registration","Lisa car",$60.00,$0.00,-$3038.71
"Discover",,U,,10/07/2017,"thriftway","Food : Groceries","Food","Groceries","",$13.37,$0.00,-$3052.08
"Discover",,U,,10/07/2017,"Shell","Transportation : Gas","Transportation","Gas","",$19.46,$0.00,-$3071.54
"Discover",,U,,10/08/2017,"thriftway","Recreation : Entertainment","Recreation","Entertainment","",$3.24,$0.00,-$3074.78
"Discover",,U,,10/08/2017,"thriftway","Food : Groceries","Food","Groceries","",$87.08,$0.00,-$3161.86
"Discover",,U,,10/09/2017,"thriftway","Food : Groceries","Food","Groceries","coffee",$6.49,$0.00,-$3168.35
"Discover",,U,,10/09/2017,"Gas","RV : gasoline","RV","gasoline","",$75.00,$0.00,-$3243.35
"Discover",,U,,10/10/2017,"Mother Natures Natural","Food : Groceries","Food","Groceries","",$20.95,$0.00,-$3264.30
"Discover",,U,,10/10/2017,"Alaska Air","Transportation : Air/train/bus/etc","Transportation","Air/train/bus/etc","",$306.41,$0.00,-$3570.71
"Discover",,U,,10/10/2017,"Alaska Air","Transportation : Air/train/bus/etc","Transportation","Air/train/bus/etc","",$306.41,$0.00,-$3877.12
"Discover",,U,,10/10/2017,"Alaska Air","Transportation : Air/train/bus/etc","Transportation","Air/train/bus/etc","Trip home",$306.41,$0.00,-$4183.53
"Discover",,U,,10/12/2017,"Gas","RV : gasoline","RV","gasoline","",$63.10,$0.00,-$4246.63
"Discover",,U,,10/13/2017,"redbox","Recreation : Entertainment","Recreation","Entertainment","",$1.50,$0.00,-$4248.13
"Discover",,U,,10/13/2017,"rite aid","Food : Groceries","Food","Groceries","",$3.09,$0.00,-$4251.22
"Discover",,U,,10/13/2017,"safeway groceries","Food : Groceries","Food","Groceries","",$140.47,$0.00,-$4391.69
"Discover",,U,,10/14/2017,"redbox","Recreation : Entertainment","Recreation","Entertainment","",$2.00,$0.00,-$4393.69
"Discover",,U,,10/14/2017,"Gas","Transportation : Gas","Transportation","Gas","",$22.79,$0.00,-$4416.48
"Discover",,U,,10/15/2017,"safeway groceries","Food : Groceries","Food","Groceries","",$18.67,$0.00,-$4435.15
"Discover",,U,,10/15/2017,"WoodVillage Burrito","Food : Restaurants","Food","Restaurants","Cheap eats - really good burritos and cheap",$26.25,$0.00,-$4461.40
"Discover",,U,,10/16/2017,"redbox","Recreation : Entertainment","Recreation","Entertainment","",$2.00,$0.00,-$4463.40
"Discover",,U,,10/16/2017,"Portland Japanese Garden","Recreation : Entertainment","Recreation","Entertainment","With DOLLY",$41.85,$0.00,-$4505.25
"Discover",,U,,10/16/2017,"Town Flowers","Personal : Gifts","Personal","Gifts","Marta Gift",$95.26,$0.00,-$4600.51
"Discover",,U,,10/16/2017,"Piazza Italia","Food : Restaurants","Food","Restaurants","Portland with dolly",$116.25,$0.00,-$4716.76
"Discover",,U,,10/17/2017,"laundry","RV : Laundry","RV","Laundry","",$24.25,$0.00,-$4741.01
"Discover",,U,,10/18/2017,"OR LIquor Store","Food : Groceries","Food","Groceries","OK REALLY BEER FOR BEER AND BRATS with dolly",$10.80,$0.00,-$4751.81
"Discover",,U,,10/18/2017,"Powells","Recreation : Entertainment","Recreation","Entertainment","GREAT BOOK STORE IN PORTLAND",$11.45,$0.00,-$4763.26
"Discover",,U,,10/18/2017,"Gas","Transportation : Gas","Transportation","Gas","",$25.25,$0.00,-$4788.51
"Discover",,U,,10/19/2017,"redbox","Recreation : Entertainment","Recreation","Entertainment","",$1.50,$0.00,-$4790.01
"Discover",,U,,10/19/2017,"Clackamas county park","RV : Campgrounds","RV","Campgrounds","Either park in Oregon City OR or Park in Boring OR",$60.00,$0.00,-$4850.01
"Discover",,U,,10/19/2017,"Safeway store","Food : Groceries","Food","Groceries","",$96.12,$0.00,-$4946.13
"Discover",,U,,10/20/2017,"F&B Cafes","Food : Restaurants","Food","Restaurants","Quick muffin and biscuits snack in Portland",$10.24,$0.00,-$4956.37
"Discover",,U,,10/20/2017,"Powells","Recreation : Entertainment","Recreation","Entertainment","AGAIN",$12.90,$0.00,-$4969.27
"Discover",,U,,10/20/2017,"Fred Myers","Food : Groceries","Food","Groceries","",$39.24,$0.00,-$5008.51
"Discover",,U,,10/20/2017,"Porland Museum of art","Recreation : Entertainment","Recreation","Entertainment","Liaka - stop action automation display plus Wyatts - cool stuff",$46.97,$0.00,-$5055.48
"Discover",,U,,10/21/2017,"redbox","Recreation : Entertainment","Recreation","Entertainment","",$1.50,$0.00,-$5056.98
"Discover",,U,,10/21/2017,"Pioneer Pizza","Food : Restaurants","Food","Restaurants","DESERT WAS GOOD",$6.60,$0.00,-$5063.58
"Discover",,U,,10/21/2017,"Fred Myers","Personal : cloths","Personal","cloths","Jeans for me slippers (and candy) for lisa",$37.47,$0.00,-$5101.05
"Discover",,U,,10/21/2017,"Pioneer Pizza","Food : Restaurants","Food","Restaurants","Watched yankee game - pizza was so-so at best",$66.25,$0.00,-$5167.30
"Discover",,U,,10/22/2017,"Redwood","Food : Restaurants","Food","Restaurants","Enjoyed a dinner with Daniel and Robin",$171.60,$0.00,-$5338.90
"Discover",,U,,10/23/2017,"Arco","Transportation : Gas","Transportation","Gas","",$17.00,$0.00,-$5355.90
"Discover",,U,,10/24/2017,"Powells","Recreation : Entertainment","Recreation","Entertainment","Books!!",$4.50,$0.00,-$5360.40
"Discover",,U,,10/24/2017,"blockbuster","Recreation : Entertainment","Recreation","Entertainment","",$5.25,$0.00,-$5365.65
"Discover",,U,,10/24/2017,"Clackamas county park","RV : Campgrounds","RV","Campgrounds","",$78.00,$0.00,-$5443.65
"Discover",,U,,10/26/2017,"google storage","business (bob) : computer","Hidden Categories","business (bob) ` computer","",$1.99,$0.00,-$5445.64
"Discover",,U,,10/26/2017,"Fred Myers","Food : Groceries","Food","Groceries","",$11.77,$0.00,-$5457.41
"Discover",,U,,10/26/2017,"Gas","Transportation : Gas","Transportation","Gas","",$20.30,$0.00,-$5477.71
"Discover",,U,,10/26/2017,"Wal-mart","Food : Groceries","Food","Groceries","",$24.47,$0.00,-$5502.18
"Discover",,U,,10/26/2017,"Clackamas county park","RV : Campgrounds","RV","Campgrounds","",$26.00,$0.00,-$5528.18
"Discover",,U,,10/26/2017,"scappose groceries","Food : Groceries","Food","Groceries","",$47.03,$0.00,-$5575.21
"Discover",,U,,10/28/2017,"Union 76","RV : gasoline","RV","gasoline","",$50.00,$0.00,-$5625.21
"Discover",,U,,10/28/2017,"Pilot","RV : gasoline","RV","gasoline","",$75.00,$0.00,-$5700.21
"Discover",,U,,10/29/2017,"Gas","Transportation : Gas","Transportation","Gas","",$18.00,$0.00,-$5718.21
"Discover",,U,,10/29/2017,"Beckies Cafe","Food : Restaurants","Food","Restaurants","Very so-so meal at cute place outside Crater Lake NP - should have had PIE!!",$58.49,$0.00,-$5776.70
"Discover",,U,,10/31/2017,"Shell","Transportation : Gas","Transportation","Gas","",$95.00,$0.00,-$5871.70
"Discover",,U,,10/31/2017,"Walmart","Food : Groceries","Food","Groceries","(Split 1/3) ",$110.00,$0.00,-$6045.14
"Discover",,U,,10/31/2017,"Walmart","RV : Equipment/Supplies","RV","Equipment/Supplies","(Split 2/3) ",$53.00,$0.00,-$6045.14
"Discover",,U,,10/31/2017,"Walmart","Personal : cloths","Personal","cloths","(Split 3/3) ",$10.44,$0.00,-$6045.14
"Discover",,U,,11/02/2017,"Emerald Forest","RV : Campgrounds","RV","Campgrounds","",$41.82,$0.00,-$6086.96
"Discover",,U,,11/03/2017,"Wal-mart","RV : Equipment/Supplies","RV","Equipment/Supplies","",$7.70,$0.00,-$6094.66
"Discover",,U,,11/03/2017,"trees of Mystery","Recreation : Entertainment","Recreation","Entertainment","",$54.00,$0.00,-$6148.66
"Discover",,U,,11/03/2017,"Wal-mart","Food : Groceries","Food","Groceries","",$121.43,$0.00,-$6270.09
"Discover",,U,,11/04/2017,"Emerald Forest","RV : Campgrounds","RV","Campgrounds",,$5.49,$0.00,-$6275.58
"Discover",,U,,11/04/2017,"Emerald Forest","Food : Groceries","Food","Groceries","",$15.04,$0.00,-$6290.62
"Discover",,U,,11/04/2017,"Emerald Forest","RV : Campgrounds","RV","Campgrounds","",$71.10,$0.00,-$6361.72
"Discover",,U,,11/06/2017,"Transfer : Dcu Checking",,,,"",$0.00,$4183.53,-$2178.19
"Discover",,U,,11/07/2017,"Cheveron","RV : gasoline","RV","gasoline","",$100.00,$0.00,-$2278.19
"Discover",,U,,11/08/2017,"Cheveron","RV : gasoline","RV","gasoline","",$17.82,$0.00,-$2296.01
"Discover",,U,,11/08/2017,"Exxon mobile","Transportation : Gas","Transportation","Gas",,$20.42,$0.00,-$2316.43
"Discover",,U,,11/08/2017,"Harvest at Medosa","Food : Groceries","Food","Groceries","",$30.83,$0.00,-$2347.26
"Discover",,U,,11/09/2017,"Moodys Organic","Food : Groceries","Food","Groceries","",$2.60,$0.00,-$2349.86
"Discover",,U,,11/09/2017,"safeway","Food : Groceries","Food","Groceries","",$33.68,$0.00,-$2383.54
"Discover",,U,,11/10/2017,"redbox","Recreation : Entertainment","Recreation","Entertainment","",$2.17,$0.00,-$2385.71
"Discover",,U,,11/10/2017,"gasoline","RV : gasoline","RV","gasoline","",$100.00,$0.00,-$2485.71
"Discover",,U,,11/11/2017,"redbox","Recreation : Entertainment","Recreation","Entertainment","",$1.63,$0.00,-$2487.34
"Discover",,U,,11/11/2017,"Barnes and Noble","Recreation : Entertainment","Recreation","Entertainment","GAME",$15.70,$0.00,-$2503.04
"Discover",,U,,11/11/2017,"lucky","Food : Groceries","Food","Groceries","",$23.52,$0.00,-$2526.56
"Discover",,U,,11/11/2017,"S C Fair RV Park","RV : Campgrounds","RV","Campgrounds","santa monica",$87.50,$0.00,-$2614.06
"Discover",,U,,11/11/2017,"Sports Basement","Personal : cloths","Personal","cloths","running shoes",$89.62,$0.00,-$2703.68
"Discover",,U,,11/11/2017,"trader Joes","Food : Groceries","Food","Groceries","",$94.17,$0.00,-$2797.85
"Discover",,U,,11/13/2017,"starbucks","Food : Restaurants","Food","Restaurants","WIFI!",$6.70,$0.00,-$2804.55
"Discover",,U,,11/13/2017,"Rotten Robbie","Transportation : Gas","Transportation","Gas","",$17.39,$0.00,-$2821.94
"Discover",,U,,11/13/2017,"S C Fair RV Park","RV : Campgrounds","RV","Campgrounds","",$31.50,$0.00,-$2853.44
"Discover",,U,,11/13/2017,"Wal-mart","Food : Groceries","Food","Groceries","",$34.66,$0.00,-$2888.10
"Discover",,U,,11/13/2017,"Spud Point Crab","Food : Restaurants","Food","Restaurants","GREAT CLAM CHOWDER and CLAM CAKES Bodega Bay",$40.44,$0.00,-$2928.54
"Discover",,U,,11/13/2017,"Sports Basement","Personal : cloths","Personal","cloths","Hiking shoes",$52.14,$0.00,-$2980.68
"Discover",,U,,11/14/2017,"S C Fair RV Park","RV : Campgrounds","RV","Campgrounds","",$94.50,$0.00,-$3075.18
"Discover",,U,,11/14/2017,"Olema Campground","RV : Campgrounds","RV","Campgrounds","Olema near POINT REYES",$240.00,$0.00,-$3315.18
"Discover",,U,,11/15/2017,"Roxy Stadiom","Recreation : Entertainment","Recreation","Entertainment","MOVIES",$25.50,$0.00,-$3340.68
"Discover",,U,,11/15/2017,"Charles Shultz Musem","Recreation : Entertainment","Recreation","Entertainment","",$29.00,$0.00,-$3369.68
"Discover",,U,,11/16/2017,"Tall Toad Music","Recreation : Entertainment","Recreation","Entertainment","Blue Guitar book",$21.57,$0.00,-$3391.25
"Discover",,U,,11/16/2017,"safeway","Food : Groceries","Food","Groceries","",$35.17,$0.00,-$3426.42
"Discover",,U,,11/16/2017,"Sax's Joint","Food : Restaurants","Food","Restaurants","OVERLY LARGE BREAKFAST",$51.00,$0.00,-$3477.42
"Discover",,U,,11/16/2017,"trader Joes","Food : Groceries","Food","Groceries","",$65.84,$0.00,-$3543.26
"Discover",,U,,11/20/2017,"Gas","Transportation : Gas","Transportation","Gas",,$21.79,$0.00,-$3565.05
"Discover",,U,,11/20/2017,"pacific Catch","Food : Restaurants","Food","Restaurants","",$57.00,$0.00,-$3622.05
"Discover",,U,,11/20/2017,"Amazon","RV : Equipment/Supplies","RV","Equipment/Supplies","Dehumidifier",$61.68,$0.00,-$3683.73
"Discover",,U,,11/22/2017,"Ginger Elizibeth","Food : Restaurants","Food","Restaurants","Chocolate plaze cookie and bark",$9.95,$0.00,-$3693.68
"Discover",,U,,11/22/2017,"Cheveron","RV : gasoline","RV","gasoline","",$80.39,$0.00,-$3774.07
"Discover",,U,,11/22/2017,"savemart","Food : Groceries","Food","Groceries","",$145.30,$0.00,-$3919.37
"Discover",,U,,11/24/2017,"redbox","Recreation : Entertainment","Recreation","Entertainment","",$1.62,$0.00,-$3920.99
"Discover",,U,,11/24/2017,"city of sacremento","Transportation : Parking","Transportation","Parking","",$1.75,$0.00,-$3922.74
"Discover",,U,,11/24/2017,"city of sacremento","Transportation : Parking","Transportation","Parking","",$1.75,$0.00,-$3924.49
"Discover",,U,,11/24/2017,"city of sacremento","Transportation : Parking","Transportation","Parking","Parking in sac",$1.75,$0.00,-$3926.24
"Discover",,U,,11/24/2017,"In n out burger","Food : Restaurants","Food","Restaurants","Over rated!!",$18.64,$0.00,-$3944.88
"Discover",,U,,11/25/2017,"redbox","Recreation : Entertainment","Recreation","Entertainment","",$1.62,$0.00,-$3946.50
"Discover",,U,,11/26/2017,"google storage","business (bob) : computer","Hidden Categories","business (bob) ` computer","",$1.99,$0.00,-$3948.49
"Discover",,U,,11/26/2017,"Raley","Food : Groceries","Food","Groceries","",$3.88,$0.00,-$3952.37
"Discover",,U,,11/26/2017,"Coffee","Food : Restaurants","Food","Restaurants","",$3.98,$0.00,-$3956.35
"Discover",,U,,11/26/2017,"Gas","Transportation : Gas","Transportation","Gas","",$21.06,$0.00,-$3977.41
"Discover",,U,,11/26/2017,"crocker art museum","Recreation : Entertainment","Recreation","Entertainment","Old part of building was beautiful and we liked the art",$28.00,$0.00,-$4005.41
"Discover",,U,,11/26/2017,"Ju Hachi","Food : Restaurants","Food","Restaurants","",$60.00,$0.00,-$4065.41
"Discover",,U,,11/26/2017,"Raley","Food : Groceries","Food","Groceries","",$93.17,$0.00,-$4158.58
"Discover",,U,,11/27/2017,"Yanks","RV : Campgrounds","RV","Campgrounds","",$340.94,$0.00,-$4499.52
"Discover",,U,,11/28/2017,"rite aid","Personal : Prescriptions, Medicine","Personal","Prescriptions, Medicine","",$12.13,$0.00,-$4511.65
"Discover",,U,,11/28/2017,"pinnacle Medical Group","Personal : Doctor, Dentist","Personal","Doctor, Dentist","",$45.00,$0.00,-$4556.65
"Discover",,U,,11/28/2017,"safeway","Food : Groceries","Food","Groceries","",$54.16,$0.00,-$4610.81
"Discover",,U,,11/28/2017,"pinnacle Medical Group","Personal : Doctor, Dentist","Personal","Doctor, Dentist","Med clinic LIsa Urinary tract infection",$95.00,$0.00,-$4705.81
"Discover",,U,,11/30/2017,"Amazon","RV : Equipment/Supplies","RV","Equipment/Supplies","",$192.28,$0.00,-$4898.09
"Discover",,U,,12/01/2017,"Monteray bay equestrian","Recreation : Alyssa Horse","Recreation","Alyssa Horse","",$0.00,$80.00,-$4818.09
"Discover",,U,,12/01/2017,"Gas","Transportation : Gas","Transportation","Gas","",$26.06,$0.00,-$4844.15
"Discover",,U,,12/01/2017,"plaza Garibaldy","Food : Restaurants","Food","Restaurants","",$47.95,$0.00,-$4892.10
"Discover",,U,,12/01/2017,"Samuri Japanese","Food : Restaurants","Food","Restaurants","Alyssa got food poisoning",$98.70,$0.00,-$4990.80
"Discover",,U,,12/01/2017,"Monteray bay equestrian","Recreation : Alyssa Horse","Recreation","Alyssa Horse","",$160.00,$0.00,-$5150.80
"Discover",,U,,12/02/2017,"rite aid","Personal : Prescriptions, Medicine","Personal","Prescriptions, Medicine","",$10.01,$0.00,-$5160.81
"Discover",,U,,12/02/2017,"Ranchos San Miguel","Food : Groceries","Food","Groceries","",$41.17,$0.00,-$5201.98
"Discover",,U,,12/02/2017,"SHS Memorial","Personal : Doctor, Dentist","Personal","Doctor, Dentist","Hospital emergency room Alyssa food poisoning",$500.00,$0.00,-$5701.98
"Discover",,U,,12/03/2017,"wordpress","Recreation : Entertainment","Recreation","Entertainment","BLog",$35.88,$0.00,-$5737.86
"Discover",,U,,12/04/2017,"Amazon","RV : Equipment/Supplies","RV","Equipment/Supplies","",$0.00,$51.61,-$5686.25
"Discover",,U,,12/04/2017,"Yanks","RV : Campgrounds","RV","Campgrounds","",$61.37,$0.00,-$5747.62
"Discover",,U,,12/04/2017,"Ranchos San Miguel","Food : Groceries","Food","Groceries","",$86.43,$0.00,-$5834.05
"Discover",,U,,12/05/2017,"YNP Village Store Fresno","Personal : Gifts","Personal","Gifts","",$6.98,$0.00,-$5841.03
"Discover",,U,,12/05/2017,"Pizza Factory","Food : Restaurants","Food","Restaurants","",$31.84,$0.00,-$5872.87
"Discover",,U,,12/06/2017,"Transfer : Dcu Checking",,,,"",$0.00,$2838.29,-$3034.58
"Discover",,U,,12/07/2017,"Coast Hardward","RV : Equipment/Supplies","RV","Equipment/Supplies","",$4.30,$0.00,-$3038.88
"Discover",,U,,12/07/2017,"Pioneer Market","Food : Groceries","Food","Groceries",,$9.11,$0.00,-$3047.99
"Discover",,U,,12/07/2017,"YNP Village Store Fresno","Personal : Gifts","Personal","Gifts","",$9.46,$0.00,-$3057.45
"Discover",,U,,12/07/2017,"Happy Burger","Food : Restaurants","Food","Restaurants","",$13.98,$0.00,-$3071.43
"Discover",,U,,12/07/2017,"Amazon","Personal : Gifts","Personal","Gifts","",$14.46,$0.00,-$3085.89
"Discover",,U,,12/07/2017,"Epic Alpacas","RV : Equipment/Supplies","RV","Equipment/Supplies","",$17.28,$0.00,-$3103.17
"Discover",,U,,12/07/2017,"Pioneer gas","Transportation : Gas","Transportation","Gas","",$19.39,$0.00,-$3122.56
"Discover",,U,,12/07/2017,"Pioneer Market","Food : Groceries","Food","Groceries","",$26.67,$0.00,-$3149.23
"Discover",,U,,12/07/2017,"teespring","Personal : Gifts","Personal","Gifts","",$28.98,$0.00,-$3178.21
"Discover",,U,,12/07/2017,"Happy Burger","Food : Restaurants","Food","Restaurants","",$33.91,$0.00,-$3212.12
"Discover",,U,,12/09/2017,"golden gate toll","Transportation : tolls","Transportation","tolls","",$7.75,$0.00,-$3219.87
"Discover",,U,,12/10/2017,"Happy Burger","Food : Restaurants","Food","Restaurants","",$9.34,$0.00,-$3229.21
"Discover",,U,,12/10/2017,"Kit fox","RV : Campgrounds","RV","Campgrounds","",$650.00,$0.00,-$3879.21
"Discover",,U,,12/12/2017,"Stewart and Jasper","Personal : Gifts","Personal","Gifts","christmas nuts",$28.55,$0.00,-$3907.76
"Discover",,U,,12/13/2017,"USPS","RV : Equipment/Supplies","RV","Equipment/Supplies","",$12.96,$0.00,-$3920.72
"Discover",,U,,12/13/2017,"Pilot","Transportation : Gas","Transportation","Gas","",$25.53,$0.00,-$3946.25
"Discover",,U,,12/13/2017,"Stewart and Jasper","Personal : Gifts","Personal","Gifts","",$31.10,$0.00,-$3977.35
"Discover",,U,,12/13/2017,"cvs","Personal : Prescriptions, Medicine","Personal","Prescriptions, Medicine","",$37.48,$0.00,-$4014.83
"Discover",,U,,12/14/2017,"Virgin Atlantic","Recreation : Vacation","Recreation","Vacation","Luggage",$25.00,$0.00,-$4039.83
"Discover",,U,,12/14/2017,"Bertolucci's","Food : Restaurants","Food","Restaurants","",$81.83,$0.00,-$4121.66
"Discover",,U,,12/15/2017,"Compass books","Personal : Gifts","Personal","Gifts","",$9.73,$0.00,-$4131.39
"Discover",,U,,12/15/2017,"PEETS COFFEEE SSFO","Food : Restaurants","Food","Restaurants","at ariport",$31.72,$0.00,-$4163.11
"Discover",,U,,12/15/2017,"rosa mexicano","Food : Restaurants","Food","Restaurants","with ISA after ICA",$146.05,$0.00,-$4309.16
"Discover",,U,,12/15/2017,"Holiday inn experess","RV : Hotel","RV","Hotel","AND PARKING`",$424.29,$0.00,-$4733.45
"Discover",,U,,12/16/2017,"cvs","Personal : Prescriptions, Medicine","Personal","Prescriptions, Medicine","",$33.50,$0.00,-$4766.95
"Discover",,U,,12/16/2017,"Delfino","Personal : Gifts","Personal","Gifts","",$100.00,$0.00,-$4866.95
"Discover",,U,,12/17/2017,"itunes","Recreation : Entertainment","Recreation","Entertainment","",$0.84,$0.00,-$4867.79
"Discover",,U,,12/18/2017,"linguines","Food : Restaurants","Food","Restaurants","",$89.77,$0.00,-$4957.56
"Discover",,U,,12/19/2017,"cvs","Personal : Prescriptions, Medicine","Personal","Prescriptions, Medicine","",$7.94,$0.00,-$4965.50
"Discover",,U,,12/19/2017,"Nancies Candy","Personal : Gifts","Personal","Gifts",,$9.63,$0.00,-$4975.13
"Discover",,U,,12/19/2017,"Marshall's","Personal : Gifts","Personal","Gifts","",$10.60,$0.00,-$4985.73
"Discover",,U,,12/19/2017,"USPS","RV : Equipment/Supplies","RV","Equipment/Supplies",,$12.10,$0.00,-$4997.83
"Discover",,U,,12/19/2017,"cvs","Personal : Prescriptions, Medicine","Personal","Prescriptions, Medicine","",$38.08,$0.00,-$5035.91
"Discover",,U,,12/20/2017,"Hot Topic","Personal : Miscellaneous","Personal","Miscellaneous","",$10.00,$0.00,-$5045.91
"Discover",,U,,12/20/2017,"Newbury Comics","Personal : Gifts","Personal","Gifts","",$10.60,$0.00,-$5056.51
"Discover",,U,,12/20/2017,"Amazon","Personal : Gifts","Personal","Gifts","",$14.91,$0.00,-$5071.42
"Discover",,U,,12/20/2017,"stop & shop","Food : Groceries","Food","Groceries","",$15.66,$0.00,-$5087.08
"Discover",,U,,12/20/2017,"Sweet Republic","Personal : Gifts","Personal","Gifts","Lisa xmas",$20.00,$0.00,-$5107.08
"Discover",,U,,12/20/2017,"Marshall's","Personal : cloths","Personal","cloths","",$22.29,$0.00,-$5129.37
"Discover",,U,,12/20/2017,"rite aid","Personal : Gifts","Personal","Gifts","",$56.13,$0.00,-$5185.50
"Discover",,U,,12/20/2017,"Barnes and Noble","Recreation : Entertainment","Recreation","Entertainment","",$85.37,$0.00,-$5270.87
"Discover",,U,,12/21/2017,"Amazon","Personal : Gifts","Personal","Gifts","",$24.97,$0.00,-$5295.84
"Discover",,U,,12/21/2017,"Amazon","Personal : Gifts","Personal","Gifts","",$25.00,$0.00,-$5320.84
"Discover",,U,,12/21/2017,"cts west Ma","Personal : Gifts","Personal","Gifts","",$29.58,$0.00,-$5350.42
"Discover",,U,,12/21/2017,"Royall II restaurant Yarmouth","Food : Restaurants","Food","Restaurants",,$130.00,$0.00,-$5480.42
"Discover",,U,,12/22/2017,"Enterprice care rental","Personal : Miscellaneous","Personal","Miscellaneous","",$17.50,$0.00,-$5497.92
"Discover",,U,,12/22/2017,"american pride tee","Personal : Gifts","Personal","Gifts","",$23.90,$0.00,-$5521.82
"Discover",,U,,12/22/2017,"Entertainment Cinemas","Recreation : Entertainment","Recreation","Entertainment","",$55.00,$0.00,-$5576.82
"Discover",,U,,12/23/2017,"HOUSTON SPCA","Personal : Gifts","Personal","Gifts","",$50.00,$0.00,-$5626.82
"Discover",,U,,12/23/2017,"Royall II restaurant Yarmouth","Food : Restaurants","Food","Restaurants","",$107.75,$0.00,-$5734.57
"Discover",,U,,12/23/2017,"Amazon","Personal : Gifts","Personal","Gifts","",$144.49,$0.00,-$5879.06
"Discover",,U,,12/24/2017,"Fein Things","Personal : Gifts","Personal","Gifts","",$4.03,$0.00,-$5883.09
"Discover",,U,,12/24/2017,"cvs","Personal : Prescriptions, Medicine","Personal","Prescriptions, Medicine","",$4.87,$0.00,-$5887.96
"Discover",,U,,12/24/2017,"seven g's","Food : Groceries","Food","Groceries","nips",$6.25,$0.00,-$5894.21
"Discover",,U,,12/24/2017,"seven g's","Food : Groceries","Food","Groceries","wine",$12.99,$0.00,-$5907.20
"Discover",,U,,12/24/2017,"Marshall's","Personal : Gifts","Personal","Gifts","",$56.27,$0.00,-$5963.47
"Discover",,U,,12/24/2017,"stop & shop","Food : Groceries","Food","Groceries","",$64.08,$0.00,-$6027.55
"Discover",,U,,12/25/2017,"target","Personal : Gifts","Personal","Gifts","",$50.00,$0.00,-$6077.55
"Discover",,U,,12/25/2017,"Uconn","Recreation : Entertainment","Recreation","Entertainment","Bball tickets",$125.00,$0.00,-$6202.55
"Discover",,U,,12/26/2017,"google storage","business (bob) : computer","Hidden Categories","business (bob) ` computer","",$1.99,$0.00,-$6204.54
"Discover",,U,,12/26/2017,"speedway","Transportation : Gas","Transportation","Gas","",$30.88,$0.00,-$6235.42
"Discover",,U,,12/27/2017,"Movies","Recreation : Entertainment","Recreation","Entertainment","",$14.53,$0.00,-$6249.95
"Discover",,U,,12/27/2017,"seatgeek","Personal : Gifts","Personal","Gifts","alyssa ed sheeran",$158.50,$0.00,-$6408.45
"Discover",,U,,12/28/2017,"Marshall's","Personal : Gifts","Personal","Gifts","",$0.00,$14.85,-$6393.60
"Discover",,U,,12/28/2017,"dunkin donuts","Food : Restaurants","Food","Restaurants","",$4.05,$0.00,-$6397.65
"Discover",,U,,12/28/2017,"tjmaxx","Personal : cloths","Personal","cloths","",$27.59,$0.00,-$6425.24
"Discover",,U,,12/28/2017,"Kohls","Personal : Gifts","Personal","Gifts","",$37.12,$0.00,-$6462.36
"Discover",,U,,12/28/2017,"trader Joes","Food : Groceries","Food","Groceries","",$45.29,$0.00,-$6507.65
"Discover",,U,,12/28/2017,"Thai place","Food : Restaurants","Food","Restaurants","",$46.39,$0.00,-$6554.04
"Discover",,U,,12/29/2017,"Acton liquor","Food : Groceries","Food","Groceries","",$13.99,$0.00,-$6568.03
"Discover",,U,,12/30/2017,"Red Rock Grill","Food : Restaurants","Food","Restaurants","",$30.21,$0.00,-$6598.24
"Discover",,U,,12/31/2017,"","Food : Restaurants","Food","Restaurants","",$6.69,$0.00,-$6604.93
"Discover",,U,,12/31/2017,"Walmart","RV : Equipment/Supplies","RV","Equipment/Supplies","",$8.20,$0.00,-$6613.13
"Discover",,U,,12/31/2017,"dunkin donuts","Food : Restaurants","Food","Restaurants","",$15.69,$0.00,-$6628.82
"Discover",,U,,12/31/2017,"Gas","Transportation : Gas","Transportation","Gas","",$24.94,$0.00,-$6653.76
"Discover",,U,,12/31/2017,"uno chicago grill","Food : Restaurants","Food","Restaurants","with cliff",$136.00,$0.00,-$6789.76
"Discover",,U,,01/01/2018,"Bertolucci's","Food : Restaurants","Food","Restaurants","",$107.06,$0.00,-$6896.82
"Discover",,U,,01/02/2018,"Wayside inn","Food : Restaurants","Food","Restaurants","",$60.45,$0.00,-$6957.27
"Discover",,U,,01/02/2018,"Market bskt","Food : Groceries","Food","Groceries","",$118.45,$0.00,-$7075.72
"Discover",,U,,01/03/2018,"Shell","Transportation : Gas","Transportation","Gas","",$24.95,$0.00,-$7100.67
"Discover",,U,,01/04/2018,"Holiday inn","Transportation : Parking","Transportation","Parking","",$27.50,$0.00,-$7128.17
"Discover",,U,,01/05/2018,"Alaska Air","Transportation : Air/train/bus/etc","Transportation","Air/train/bus/etc","bag",$25.00,$0.00,-$7153.17
"Discover",,U,,01/05/2018,"Passport America","RV : clubs","RV","clubs","",$44.00,$0.00,-$7197.17
"Discover",,U,,01/06/2018,"Transfer : Dcu Checking",,,,"",$0.00,$3879.21,-$3317.96
"Discover",,U,,01/06/2018,"lean n green","Food : Restaurants","Food","Restaurants","airport",$15.02,$0.00,-$3332.98
"Discover",,U,,01/06/2018,"Apricot Grill","Food : Restaurants","Food","Restaurants","In Patterson",$32.36,$0.00,-$3365.34
"Discover",,U,,01/06/2018,"Big foot food","Food : Restaurants","Food","Restaurants","airport",$54.00,$0.00,-$3419.34
"Discover",,U,,01/06/2018,"Met Boston","Transportation : Air/train/bus/etc","Transportation","Air/train/bus/etc","Limo",$84.50,$0.00,-$3503.84
"Discover",,U,,01/07/2018,"parking","Transportation : Parking","Transportation","Parking","San Fran",$3.50,$0.00,-$3507.34
"Discover",,U,,01/07/2018,"parking","Transportation : Parking","Transportation","Parking","",$4.00,$0.00,-$3511.34
"Discover",,U,,01/07/2018,"parrking","Lisa Business : Parking","Lisa Business","Parking","",$4.00,$0.00,-$3515.34
"Discover",,U,,01/07/2018,"Blick Art","Recreation : Entertainment","Recreation","Entertainment","",$16.18,$0.00,-$3531.52
"Discover",,U,,01/07/2018,"Exxon mobile","Transportation : Gas","Transportation","Gas","",$26.06,$0.00,-$3557.58
"Discover",,U,,01/07/2018,"Walt disney Museum","Recreation : Entertainment","Recreation","Entertainment","ART",$30.00,$0.00,-$3587.58
"Discover",,U,,01/07/2018,"Sri Vasantha Bhava","Food : Restaurants","Food","Restaurants","Killer peanut sauce",$49.01,$0.00,-$3636.59
"Discover",,U,,01/08/2018,"redbox","Recreation : Entertainment","Recreation","Entertainment","",$1.62,$0.00,-$3638.21
"Discover",,U,,01/08/2018,"Wal-mart","Food : Groceries","Food","Groceries","",$104.18,$0.00,-$3742.39
"Discover",,U,,01/08/2018,"savemart","Food : Groceries","Food","Groceries","",$185.81,$0.00,-$3928.20
"Discover",,U,,01/09/2018,"Wal-mart","Food : Groceries","Food","Groceries","",$100.87,$0.00,-$4029.07
"Discover",,U,,01/10/2018,"USPS","RV : Equipment/Supplies","RV","Equipment/Supplies","",$10.14,$0.00,-$4039.21
"Discover",,U,,01/10/2018,"Pilot","RV : gasoline","RV","gasoline","",$75.00,$0.00,-$4114.21
"Discover",,U,,01/13/2018,"Clingans Junction","Transportation : Gas","Transportation","Gas","",$24.62,$0.00,-$4138.83
"Discover",,U,,01/13/2018,"Project Survival","Recreation : Entertainment","Recreation","Entertainment","cat place",$45.00,$0.00,-$4183.83
"Discover",,U,,01/13/2018,"Chi Chi pizza","Food : Restaurants","Food","Restaurants","",$77.75,$0.00,-$4261.58
"Discover",,U,,01/13/2018,"Valencia Village","RV : Campgrounds","RV","Campgrounds","Good deal with passport for 4 das",$116.00,$0.00,-$4377.58
"Discover",,U,,01/14/2018,"Pilot","RV : gasoline","RV","gasoline","",$75.00,$0.00,-$4452.58
"Discover",,U,,01/15/2018,"Wal-mart","Food : Groceries","Food","Groceries","",$68.26,$0.00,-$4520.84
"Discover",,U,,01/15/2018,"Island Cruisers","Recreation : Entertainment","Recreation","Entertainment","Trip to channel islands",$167.00,$0.00,-$4687.84
"Discover",,U,,01/17/2018,"itunes","Recreation : Entertainment","Recreation","Entertainment","",$0.99,$0.00,-$4688.83
"Discover",,U,,01/18/2018,"starbucks","Food : Restaurants","Food","Restaurants","",$5.20,$0.00,-$4694.03
"Discover",,U,,01/19/2018,"Ralphs","Food : Groceries","Food","Groceries","",$164.70,$0.00,-$4858.73
"Discover",,U,,01/20/2018,"LA Metro","Transportation : Air/train/bus/etc","Transportation","Air/train/bus/etc","",$1.75,$0.00,-$4860.48
"Discover",,U,,01/20/2018,"LA Metro","Transportation : Air/train/bus/etc","Transportation","Air/train/bus/etc","",$1.75,$0.00,-$4862.23
"Discover",,U,,01/20/2018,"LA Metro","Transportation : Air/train/bus/etc","Transportation","Air/train/bus/etc","",$1.75,$0.00,-$4863.98
"Discover",,U,,01/20/2018,"LA Metro","Transportation : Air/train/bus/etc","Transportation","Air/train/bus/etc","",$2.75,$0.00,-$4866.73
"Discover",,U,,01/20/2018,"LA Metro","Transportation : Air/train/bus/etc","Transportation","Air/train/bus/etc","",$2.75,$0.00,-$4869.48
"Discover",,U,,01/20/2018,"LA Metro","Transportation : Air/train/bus/etc","Transportation","Air/train/bus/etc","",$2.75,$0.00,-$4872.23
"Discover",,U,,01/20/2018,"walgreens","Personal : nom-prescription medication","Personal","nom-prescription medication","Gloucosimine",$22.98,$0.00,-$4895.21
"Discover",,U,,01/22/2018,"parking","Transportation : Parking","Transportation","Parking","",$0.75,$0.00,-$4895.96
"Discover",,U,,01/22/2018,"Portfolio","Food : Restaurants","Food","Restaurants","",$9.00,$0.00,-$4904.96
"Discover",,U,,01/22/2018,"USPS","RV : Equipment/Supplies","RV","Equipment/Supplies","",$21.60,$0.00,-$4926.56
"Discover",,U,,01/22/2018,"Gas","Transportation : Gas","Transportation","Gas","",$27.81,$0.00,-$4954.37
"Discover",,U,,01/23/2018,"starbucks","Food : Restaurants","Food","Restaurants","",$2.75,$0.00,-$4957.12
"Discover",,U,,01/23/2018,"disney","Recreation : Entertainment","Recreation","Entertainment","parking",$20.00,$0.00,-$4977.12
"Discover",,U,,01/23/2018,"disney","Recreation : Entertainment","Recreation","Entertainment","Lisa Disney",$97.00,$0.00,-$5074.12
"Discover",,U,,01/24/2018,"parking","Transportation : Parking","Transportation","Parking","",$2.00,$0.00,-$5076.12
"Discover",,U,,01/24/2018,"starbucks","Food : Restaurants","Food","Restaurants","",$6.70,$0.00,-$5082.82
"Discover",,U,,01/25/2018,"starbucks","Food : Restaurants","Food","Restaurants","",$2.75,$0.00,-$5085.57
"Discover",,U,,01/26/2018,"google storage","business (bob) : computer","Hidden Categories","business (bob) ` computer","",$1.99,$0.00,-$5087.56
"Discover",,U,,01/26/2018,"san diago zoo","Recreation : Entertainment","Recreation","Entertainment","",$259.20,$0.00,-$5346.76
"Discover",,U,,01/27/2018,"starbucks","Food : Restaurants","Food","Restaurants","",$6.70,$0.00,-$5353.46
"Discover",,U,,01/27/2018,"Ralphs","Food : Groceries","Food","Groceries","",$37.23,$0.00,-$5390.69
"Discover",,U,,01/27/2018,"trader Joes","Food : Groceries","Food","Groceries","",$91.07,$0.00,-$5481.76
"Discover",,U,,01/29/2018,"starbucks","Food : Restaurants","Food","Restaurants","",$7.70,$0.00,-$5489.46
"Discover",,U,,01/29/2018,"Amc plaze","Recreation : Entertainment","Recreation","Entertainment","",$37.47,$0.00,-$5526.93
"Discover",,U,,01/30/2018,"Bella Pizza","Food : Restaurants","Food","Restaurants","Giddens",$5.00,$0.00,-$5531.93
"Discover",,U,,01/30/2018,"lowes","RV : Equipment/Supplies","RV","Equipment/Supplies","ANT killer",$12.90,$0.00,-$5544.83
"Discover",,U,,01/30/2018,"Gas","Transportation : Gas","Transportation","Gas","",$31.03,$0.00,-$5575.86
"Discover",,U,,01/30/2018,"Bella Pizza","Food : Restaurants","Food","Restaurants","Pizza with Paul and Jamie GIddens",$52.00,$0.00,-$5627.86
"Discover",,U,,01/31/2018,"Wal-mart","Food : Groceries","Food","Groceries","(Split 1/2) ",$130.00,$0.00,-$5795.20
"Discover",,U,,01/31/2018,"Wal-mart","RV : Equipment/Supplies","RV","Equipment/Supplies","(Split 2/2) ",$37.34,$0.00,-$5795.20
"Discover",,U,,02/01/2018,"parking","Transportation : Parking","Transportation","Parking","",$3.25,$0.00,-$5798.45
"Discover",,U,,02/01/2018,"parking","Transportation : Parking","Transportation","Parking","",$3.25,$0.00,-$5801.70
"Discover",,U,,02/01/2018,"trader Joes","Food : Groceries","Food","Groceries","",$8.75,$0.00,-$5810.45
"Discover",,U,,02/01/2018,"cvs","Personal : Prescriptions, Medicine","Personal","Prescriptions, Medicine","",$20.00,$0.00,-$5830.45
"Discover",,U,,02/01/2018,"Carniatas Shack","Food : Restaurants","Food","Restaurants","",$59.08,$0.00,-$5889.53
"Discover",,U,,02/02/2018,"7-11","Transportation : Gas","Transportation","Gas","",$28.44,$0.00,-$5917.97
"Discover",,U,,02/03/2018,"USA Gas","RV : gasoline","RV","gasoline","",$75.00,$0.00,-$5992.97
"Discover",,U,,02/03/2018,"Moranos Travel Center","RV : gasoline","RV","gasoline","",$150.00,$0.00,-$6142.97
"Discover",,U,,02/03/2018,"Catalina Spa RV Resort","RV : Campgrounds","RV","Campgrounds","Dessert how springs - two pools, fitness center - no free wifi",$192.50,$0.00,-$6335.47
"Discover",,U,,02/05/2018,"trader Joes","Food : Groceries","Food","Groceries","",$47.41,$0.00,-$6382.88
"Discover",,U,,02/05/2018,"Taqueria San Miguel","Food : Restaurants","Food","Restaurants","WIth Robbie and Brett",$117.65,$0.00,-$6500.53
"Discover",,U,,02/06/2018,"Transfer : Dcu Checking",,,,"",$0.00,$4013.34,-$2487.19
"Discover",,U,,02/06/2018,"starbucks","Food : Restaurants","Food","Restaurants","",$7.40,$0.00,-$2494.59
"Discover",,U,,02/07/2018,"Gas","Transportation : Gas","Transportation","Gas","",$22.70,$0.00,-$2517.29
"Discover",,U,,02/07/2018,"Two guys Pizza","Food : Restaurants","Food","Restaurants","",$28.00,$0.00,-$2545.29
"Discover",,U,,02/07/2018,"Joshua tree park","Recreation : Entertainment","Recreation","Entertainment","National Park Pass",$80.00,$0.00,-$2625.29
"Discover",,U,,02/08/2018,"Marriot Desert","Food : Restaurants","Food","Restaurants","while waiting for car",$10.88,$0.00,-$2636.17
"Discover",,U,,02/08/2018,"CJS  Palm Desert","Food : Restaurants","Food","Restaurants","",$38.49,$0.00,-$2674.66
"Discover",,U,,02/08/2018,"Catalina Spa RV Resort","RV : Campgrounds","RV","Campgrounds","",$55.00,$0.00,-$2729.66
"Discover",,U,,02/08/2018,"Amazon","RV : Equipment/Supplies","RV","Equipment/Supplies","",$91.34,$0.00,-$2821.00
"Discover",,U,,02/08/2018,"Palms to Pines Auto","Transportation : Repairs & Maintenance","Transportation","Repairs & Maintenance","Car repair Transmission service Oil change tire rotation",$296.22,$0.00,-$3117.22
"Discover",,U,,02/09/2018,"starbucks","Food : Restaurants","Food","Restaurants","",$2.65,$0.00,-$3119.87
"Discover",,U,,02/09/2018,"Albertsons","Food : Groceries","Food","Groceries","",$121.87,$0.00,-$3241.74
"Discover",,U,,02/09/2018,"Palms to Pines Auto","Transportation : Repairs & Maintenance","Transportation","Repairs & Maintenance","Engine Mount",$261.64,$0.00,-$3503.38
"Discover",,U,,02/10/2018,"Joanns Simply Soap","RV : Equipment/Supplies","RV","Equipment/Supplies","Soap for lisa - Nice couple with shop in ""Western Town"" and goats",$15.00,$0.00,-$3518.38
"Discover",,U,,02/10/2018,"Imperial Station","Transportation : Gas","Transportation","Gas","",$23.08,$0.00,-$3541.46
"Discover",,U,,02/10/2018,"Two guys Pizza","Food : Restaurants","Food","Restaurants","",$42.85,$0.00,-$3584.31
"Discover",,U,,02/11/2018,"cvs","Personal : Prescriptions, Medicine","Personal","Prescriptions, Medicine","",$3.70,$0.00,-$3588.01
"Discover",,U,,02/11/2018,"cvs","Personal : Prescriptions, Medicine","Personal","Prescriptions, Medicine","",$17.45,$0.00,-$3605.46
"Discover",,U,,02/11/2018,"JRK Memorial Hosptital","Personal : Doctor, Dentist","Personal","Doctor, Dentist","Lisa ER visit",$50.00,$0.00,-$3655.46
"Discover",,U,,02/11/2018,"Catalina Spa RV Resort","RV : Campgrounds","RV","Campgrounds","",$137.50,$0.00,-$3792.96
"Discover",,U,,02/13/2018,"chathdral city 10","Recreation : Entertainment","Recreation","Entertainment","CHEAP MOVIES",$9.00,$0.00,-$3801.96
"Discover",,U,,02/13/2018,"Food 4less","Food : Groceries","Food","Groceries","",$42.82,$0.00,-$3844.78
"Discover",,U,,02/13/2018,"Ed SHeeran","Recreation : Entertainment","Recreation","Entertainment","Ed Sheeran ticket ALyssa",$277.70,$0.00,-$4122.48
"Discover",,U,,02/14/2018,"Greeting palm spring","Personal : Gifts","Personal","Gifts","vaentines day fits",$8.10,$0.00,-$4130.58
"Discover",,U,,02/14/2018,"kmart","Personal : Gifts","Personal","Gifts","valentines day gifts",$26.85,$0.00,-$4157.43
"Discover",,U,,02/14/2018,"starbucks","Personal : Gifts","Personal","Gifts","Valentines day gifts",$40.00,$0.00,-$4197.43
"Discover",,U,,02/14/2018,"TUCON MEADOWS","RV : Campgrounds","RV","Campgrounds","PLACE THAT WOULD NOT LET ALYSSA STAY - WINTER HAVEN NEAR TUSCON",$50.00,$0.00,-$4247.43
"Discover",,U,,02/14/2018,"mimmos","Food : Restaurants","Food","Restaurants","",$84.80,$0.00,-$4332.23
"Discover",,U,,02/14/2018,"MIFI","RV : Equipment/Supplies","RV","Equipment/Supplies","MIFI",$237.44,$0.00,-$4569.67
"Discover",,U,,02/15/2018,"cathdral city 10","Recreation : Entertainment","Recreation","Entertainment","Cheap movies",$9.00,$0.00,-$4578.67
"Discover",,U,,02/15/2018,"The Living Desert","Recreation : Entertainment","Recreation","Entertainment","ZOO",$39.90,$0.00,-$4618.57
"Discover",,U,,02/16/2018,"Pilot","Transportation : Gas","Transportation","Gas","",$28.88,$0.00,-$4647.45
"Discover",,U,,02/17/2018,"itunes","Recreation : Entertainment","Recreation","Entertainment","",$0.99,$0.00,-$4648.44
"Discover",,U,,02/17/2018,"Silly Als Pizza","Food : Restaurants","Food","Restaurants","Quartz site - with music - interesting place",$35.29,$0.00,-$4683.73
"Discover",,U,,02/19/2018,"pilot subway","Food : Restaurants","Food","Restaurants","",$15.53,$0.00,-$4699.26
"Discover",,U,,02/19/2018,"Arco","RV : gasoline","RV","gasoline","",$75.00,$0.00,-$4774.26
"Discover",,U,,02/19/2018,"Pilot","RV : gasoline","RV","gasoline","",$75.00,$0.00,-$4849.26
"Discover",,U,,02/19/2018,"Jetblue","Transportation : Air/train/bus/etc","Transportation","Air/train/bus/etc","",$181.29,$0.00,-$5030.55
"Discover",,U,,02/20/2018,"SKP SAGUARO","RV : Campgrounds","RV","Campgrounds","DRY CAMPING",$16.74,$0.00,-$5047.29
"Discover",,U,,02/20/2018,"Safeway Benson","Food : Groceries","Food","Groceries","",$171.98,$0.00,-$5219.27
"Discover",,U,,02/21/2018,"SKP SAGUARO","RV : Campgrounds","RV","Campgrounds","",$11.16,$0.00,-$5230.43
"Discover",,U,,02/21/2018,"J&L Silver company","Personal : Miscellaneous","Personal","Miscellaneous","KNick Knacks and post cards",$14.76,$0.00,-$5245.19
"Discover",,U,,02/21/2018,"SKP SAGUARO","RV : Campgrounds","RV","Campgrounds","",$43.33,$0.00,-$5288.52
"Discover",,U,,02/22/2018,"Mia CASA","Food : Restaurants","Food","Restaurants","WITH DICK AND SANDIE - nice people 4 years in Kenya and a year in India!!",$62.00,$0.00,-$5350.52
"Discover",,U,,02/23/2018,"Wal-mart","Food : Groceries","Food","Groceries","(Split 1/3) groceries",$44.77,$0.00,-$5445.29
"Discover",,U,,02/23/2018,"Wal-mart","Personal : cloths","Personal","cloths","(Split 2/3) cloths",$15.00,$0.00,-$5445.29
"Discover",,U,,02/23/2018,"Wal-mart","RV : Equipment/Supplies","RV","Equipment/Supplies","(Split 3/3) ",$35.00,$0.00,-$5445.29
"Discover",,U,,02/23/2018,"safeway","Food : Groceries","Food","Groceries","",$108.65,$0.00,-$5553.94
"Discover",,U,,02/24/2018,"","Personal : Gifts","Personal","Gifts","",$47.93,$0.00,-$5601.87
"Discover",,U,,02/25/2018,"SKP SAGUARO","RV : Campgrounds","RV","Campgrounds","",$122.71,$0.00,-$5724.58
"Discover",,U,,02/26/2018,"google storage","business (bob) : computer","Hidden Categories","business (bob) ` computer","",$1.99,$0.00,-$5726.57
"Discover",,U,,02/26/2018,"Old benson Icecrean","Food : Restaurants","Food","Restaurants","",$10.50,$0.00,-$5737.07
"Discover",,U,,02/26/2018,"mini time machine","Recreation : Entertainment","Recreation","Entertainment","Mini museaum Tuscon",$18.00,$0.00,-$5755.07
"Discover",,U,,02/26/2018,"safeway","Food : Groceries","Food","Groceries","",$36.35,$0.00,-$5791.42
"Discover",,U,,02/27/2018,"Shell","Transportation : Gas","Transportation","Gas","",$20.33,$0.00,-$5811.75
"Discover",,U,,02/27/2018,"AAII","Education : Investing","Education","Investing","",$29.00,$0.00,-$5840.75
"Discover",,U,,03/01/2018,"Old benson Icecrean","Food : Restaurants","Food","Restaurants","",$25.90,$0.00,-$5866.65
"Discover",,U,,03/03/2018,"Safeway Benson","Food : Groceries","Food","Groceries","",$30.24,$0.00,-$5896.89
"Discover",,U,,03/03/2018,"chipolte","Food : Restaurants","Food","Restaurants",,$31.79,$0.00,-$5928.68
"Discover",,U,,03/04/2018,"Shell","Transportation : Gas","Transportation","Gas","",$17.05,$0.00,-$5945.73
"Discover",,U,,03/04/2018,"Roadhouse Cinemas","Food : Restaurants","Food","Restaurants","",$28.32,$0.00,-$5974.05
"Discover",,U,,03/04/2018,"Roadhouse Cinemas","Recreation : Entertainment","Recreation","Entertainment","",$43.74,$0.00,-$6017.79
"Discover",,U,,03/04/2018,"safeway","Food : Groceries","Food","Groceries","",$48.44,$0.00,-$6066.23
"Discover",,U,,03/06/2018,"Amerind foundation","Recreation : Entertainment","Recreation","Entertainment","American indian museum",$30.00,$0.00,-$6096.23
"Discover",,U,,03/06/2018,"Walmart","Food : Groceries","Food","Groceries","(Split 1/2) ",$120.00,$0.00,-$6241.78
"Discover",,U,,03/06/2018,"Walmart","RV : Equipment/Supplies","RV","Equipment/Supplies","(Split 2/2) ",$25.55,$0.00,-$6241.78
"Discover",,U,,03/07/2018,"Transfer : Dcu Checking",,,,"",$0.00,$3792.96,-$2448.82
"Discover",,U,,03/07/2018,"SKP SAGUARO","RV : Campgrounds","RV","Campgrounds","",$122.71,$0.00,-$2571.53
"Discover",,U,,03/08/2018,"Monroe crossing","Recreation : Entertainment","Recreation","Entertainment","CD from great bluegrass band we saw at SKP Saguaro",$15.00,$0.00,-$2586.53
"Discover",,U,,03/08/2018,"86 Cafe","Food : Restaurants","Food","Restaurants","Benson CAFE",$25.02,$0.00,-$2611.55
"Discover",,U,,03/10/2018,"Marshall's","Personal : cloths","Personal","cloths","",$8.64,$0.00,-$2620.19
"Discover",,U,,03/10/2018,"Ross Store","Personal : cloths","Personal","cloths","",$12.96,$0.00,-$2633.15
"Discover",,U,,03/10/2018,"Gas","Transportation : Gas","Transportation","Gas","",$21.07,$0.00,-$2654.22
"Discover",,U,,03/10/2018,"Food City","Food : Groceries","Food","Groceries","",$35.12,$0.00,-$2689.34
"Discover",,U,,03/10/2018,"Burkes","Personal : cloths","Personal","cloths","",$44.03,$0.00,-$2733.37
"Discover",,U,,03/11/2018,"Paw Finders Keepers","Recreation : Entertainment","Recreation","Entertainment","",$21.87,$0.00,-$2755.24
"Discover",,U,,03/11/2018,"Arizona Sonara Desert Museum","Recreation : Entertainment","Recreation","Entertainment","",$74.85,$0.00,-$2830.09
"Discover",,U,,03/12/2018,"CKE Bisee","Food : Restaurants","Food","Restaurants","Pizza Bisbee",$15.33,$0.00,-$2845.42
"Discover",,U,,03/13/2018,"Walmart","Food : Groceries","Food","Groceries","",$0.00,$9.46,-$2835.96
"Discover",,U,,03/13/2018,"Wal-mart","Food : Groceries","Food","Groceries","(Split 1/2) groce",$50.00,$0.00,-$2908.42
"Discover",,U,,03/13/2018,"Wal-mart","RV : Equipment/Supplies","RV","Equipment/Supplies","(Split 2/2) ",$22.46,$0.00,-$2908.42
"Discover",,U,,03/13/2018,"Horse shoe cafe Benson","Food : Restaurants","Food","Restaurants","",$83.00,$0.00,-$2991.42
"Discover",,U,,03/14/2018,"Mustang Maddy","Recreation : Entertainment","Recreation","Entertainment","",$40.00,$0.00,-$3031.42
"Discover",,U,,03/14/2018,"Good Sam","RV : clubs","RV","clubs","",$50.00,$0.00,-$3081.42
"Discover",,U,,03/14/2018,"Turbotax","RV : MISC","RV","MISC","",$84.99,$0.00,-$3166.41
"Discover",,U,,03/14/2018,"Good Sam","RV : clubs","RV","clubs","",$119.95,$0.00,-$3286.36
"Discover",,U,,03/15/2018,"Gas","Transportation : Gas","Transportation","Gas","",$20.11,$0.00,-$3306.47
"Discover",,U,,03/15/2018,"safeway","Food : Groceries","Food","Groceries","",$129.94,$0.00,-$3436.41
"Discover",,U,,03/16/2018,"sonic","Food : Restaurants","Food","Restaurants","icecream",$4.19,$0.00,-$3440.60
"Discover",,U,,03/16/2018,"UK eggroll","Food : Restaurants","Food","Restaurants","",$33.18,$0.00,-$3473.78
"Discover",,U,,03/17/2018,"itunes","Recreation : Entertainment","Recreation","Entertainment","",$0.99,$0.00,-$3474.77
"Discover",,U,,03/17/2018,"redbubble","Personal : cloths","Personal","cloths","",$49.83,$0.00,-$3524.60
"Discover",,U,,03/18/2018,"Shell","Transportation : Gas","Transportation","Gas","",$20.13,$0.00,-$3544.73
"Discover",,U,,03/18/2018,"City of mesa","Recreation : Entertainment","Recreation","Entertainment","natural history museum",$32.00,$0.00,-$3576.73
"Discover",,U,,03/18/2018,"frys","Food : Groceries","Food","Groceries","",$34.49,$0.00,-$3611.22
"Discover",,U,,03/18/2018,"Desert Botanical Garden","Recreation : Entertainment","Recreation","Entertainment","",$99.00,$0.00,-$3710.22
"Discover",,U,,03/19/2018,"Payless Shoes","Personal : cloths","Personal","cloths","",$27.16,$0.00,-$3737.38
"Discover",,U,,03/19/2018,"UOFA Admissions","Recreation : Entertainment","Recreation","Entertainment","biosphere",$55.00,$0.00,-$3792.38
"Discover",,U,,03/20/2018,"Amazon","RV : Equipment/Supplies","RV","Equipment/Supplies","",$23.63,$0.00,-$3816.01
"Discover",,U,,03/20/2018,"Amazon","RV : Equipment/Supplies","RV","Equipment/Supplies","",$87.33,$0.00,-$3903.34
"Discover",,U,,03/21/2018,"redbox","Recreation : Entertainment","Recreation","Entertainment","",$1.63,$0.00,-$3904.97
"Discover",,U,,03/21/2018,"Gas","Transportation : Gas","Transportation","Gas","",$18.56,$0.00,-$3923.53
"Discover",,U,,03/21/2018,"frys","Food : Groceries","Food","Groceries","",$125.83,$0.00,-$4049.36
"Discover",,U,,03/21/2018,"DunRoamin","RV : Campgrounds","RV","Campgrounds","FOR AUGUST",$630.00,$0.00,-$4679.36
"Discover",,U,,03/22/2018,"Food City","Food : Groceries","Food","Groceries","",$1.83,$0.00,-$4681.19
"Discover",,U,,03/22/2018,"bealls","Personal : cloths","Personal","cloths","",$8.69,$0.00,-$4689.88
"Discover",,U,,03/22/2018,"Amazon","RV : Equipment/Supplies","RV","Equipment/Supplies","",$24.99,$0.00,-$4714.87
"Discover",,U,,03/22/2018,"round trip bike","Recreation : Entertainment","Recreation","Entertainment","bike tubes",$25.12,$0.00,-$4739.99
"Discover",,U,,03/22/2018,"shoe dpt encore","Personal : cloths","Personal","cloths","",$54.33,$0.00,-$4794.32
"Discover",,U,,03/24/2018,"SKP SAGUARO","RV : Campgrounds","RV","Campgrounds","",$66.93,$0.00,-$4861.25
"Discover",,U,,03/24/2018,"Pilot","RV : gasoline","RV","gasoline","",$75.00,$0.00,-$4936.25
"Discover",,U,,03/25/2018,"Gas","Transportation : Gas","Transportation","Gas","",$19.25,$0.00,-$4955.50
"Discover",,U,,03/25/2018,"cvs","Personal : Prescriptions, Medicine","Personal","Prescriptions, Medicine","",$20.00,$0.00,-$4975.50
"Discover",,U,,03/25/2018,"Roccos Little Italy","Food : Restaurants","Food","Restaurants","Tuscon deep dish",$57.00,$0.00,-$5032.50
"Discover",,U,,03/25/2018,"cvs","Food : Groceries","Food","Groceries","(Split 1/2) ",$20.00,$0.00,-$5138.37
"Discover",,U,,03/25/2018,"cvs","Personal : nom-prescription medication","Personal","nom-prescription medication","(Split 2/2) ",$85.87,$0.00,-$5138.37
"Discover",,U,,03/26/2018,"google storage","business (bob) : computer","Hidden Categories","business (bob) ` computer","",$1.99,$0.00,-$5140.36
"Discover",,U,,03/26/2018,"Turbotax","RV : MISC","RV","MISC","Electronic filing",$24.99,$0.00,-$5165.35
"Discover",,U,,03/27/2018,"Albertsons","Food : Groceries","Food","Groceries","",$78.62,$0.00,-$5243.97
"Discover",,U,,03/27/2018,"lakeside RV Park","RV : Campgrounds","RV","Campgrounds","",$92.20,$0.00,-$5336.17
"Discover",,U,,03/27/2018,"Love's","RV : gasoline","RV","gasoline","",$123.54,$0.00,-$5459.71
"Discover",,U,,03/29/2018,"Shell","Transportation : Gas","Transportation","Gas","",$21.93,$0.00,-$5481.64
"Discover",,U,,03/29/2018,"Jalisco's","Food : Restaurants","Food","Restaurants","Mexicna silver city",$24.00,$0.00,-$5505.64
"Discover",,U,,03/30/2018,"Brewary Truth or consequence","Food : Restaurants","Food","Restaurants","",$6.00,$0.00,-$5511.64
"Discover",,U,,03/30/2018,"Brewary Truth or consequence","Food : Restaurants","Food","Restaurants","",$11.00,$0.00,-$5522.64
"Discover",,U,,03/30/2018,"","Personal : Gifts","Personal","Gifts","postcards",$20.00,$0.00,-$5542.64
"Discover",,U,,03/30/2018,"Riverbend host springs","Recreation : Entertainment","Recreation","Entertainment","",$20.00,$0.00,-$5562.64
"Discover",,U,,03/30/2018,"food truck t or c","Food : Restaurants","Food","Restaurants","",$20.70,$0.00,-$5583.34
"Discover",,U,,03/31/2018,"Elephabte Butte state park","Recreation : Entertainment","Recreation","Entertainment","Met JACK AND DEBBIE BLUEBIRD",$5.00,$0.00,-$5588.34
"Discover",,U,,03/31/2018,"China Casa","Food : Restaurants","Food","Restaurants","",$27.78,$0.00,-$5616.12
"Discover",,U,,04/02/2018,"Gabbys Handmade soap","Personal : nom-prescription medication","Personal","nom-prescription medication","Lisa skin care",$10.75,$0.00,-$5626.87
"Discover",,U,,04/02/2018,"Central Grill and Coff","Food : Restaurants","Food","Restaurants","Breakfast Alburqueque",$18.75,$0.00,-$5645.62
"Discover",,U,,04/03/2018,"redbox","Recreation : Entertainment","Recreation","Entertainment","",$2.15,$0.00,-$5647.77
"Discover",,U,,04/03/2018,"Albuquerque museum","Recreation : Entertainment","Recreation","Entertainment","",$8.00,$0.00,-$5655.77
"Discover",,U,,04/03/2018,"Vick' Vittles","Food : Restaurants","Food","Restaurants","Breakfast Alburqueque - cowboy theme good food",$28.70,$0.00,-$5684.47
"Discover",,U,,04/03/2018,"Sudbury Valley trustees","Charity : Other","Charity","Other","",$41.20,$0.00,-$5725.67
"Discover",,U,,04/03/2018,"Myers RV","RV : Maintenance","RV","Maintenance","Running lights to toad - was just a blown fuse",$83.89,$0.00,-$5809.56
"Discover",,U,,04/03/2018,"Albertsons","Food : Groceries","Food","Groceries","",$96.55,$0.00,-$5906.11
"Discover",,U,,04/03/2018,"Loves  Fresh Pasta","RV : gasoline","RV","gasoline","",$100.00,$0.00,-$6006.11
"Discover",,U,,04/04/2018,"redbox","Recreation : Entertainment","Recreation","Entertainment","",$1.88,$0.00,-$6007.99
"Discover",,U,,04/04/2018,"amazonprime","RV : MISC","RV","MISC","",$99.00,$0.00,-$6106.99
"Discover",,U,,04/05/2018,"Albuquerque Aquarium","Recreation : Entertainment","Recreation","Entertainment","Bio park with aquarium and cool fantasy garden",$29.00,$0.00,-$6135.99
"Discover",,U,,04/06/2018,"Transfer : Dcu Checking",,,,"",$0.00,$2845.42,-$3290.57
"Discover",,U,,04/06/2018,"Fine Art Gallery Socorro","Personal : Gifts","Personal","Gifts","Where we met guy from MA  - system eng who now owns gallery in socorro",$8.33,$0.00,-$3298.90
"Discover",,U,,04/06/2018,"El Camino","Food : Restaurants","Food","Restaurants","",$21.99,$0.00,-$3320.89
"Discover",,U,,04/06/2018,"Gas","Transportation : Gas","Transportation","Gas","",$22.16,$0.00,-$3343.05
"Discover",,U,,04/06/2018,"casa de Ragals","Personal : Gifts","Personal","Gifts","Socorro place the use to be grocery store - bough T-shirts",$37.60,$0.00,-$3380.65
"Discover",,U,,04/07/2018,"Steves Ice cream","Food : Restaurants","Food","Restaurants","",$9.90,$0.00,-$3390.55
"Discover",,U,,04/08/2018,"redbox","Recreation : Entertainment","Recreation","Entertainment","",$1.88,$0.00,-$3392.43
"Discover",,U,,04/08/2018,"Taqueria  Alandras","Food : Restaurants","Food","Restaurants","",$16.00,$0.00,-$3408.43
"Discover",,U,,04/08/2018,"Pueblo Cultural Center","Recreation : Entertainment","Recreation","Entertainment","",$17.00,$0.00,-$3425.43
"Discover",,U,,04/08/2018,"High Dsert RV","RV : Campgrounds","RV","Campgrounds","",$45.09,$0.00,-$3470.52
"Discover",,U,,04/08/2018,"Smiths","Food : Groceries","Food","Groceries","",$151.75,$0.00,-$3622.27
"Discover",,U,,04/09/2018,"Santa fe Skies","RV : Campgrounds","RV","Campgrounds","",$144.03,$0.00,-$3766.30
"Discover",,U,,04/10/2018,"laundry","RV : Laundry","RV","Laundry","",$5.00,$0.00,-$3771.30
"Discover",,U,,04/10/2018,"laundry","RV : Laundry","RV","Laundry","",$5.00,$0.00,-$3776.30
"Discover",,U,,04/10/2018,"New Mexico Musume of Santay Fe","Recreation : Entertainment","Recreation","Entertainment","",$12.00,$0.00,-$3788.30
"Discover",,U,,04/10/2018,"Tortilla Flats","Food : Restaurants","Food","Restaurants","",$35.02,$0.00,-$3823.32
"Discover",,U,,04/11/2018,"Georgia O'keefe Museum","Recreation : Entertainment","Recreation","Entertainment","",$0.00,$26.00,-$3797.32
"Discover",,U,,04/11/2018,"parking","Transportation : Parking","Transportation","Parking","",$1.00,$0.00,-$3798.32
"Discover",,U,,04/11/2018,"redbox","Recreation : Entertainment","Recreation","Entertainment","",$2.17,$0.00,-$3800.49
"Discover",,U,,04/11/2018,"Georgia O'keefe Museum","Recreation : Entertainment","Recreation","Entertainment","",$26.00,$0.00,-$3826.49
"Discover",,U,,04/11/2018,"Wal-mart","RV : Equipment/Supplies","RV","Equipment/Supplies","",$50.76,$0.00,-$3877.25
"Discover",,U,,04/11/2018,"Santa fe Skies","RV : Campgrounds","RV","Campgrounds","",$144.03,$0.00,-$4021.28
"Discover",,U,,04/11/2018,"Georgia O'keefe Museum","Recreation : Entertainment","Recreation","Entertainment","",$150.00,$0.00,-$4171.28
"Discover",,U,,04/12/2018,"redbox","Recreation : Entertainment","Recreation","Entertainment","",$1.90,$0.00,-$4173.18
"Discover",,U,,04/12/2018,"Gas","Transportation : Gas","Transportation","Gas","",$21.57,$0.00,-$4194.75
"Discover",,U,,04/12/2018,"Wal-mart","Food : Groceries","Food","Groceries","",$49.55,$0.00,-$4244.30
"Discover",,U,,04/12/2018,"Mineshaft Tavern","Food : Restaurants","Food","Restaurants","",$78.70,$0.00,-$4323.00
"Discover",,U,,04/14/2018,"Walmart","Food : Groceries","Food","Groceries","",$36.85,$0.00,-$4359.85
"Discover",,U,,04/14/2018,"liquid light glass","Recreation : Entertainment","Recreation","Entertainment","",$140.97,$0.00,-$4500.82
"Discover",,U,,04/15/2018,"laundry","RV : Laundry","RV","Laundry","",$5.00,$0.00,-$4505.82
"Discover",,U,,04/15/2018,"laundry","RV : Laundry","RV","Laundry","",$5.00,$0.00,-$4510.82
"Discover",,U,,04/15/2018,"Gas","Transportation : Gas","Transportation","Gas","",$20.41,$0.00,-$4531.23
"Discover",,U,,04/15/2018,"The Pantry","Food : Restaurants","Food","Restaurants","Breakfast with Dick and Sandy",$30.58,$0.00,-$4561.81
"Discover",,U,,04/16/2018,"gasoline","RV : gasoline","RV","gasoline","",$100.00,$0.00,-$4661.81
"Discover",,U,,04/17/2018,"itunes","Recreation : Entertainment","Recreation","Entertainment","",$0.77,$0.00,-$4662.58
"Discover",,U,,04/17/2018,"Pistachio Tree","Food : Groceries","Food","Groceries","",$5.95,$0.00,-$4668.53
"Discover",,U,,04/17/2018,"Walmart","RV : Equipment/Supplies","RV","Equipment/Supplies","",$12.20,$0.00,-$4680.73
"Discover",,U,,04/17/2018,"Walmart","RV : Equipment/Supplies","RV","Equipment/Supplies","",$30.43,$0.00,-$4711.16
"Discover",,U,,04/18/2018,"Southwest Airlines","Transportation : Air/train/bus/etc","Transportation","Air/train/bus/etc","Alyssa Flight Back",$130.81,$0.00,-$4841.97
"Discover",,U,,04/19/2018,"carlsbad caverns","Personal : Gifts","Personal","Gifts","Postcards",$8.97,$0.00,-$4850.94
"Discover",,U,,04/19/2018,"White City NM","Personal : cloths","Personal","cloths","",$10.59,$0.00,-$4861.53
"Discover",,U,,04/19/2018,"Gas","Transportation : Gas","Transportation","Gas","",$16.21,$0.00,-$4877.74
"Discover",,U,,04/19/2018,"Albertsons","Food : Groceries","Food","Groceries","",$38.34,$0.00,-$4916.08
"Discover",,U,,04/19/2018,"Amazon","Personal : Miscellaneous","Personal","Miscellaneous","ALyssa ?",$44.01,$0.00,-$4960.09
"Discover",,U,,04/20/2018,"Gas","Transportation : Gas","Transportation","Gas","",$11.59,$0.00,-$4971.68
"Discover",,U,,04/20/2018,"Wal-mart","Food : Groceries","Food","Groceries","",$47.19,$0.00,-$5018.87
"Discover",,U,,04/20/2018,"redbubble","Personal : cloths","Personal","cloths","",$124.12,$0.00,-$5142.99
"Discover",,U,,04/20/2018,"Myers RV","RV : Maintenance","RV","Maintenance","",$158.03,$0.00,-$5301.02
"Discover",,U,,04/21/2018,"Albertsons","Food : Groceries","Food","Groceries","",$19.87,$0.00,-$5320.89
"Discover",,U,,04/22/2018,"drive in","Recreation : Entertainment","Recreation","Entertainment","",$10.00,$0.00,-$5330.89
"Discover",,U,,04/22/2018,"rvtripwiz","RV : Equipment/Supplies","RV","Equipment/Supplies","",$39.00,$0.00,-$5369.89
"Discover",,U,,04/23/2018,"USPS","RV : Equipment/Supplies","RV","Equipment/Supplies","stamps",$14.20,$0.00,-$5384.09
"Discover",,U,,04/23/2018,"Gas","Transportation : Gas","Transportation","Gas","",$23.42,$0.00,-$5407.51
"Discover",,U,,04/24/2018,"shutter fly","Personal : Miscellaneous","Personal","Miscellaneous","",$19.96,$0.00,-$5427.47
"Discover",,U,,04/25/2018,"dvd express","Recreation : Entertainment","Recreation","Entertainment","",$1.61,$0.00,-$5429.08
"Discover",,U,,04/25/2018,"Albertsons","Food : Groceries","Food","Groceries","",$90.25,$0.00,-$5519.33
"Discover",,U,,04/26/2018,"google storage","business (bob) : computer","Hidden Categories","business (bob) ` computer","",$1.99,$0.00,-$5521.32
"Discover",,U,,04/26/2018,"walgreens","Personal : nom-prescription medication","Personal","nom-prescription medication","",$15.61,$0.00,-$5536.93
"Discover",,U,,04/28/2018,"gasoline","RV : gasoline","RV","gasoline","",$95.00,$0.00,-$5631.93
"Discover",,U,,04/28/2018,"Santa fe Skies","RV : Campgrounds","RV","Campgrounds","",$288.00,$0.00,-$5919.93
"Discover",,U,,04/29/2018,"laundry","RV : Laundry","RV","Laundry","",$4.50,$0.00,-$5924.43
"Discover",,U,,04/29/2018,"laundry","RV : Laundry","RV","Laundry","",$5.00,$0.00,-$5929.43
"Discover",,U,,04/29/2018,"laundry","RV : Laundry","RV","Laundry","",$5.00,$0.00,-$5934.43
"Discover",,U,,04/29/2018,"sprouts","Food : Groceries","Food","Groceries","",$161.31,$0.00,-$6095.74
"Discover",,U,,04/30/2018,"Amazon","RV : Equipment/Supplies","RV","Equipment/Supplies","",$22.99,$0.00,-$6118.73
"Discover",,U,,05/01/2018,"redbox","Recreation : Entertainment","Recreation","Entertainment","",$1.90,$0.00,-$6120.63
"Discover",,U,,05/01/2018,"carwasg","Transportation : Repairs & Maintenance","Transportation","Repairs & Maintenance","Car wasg",$13.00,$0.00,-$6133.63
"Discover",,U,,05/01/2018,"Gas","Transportation : Gas","Transportation","Gas","",$19.78,$0.00,-$6153.41
"Discover",,U,,05/01/2018,"Wal-mart","RV : Equipment/Supplies","RV","Equipment/Supplies","",$20.00,$0.00,-$6173.41
"Discover",,U,,05/01/2018,"cafe castro","Food : Restaurants","Food","Restaurants","",$27.00,$0.00,-$6200.41
"Discover",,U,,05/01/2018,"Amazon","Recreation : Entertainment","Recreation","Entertainment","(Split 1/2) ",$76.00,$0.00,-$6476.74
"Discover",,U,,05/01/2018,"Amazon","RV : Equipment/Supplies","RV","Equipment/Supplies","(Split 2/2) ",$200.33,$0.00,-$6476.74
"Discover",,U,,05/03/2018,"parking","Transportation : Parking","Transportation","Parking","",$2.00,$0.00,-$6478.74
"Discover",,U,,05/03/2018,"meow wolf","Recreation : Entertainment","Recreation","Entertainment","",$82.33,$0.00,-$6561.07
"Discover",,U,,05/04/2018,"Santa fe Skies","RV : Laundry","RV","Laundry","",$2.00,$0.00,-$6563.07
"Discover",,U,,05/04/2018,"Santa fe Skies","RV : Laundry","RV","Laundry","",$7.00,$0.00,-$6570.07
"Discover",,U,,05/04/2018,"Gas","Transportation : Gas","Transportation","Gas","",$13.73,$0.00,-$6583.80
"Discover",,U,,05/04/2018,"sprouts","Food : Groceries","Food","Groceries","",$77.62,$0.00,-$6661.42
"Discover",,U,,05/04/2018,"Fort Tuthill","RV : Campgrounds","RV","Campgrounds","County Park near Flagstaff",$166.00,$0.00,-$6827.42
"Discover",,U,,05/05/2018,"gasoline","RV : gasoline","RV","gasoline","",$100.00,$0.00,-$6927.42
"Discover",,U,,05/06/2018,"Transfer : Dcu Checking",,,,"",$0.00,$4120.52,-$2806.90
"Discover",,U,,05/07/2018,"frys","Food : Groceries","Food","Groceries","",$6.48,$0.00,-$2813.38
"Discover",,U,,05/07/2018,"UPS","RV : Equipment/Supplies","RV","Equipment/Supplies","stamps",$7.00,$0.00,-$2820.38
"Discover",,U,,05/07/2018,"Flagstaff Farmers Market","Food : Groceries","Food","Groceries","",$10.86,$0.00,-$2831.24
"Discover",,U,,05/07/2018,"gasoline","RV : gasoline","RV","gasoline","",$50.30,$0.00,-$2881.54
"Discover",,U,,05/07/2018,"frys","Food : Groceries","Food","Groceries","",$125.55,$0.00,-$3007.09
"Discover",,U,,05/09/2018,"UPS","RV : Equipment/Supplies","RV","Equipment/Supplies","",$12.00,$0.00,-$3019.09
"Discover",,U,,05/10/2018,"laundry","RV : Laundry","RV","Laundry","",$7.00,$0.00,-$3026.09
"Discover",,U,,05/10/2018,"Macy's European coffe","Food : Restaurants","Food","Restaurants","ASK LISA",$11.60,$0.00,-$3037.69
"Discover",,U,,05/10/2018,"Gas","Transportation : Gas","Transportation","Gas","",$23.82,$0.00,-$3061.51
"Discover",,U,,05/10/2018,"Blossoms Dennis","Personal : Gifts","Personal","Gifts","Mothers day",$63.13,$0.00,-$3124.64
"Discover",,U,,05/13/2018,"Violas Flowers","RV : Equipment/Supplies","RV","Equipment/Supplies","Flowers for mothers day",$9.62,$0.00,-$3134.26
"Discover",,U,,05/13/2018,"Red Curry","Food : Restaurants","Food","Restaurants","Mother's day dinner - Really good Vegan Restaurant",$51.61,$0.00,-$3185.87
"Discover",,U,,05/14/2018,"Gaosoline","RV : gasoline","RV","gasoline","",$75.00,$0.00,-$3260.87
"Discover",,U,,05/15/2018,"Grand Canyon Store","Food : Restaurants","Food","Restaurants","",$7.60,$0.00,-$3268.47
"Discover",,U,,05/15/2018,"Chevron","Transportation : Gas","Transportation","Gas","",$31.22,$0.00,-$3299.69
"Discover",,U,,05/16/2018,"shutter fly","Personal : Gifts","Personal","Gifts","",$13.20,$0.00,-$3312.89
"Discover",,U,,05/16/2018,"Maswik cafe","Food : Restaurants","Food","Restaurants","",$23.25,$0.00,-$3336.14
"Discover",,U,,05/16/2018,"South rim general store","Food : Groceries","Food","Groceries","",$29.51,$0.00,-$3365.65
"Discover",,U,,05/17/2018,"Micheals","Recreation : Entertainment","Recreation","Entertainment","",$4.35,$0.00,-$3370.00
"Discover",,U,,05/17/2018,"bookmans","Recreation : Entertainment","Recreation","Entertainment","",$4.36,$0.00,-$3374.36
"Discover",,U,,05/17/2018,"Gas","Transportation : Gas","Transportation","Gas","",$12.95,$0.00,-$3387.31
"Discover",,U,,05/17/2018,"Nomads","Food : Restaurants","Food","Restaurants","",$63.82,$0.00,-$3451.13
"Discover",,U,,05/17/2018,"cvs","Personal : Prescriptions, Medicine","Personal","Prescriptions, Medicine","",$70.67,$0.00,-$3521.80
"Discover",,U,,05/17/2018,"sprouts","Food : Groceries","Food","Groceries","",$118.72,$0.00,-$3640.52
"Discover",,U,,05/18/2018,"gasoline","RV : gasoline","RV","gasoline","",$75.00,$0.00,-$3715.52
"Discover",,U,,05/20/2018,"navejo bridge","RV : Equipment/Supplies","RV","Equipment/Supplies","ask lisa",$16.00,$0.00,-$3731.52
"Discover",,U,,05/20/2018,"Walmart","RV : Equipment/Supplies","RV","Equipment/Supplies","",$54.31,$0.00,-$3785.83
"Discover",,U,,05/20/2018,"safeway","Food : Groceries","Food","Groceries","",$129.69,$0.00,-$3915.52
"Discover",,U,,05/21/2018,"thunderbird","RV : Campgrounds","RV","Campgrounds","Mount Carmel Junction outside of zion",$140.65,$0.00,-$4056.17
"Discover",,U,,05/23/2018,"zion mountain Ranch","Recreation : Entertainment","Recreation","Entertainment","ask lisa",$24.78,$0.00,-$4080.95
"Discover",,U,,05/25/2018,"Bit and spur","Food : Restaurants","Food","Restaurants","Verify amount",$62.15,$0.00,-$4143.10
"Discover",,U,,05/26/2018,"google storage","business (bob) : computer","Hidden Categories","business (bob) ` computer","",$1.99,$0.00,-$4145.09
"Discover",,U,,05/26/2018,"Ruby general store","Food : Groceries","Food","Groceries","",$34.41,$0.00,-$4179.50
"Discover",,U,,05/26/2018,"Chevron","RV : gasoline","RV","gasoline","mount carmel",$100.00,$0.00,-$4279.50
"Discover",,U,,05/27/2018,"gas Sinclair","Transportation : Gas","Transportation","Gas","",$29.34,$0.00,-$4308.84
"Discover",,U,,05/29/2018,"Ruby's general store","Food : Groceries","Food","Groceries","",$8.62,$0.00,-$4317.46
"Discover",,U,,05/30/2018,"Ruby Falls","Food : Groceries","Food","Groceries","",$7.54,$0.00,-$4325.00
"Discover",,U,,05/31/2018,"Bhindas Curry","Food : Restaurants","Food","Restaurants","Curry PIZZA! and Great Cauliflower dish",$41.31,$0.00,-$4366.31
"Discover",,U,,05/31/2018,"Canyon Sinclair","RV : propane","RV","propane","",$59.35,$0.00,-$4425.66
"Discover",,U,,05/31/2018,"gasoline","Transportation : Gas","Transportation","Gas","Outside capitol reef",$100.00,$0.00,-$4525.66
"Discover",,U,,05/31/2018,"Royals Foodtown","Food : Groceries","Food","Groceries","10 BAG OF PRODUCE!! - LOA UTAH",$172.00,$0.00,-$4697.66
"Discover",,U,,05/31/2018,"THousand Lakes RV","Transportation : Repairs & Maintenance","Transportation","Repairs & Maintenance","(Split 1/2) Check Engine Light",$40.00,$0.00,-$4921.16
"Discover",,U,,05/31/2018,"THousand Lakes RV","RV : Maintenance","RV","Maintenance","(Split 2/2) Propane Regulator",$183.50,$0.00,-$4921.16
"Discover",,U,,06/02/2018,"firewood","RV : Equipment/Supplies","RV","Equipment/Supplies","",$5.98,$0.00,-$4927.14
"Discover",,U,,06/04/2018,"Goblin Valley","RV : Campgrounds","RV","Campgrounds","Good Campsite - GREAT FUN PLAYING in GOBLIN VALLEY",$30.00,$0.00,-$4957.14
"Discover",,U,,06/05/2018,"Desert Dreams","Personal : cloths","Personal","cloths","",$8.68,$0.00,-$4965.82
"Discover",,U,,06/05/2018,"USPS","RV : Equipment/Supplies","RV","Equipment/Supplies","",$13.90,$0.00,-$4979.72
"Discover",,U,,06/05/2018,"Gas","Transportation : Gas","Transportation","Gas","",$27.59,$0.00,-$5007.31
"Discover",,U,,06/05/2018,"Pasta Jays","Food : Restaurants","Food","Restaurants","",$73.92,$0.00,-$5081.23
"Discover",,U,,06/06/2018,"redbox","Recreation : Entertainment","Recreation","Entertainment","",$1.87,$0.00,-$5083.10
"Discover",,U,,06/06/2018,"Gas","Transportation : Gas","Transportation","Gas","",$18.67,$0.00,-$5101.77
"Discover",,U,,06/06/2018,"wlaker drugs","Personal : nom-prescription medication","Personal","nom-prescription medication","Knee brace",$20.51,$0.00,-$5122.28
"Discover",,U,,06/06/2018,"quesadilla mobilla","Food : Restaurants","Food","Restaurants","FOOD TRUCK good quesadillas",$30.19,$0.00,-$5152.47
"Discover",,U,,06/06/2018,"Moab Giants","Recreation : Entertainment","Recreation","Entertainment","",$34.14,$0.00,-$5186.61
"Discover",,U,,06/06/2018,"city market","Food : Groceries","Food","Groceries","moab",$109.02,$0.00,-$5295.63
"Discover",,U,,06/07/2018,"Transfer : Dcu Checking",,,,"",$0.00,$3124.64,-$2170.99
"Discover",,U,,06/07/2018,"Alzheiimers fund","Charity : Other","Charity","Other","Cliff bike ride",$50.00,$0.00,-$2220.99
"Discover",,U,,06/07/2018,"gasoline","RV : gasoline","RV","gasoline","",$100.00,$0.00,-$2320.99
"Discover",,U,,06/08/2018,"USPS","RV : Equipment/Supplies","RV","Equipment/Supplies","",$6.00,$0.00,-$2326.99
"Discover",,U,,06/08/2018,"Mssa Verde","Recreation : Entertainment","Recreation","Entertainment","cliff dwelling tours",$30.00,$0.00,-$2356.99
"Discover",,U,,06/09/2018,"Wal-mart","RV : Equipment/Supplies","RV","Equipment/Supplies","",$24.38,$0.00,-$2381.37
"Discover",,U,,06/09/2018,"bikes not bombs","Charity : Other","Charity","Other","laura bike ride",$31.50,$0.00,-$2412.87
"Discover",,U,,06/09/2018,"woods & river RV","RV : Campgrounds","RV","Campgrounds","Liked this place on RIO GRANDE",$55.50,$0.00,-$2468.37
"Discover",,U,,06/09/2018,"Montezuma","Food : Restaurants","Food","Restaurants","",$64.61,$0.00,-$2532.98
"Discover",,U,,06/09/2018,"Walmart","RV : Equipment/Supplies","RV","Equipment/Supplies","(Split 1/2) ",$90.00,$0.00,-$2657.93
"Discover",,U,,06/09/2018,"Walmart","Food : Groceries","Food","Groceries","(Split 2/2) ",$34.95,$0.00,-$2657.93
"Discover",,U,,06/10/2018,"Amazon","Personal : Gifts","Personal","Gifts","grammy hummingbirid thing",$20.99,$0.00,-$2678.92
"Discover",,U,,06/10/2018,"Gaosoline","RV : gasoline","RV","gasoline","",$60.70,$0.00,-$2739.62
"Discover",,U,,06/11/2018,"Mi Taquito","Food : Restaurants","Food","Restaurants","",$25.51,$0.00,-$2765.13
"Discover",,U,,06/11/2018,"Gas","Transportation : Gas","Transportation","Gas","",$26.56,$0.00,-$2791.69
"Discover",,U,,06/11/2018,"Charity Gus","Charity : Other","Charity","Other","",$30.00,$0.00,-$2821.69
"Discover",,U,,06/12/2018,"redbox","Recreation : Entertainment","Recreation","Entertainment","",$1.89,$0.00,-$2823.58
"Discover",,U,,06/13/2018,"dinosuar resource ccenter","Recreation : Entertainment","Recreation","Entertainment","",$19.00,$0.00,-$2842.58
"Discover",,U,,06/13/2018,"Progressive Insurance","RV : Insurance","RV","Insurance","",$1549.00,$0.00,-$4391.58
"Discover",,U,,06/14/2018,"Tocabe","Food : Restaurants","Food","Restaurants","Indian tacos",$32.48,$0.00,-$4424.06
"Discover",,U,,06/14/2018,"safeway","Food : Groceries","Food","Groceries","",$125.00,$0.00,-$4549.06
"Discover",,U,,06/14/2018,"sprouts","Food : Groceries","Food","Groceries","",$195.97,$0.00,-$4745.03
"Discover",,U,,06/15/2018,"Denver Zoo","Recreation : Entertainment","Recreation","Entertainment","",$58.00,$0.00,-$4803.03
"Discover",,U,,06/15/2018,"Wal-mart","RV : Equipment/Supplies","RV","Equipment/Supplies","",$183.42,$0.00,-$4986.45
"Discover",,U,,06/16/2018,"King Soopers","Transportation : Gas","Transportation","Gas","",$25.28,$0.00,-$5011.73
"Discover",,U,,06/17/2018,"Sweet cow","Food : Restaurants","Food","Restaurants","Gift - partial payback for dinner Areeya and Ed",$30.00,$0.00,-$5041.73
"Discover",,U,,06/17/2018,"Audrey Janes","Food : Restaurants","Food","Restaurants","Pizza for Fathers day",$43.24,$0.00,-$5084.97
"Discover",,U,,06/17/2018,"Catherines Landing Hot Springg AR","RV : Campgrounds","RV","Campgrounds","Future campground",$341.77,$0.00,-$5426.74
"Discover",,U,,06/18/2018,"Exxon mobile","RV : gasoline","RV","gasoline","",$100.00,$0.00,-$5526.74
"Discover",,U,,06/18/2018,"United airline","Transportation : Air/train/bus/etc","Transportation","Air/train/bus/etc","Lisa Flight to Boston from Denver",$664.40,$0.00,-$6191.14
"Discover",,U,,06/19/2018,"Rocky MTN SNAK BAR GREENWOOD VILCO","Food : Restaurants","Food","Restaurants","",$6.00,$0.00,-$6197.14
"Discover",,U,,06/19/2018,"Tiny Town Eagle","Transportation : Gas","Transportation","Gas","",$16.33,$0.00,-$6213.47
"Discover",,U,,06/21/2018,"Tiny Town Eagle","Transportation : Gas","Transportation","Gas","",$22.54,$0.00,-$6236.01
"Discover",,U,,06/22/2018,"Exxon mobile","RV : gasoline","RV","gasoline","Disputed Clain",$0.00,$100.00,-$6136.01
"Discover",,U,,06/22/2018,"O'Reilly Auto","Transportation : Repairs & Maintenance","Transportation","Repairs & Maintenance","Headlights",$28.19,$0.00,-$6164.20
"Discover",,U,,06/23/2018,"Limon Stop and Shop","Food : Groceries","Food","Groceries","",$41.61,$0.00,-$6205.81
"Discover",,U,,06/24/2018,"travel shppe 7 Bennett co","Transportation : Gas","Transportation","Gas","",$18.53,$0.00,-$6224.34
"Discover",,U,,06/24/2018,"High Plains Diner","Food : Restaurants","Food","Restaurants","",$32.00,$0.00,-$6256.34
"Discover",,U,,06/24/2018,"Wal-mart","RV : Equipment/Supplies","RV","Equipment/Supplies","(Split 1/2) ",$50.00,$0.00,-$6336.63
"Discover",,U,,06/24/2018,"Wal-mart","Food : Groceries","Food","Groceries","(Split 2/2) ",$30.29,$0.00,-$6336.63
"Discover",,U,,06/26/2018,"redbox","Recreation : Entertainment","Recreation","Entertainment","",$1.91,$0.00,-$6338.54
"Discover",,U,,06/26/2018,"google storage","business (bob) : computer","Hidden Categories","business (bob) ` computer","",$1.99,$0.00,-$6340.53
"Discover",,U,,06/26/2018,"terrebonne Po' Boy","Food : Restaurants","Food","Restaurants","GOOD po'boys in Lawrence KS",$34.18,$0.00,-$6374.71
"Discover",,U,,06/26/2018,"Loves Travel Stops","Recreation : Vacation","Recreation","Vacation",,$79.24,$0.00,-$6453.95
"Discover",,U,,06/26/2018,"Cheveron","RV : gasoline","RV","gasoline","",$100.00,$0.00,-$6553.95
"Discover",,U,,06/27/2018,"BP Topeka","Transportation : Gas","Transportation","Gas","",$22.87,$0.00,-$6576.82
"Discover",,U,,06/27/2018,"OZ Museum","Recreation : Entertainment","Recreation","Entertainment","WAMEGO KANSAS - SMALL BUT FUN and NOSTALGIC",$25.00,$0.00,-$6601.82
"Discover",,U,,06/28/2018,"Q 39 Kansas city MO","Food : Restaurants","Food","Restaurants","Kansas City BBQ!  - IT DID NOT DISAPPOINT",$78.66,$0.00,-$6680.48
"Discover",,U,,06/28/2018,"Casey's South Pekin KS","RV : gasoline","RV","gasoline","",$123.51,$0.00,-$6803.99
"Discover",,U,,06/29/2018,"Camp Mi Casa on on the Route","RV : Campgrounds","RV","Campgrounds","Great little campground in Carherage MO - NEAR DRIVIN",$20.00,$0.00,-$6823.99
"Discover",,U,,07/01/2018,"Pilot Hot Spring AR","RV : gasoline","RV","gasoline","",$75.03,$0.00,-$6899.02
"Discover",,U,,07/01/2018,"Krogers Hot Springs","Food : Groceries","Food","Groceries","",$212.94,$0.00,-$7111.96
"Discover",,U,,07/02/2018,"Krogers Hot Springs","Food : Groceries","Food","Groceries",,$14.00,$0.00,-$7125.96
"Discover",,U,,07/02/2018,"Family Dollar Hot springs","Personal : Gifts","Personal","Gifts","Greeting Cards",$14.07,$0.00,-$7140.03
"Discover",,U,,07/03/2018,"Chevron Corona","RV : gasoline","RV","gasoline","Disputed BOGUS CHARGE",$100.00,$0.00,-$7240.03
"Discover",,U,,07/04/2018,"shell Hotsprings","Transportation : Gas","Transportation","Gas","",$22.41,$0.00,-$7262.44
"Discover",,U,,07/04/2018,"Krogers","Food : Groceries","Food","Groceries","",$35.45,$0.00,-$7297.89
"Discover",,U,,07/04/2018,"Bubbas Hot Springs","Food : Restaurants","Food","Restaurants","Great Fried Catfish, shrimp and crawfish",$50.00,$0.00,-$7347.89
"Discover",,U,,07/06/2018,"Transfer : Dcu Checking",,,,"",$0.00,$2821.69,-$4526.20
"Discover",,U,,07/07/2018,"Uaf Gardens Fayettevill AR","Recreation : Entertainment","Recreation","Entertainment","Nice Garden - cool glass chapel",$30.00,$0.00,-$4556.20
"Discover",,U,,07/07/2018,"TOm Sawyer West Memphis AR","RV : Campgrounds","RV","Campgrounds","",$35.00,$0.00,-$4591.20
"Discover",,U,,07/07/2018,"Newks Hotsprings Jackons MS","Food : Restaurants","Food","Restaurants","Takeout meal",$53.38,$0.00,-$4644.58
"Discover",,U,,07/07/2018,"Krogers Hot Springs","Food : Groceries","Food","Groceries","",$55.93,$0.00,-$4700.51
"Discover",,U,,07/08/2018,"TOm Sawyer West Memphis AR","RV : Campgrounds","RV","Campgrounds","",$35.00,$0.00,-$4735.51
"Discover",,U,,07/09/2018,"Rock N Soul Memphis TM","Recreation : Entertainment","Recreation","Entertainment","Cool museum - Great Music",$34.50,$0.00,-$4770.01
"Discover",,U,,07/09/2018,"Gus's Chicken Memphis","Food : Restaurants","Food","Restaurants","",$38.19,$0.00,-$4808.20
"Discover",,U,,07/09/2018,"Leukemia Research Fund","Charity : Other","Charity","Other","In Uncle Henry's Honor",$100.00,$0.00,-$4908.20
"Discover",,U,,07/09/2018,"","RV : Hotel","RV","Hotel","(Split 1/2) Ohio",$600.00,$0.00,-$5931.32
"Discover",,U,,07/09/2018,"","Transportation : Air/train/bus/etc","Transportation","Air/train/bus/etc","(Split 2/2) Care Rental Ohio",$423.12,$0.00,-$5931.32
"Discover",,U,,07/19/2018,"gasoline","RV : gasoline","RV","gasoline","",$0.00,$100.00,-$5831.32
"Discover",,U,,07/19/2018,"gasoline","RV : gasoline","RV","gasoline","",$0.00,$100.00,-$5731.32
"Discover",,U,,07/19/2018,"gasoline","RV : gasoline","RV","gasoline","Returned money -CORANA GAS charge",$0.00,$100.00,-$5631.32
"Discover",,U,,07/19/2018,"Premeir Parking","Lisa Business : Parking","Lisa Business","Parking","Memphis parking",$10.00,$0.00,-$5641.32
"Discover",,U,,08/07/2018,"Transfer : Dcu Checking",,,,"",$0.00,$5641.32,$0.00
"Discover",,U,,08/11/2018,"stop & shop","Food : Groceries","Food","Groceries","sandwich",$9.46,$0.00,-$9.46
"Discover",,U,,08/13/2018,"cvs","Personal : nom-prescription medication","Personal","nom-prescription medication","Kniee brace",$21.71,$0.00,-$31.17
"Discover",,U,,08/13/2018,"Cumberland Farms","Transportation : Gas","Transportation","Gas","",$25.42,$0.00,-$56.59
"Discover",,U,,08/13/2018,"stop & shop","Food : Groceries","Food","Groceries","",$109.10,$0.00,-$165.69
"Discover",,U,,08/14/2018,"stop & shop","Food : Groceries","Food","Groceries","Orleans",$2.84,$0.00,-$168.53
"Discover",,U,,08/14/2018,"south dennis mer","Food : Groceries","Food","Groceries","",$8.49,$0.00,-$177.02
"Discover",,U,,08/14/2018,"displute","RV : gasoline","RV","gasoline","reverse reimbursement that that did too many times",$100.00,$0.00,-$277.02
"Discover",,U,,08/15/2018,"dunkin donuts","Food : Restaurants","Food","Restaurants","",$6.29,$0.00,-$283.31
"Discover",,U,,08/15/2018,"Exxon Yarmouth","Transportation : Gas","Transportation","Gas","",$27.21,$0.00,-$310.52
"Discover",,U,,08/15/2018,"Ocean State Joblot","RV : Equipment/Supplies","RV","Equipment/Supplies","",$58.15,$0.00,-$368.67
"Discover",,U,,08/15/2018,"stop & shop","Food : Groceries","Food","Groceries","",$59.02,$0.00,-$427.69
"Discover",,U,,08/15/2018,"Plymouth and Brock","Transportation : Air/train/bus/etc","Transportation","Air/train/bus/etc","Bus oho",$147.00,$0.00,-$574.69
"Discover",,U,,08/16/2018,"Meeting house","Food : Restaurants","Food","Restaurants","sandwiches",$9.99,$0.00,-$584.68
"Discover",,U,,08/16/2018,"Amazon","RV : Equipment/Supplies","RV","Equipment/Supplies","",$37.49,$0.00,-$622.17
"Discover",,U,,08/16/2018,"Amazon","Personal : Fitness","Personal","Fitness","",$53.14,$0.00,-$675.31
"Discover",,U,,08/16/2018,"stop & shop","Food : Groceries","Food","Groceries","",$91.63,$0.00,-$766.94
"Discover",,U,,08/17/2018,"liquour N more","Food : Groceries","Food","Groceries","beer",$32.97,$0.00,-$799.91
"Discover",,U,,08/17/2018,"Morenas cucina","Food : Restaurants","Food","Restaurants","Stopped on  drive to gloucestor",$35.15,$0.00,-$835.06
"Discover",,U,,08/17/2018,"stop & shop","Food : Groceries","Food","Groceries",,$45.77,$0.00,-$880.83
"Discover",,U,,08/17/2018,"Amazon","Recreation : Entertainment","Recreation","Entertainment","",$82.75,$0.00,-$963.58
"Discover",,U,,08/18/2018,"Shell","Transportation : Gas","Transportation","Gas","wakefield",$25.73,$0.00,-$989.31
"Discover",,U,,08/18/2018,"second glance","Personal : cloths","Personal","cloths","",$29.48,$0.00,-$1018.79
"Discover",,U,,08/18/2018,"Amazon","RV : Equipment/Supplies","RV","Equipment/Supplies","",$46.95,$0.00,-$1065.74
"Discover",,U,,08/20/2018,"Optimist Cafe","Food : Restaurants","Food","Restaurants","",$32.80,$0.00,-$1098.54
"Discover",,U,,08/20/2018,"Walmart","RV : Equipment/Supplies","RV","Equipment/Supplies","",$34.81,$0.00,-$1133.35
"Discover",,U,,08/21/2018,"Shell s dennis","Transportation : Gas","Transportation","Gas","",$22.11,$0.00,-$1155.46
"Discover",,U,,08/21/2018,"Fishermans view Sandwich","Food : Restaurants","Food","Restaurants","",$40.24,$0.00,-$1195.70
"Discover",,U,,08/21/2018,"Percorino Romanos","Food : Restaurants","Food","Restaurants","Anniversary",$46.25,$0.00,-$1241.95
"Discover",,U,,08/21/2018,"stop & shop","Food : Groceries","Food","Groceries","",$91.71,$0.00,-$1333.66
"Discover",,U,,08/22/2018,"stop & shop","Food : Groceries","Food","Groceries","",$1.98,$0.00,-$1335.64
"Discover",,U,,08/22/2018,"stop & shop","Food : Groceries","Food","Groceries","",$31.72,$0.00,-$1367.36
"Discover",,U,,08/22/2018,"stop & shop","Food : Groceries","Food","Groceries","",$35.39,$0.00,-$1402.75
"Discover",,U,,08/22/2018,"cvs","Housing : Supplies","Hidden Categories","Housing ` Supplies","",$52.81,$0.00,-$1455.56
"Discover",,U,,08/23/2018,"Speedway Bellingham","Transportation : Gas","Transportation","Gas","",$17.32,$0.00,-$1472.88
"Discover",,U,,08/23/2018,"Boston Market","Food : Restaurants","Food","Restaurants","",$30.61,$0.00,-$1503.49
"Discover",,U,,08/24/2018,"Tolls COlorado","RV : Tolls","RV","Tolls","",$26.30,$0.00,-$1529.79
"Discover",,U,,08/24/2018,"QUantoom Radiiolgy","Personal : Doctor, Dentist","Personal","Doctor, Dentist","",$34.00,$0.00,-$1563.79
"Discover",,U,,08/24/2018,"Somtum","Food : Restaurants","Food","Restaurants","Mary Alyssa Karina",$75.40,$0.00,-$1639.19
"Discover",,U,,08/25/2018,"Krogers","Food : Groceries","Food","Groceries","",$3.21,$0.00,-$1642.40
"Discover",,U,,08/25/2018,"Krogers","Food : Groceries","Food","Groceries","Cincinati",$11.98,$0.00,-$1654.38
"Discover",,U,,08/26/2018,"Verril Farm","Food : Groceries","Food","Groceries","Pies for lauras party",$33.95,$0.00,-$1688.33
"Discover",,U,,08/27/2018,"Exxon mobile","Transportation : Gas","Transportation","Gas","West Barnstable",$12.05,$0.00,-$1700.38
"Discover",,U,,08/27/2018,"Alamo","Transportation : Air/train/bus/etc","Transportation","Air/train/bus/etc","Car rentail ohio",$83.30,$0.00,-$1783.68
"Discover",,U,,08/28/2018,"Heritage Theatre","Recreation : Entertainment","Recreation","Entertainment","movie Crazy rich asians",$33.00,$0.00,-$1816.68
"Discover",,U,,08/31/2018,"Dunn Gatherin","Food : Restaurants","Food","Restaurants","Newton ma - IRISH PUB",$63.47,$0.00,-$1880.15
"Discover",,U,,09/01/2018,"Meeting house","Food : Restaurants","Food","Restaurants","Sandwich",$9.99,$0.00,-$1890.14
"Discover",,U,,09/01/2018,"stop & shop","Food : Groceries","Food","Groceries","Sandwich",$44.03,$0.00,-$1934.17
"Discover",,U,,09/02/2018,"Wicked Oysster","Food : Restaurants","Food","Restaurants","Wellfleet - with laura and lamar",$293.00,$0.00,-$2227.17
"Discover",,U,,09/03/2018,"Shell","Transportation : Gas","Transportation","Gas","sandwich",$27.87,$0.00,-$2255.04
"Discover",,U,,09/04/2018,"Sweet Water Forest Campground","RV : Campgrounds","RV","Campgrounds","",$40.00,$0.00,-$2295.04
"Discover",,U,,09/05/2018,"cvs","Personal : nom-prescription medication","Personal","nom-prescription medication","",$8.78,$0.00,-$2303.82
"Discover",,U,,09/05/2018,"savers marlboro","Personal : cloths","Personal","cloths","",$35.11,$0.00,-$2338.93
"Discover",,U,,09/05/2018,"cvs","Personal : nom-prescription medication","Personal","nom-prescription medication","",$53.35,$0.00,-$2392.28
"Discover",,U,,09/06/2018,"all star liquor","Food : Restaurants","Food","Restaurants","Gatorade Newton",$3.98,$0.00,-$2396.26
"Discover",,U,,09/06/2018,"Baza Gourmet","Food : Groceries","Food","Groceries","Russian Grocery in Newton",$23.69,$0.00,-$2419.95
"Discover",,U,,09/06/2018,"pho 89","Food : Restaurants","Food","Restaurants","Pho in Randolph on way back from Newton",$48.87,$0.00,-$2468.82
"Discover",,U,,09/06/2018,"stop & shop","Food : Groceries","Food","Groceries","Sandwich",$147.19,$0.00,-$2616.01
"Discover",,U,,09/07/2018,"Transfer : Dcu Checking",,,,"Overpaid balance?",$0.00,$9.46,-$2606.55
"Discover",,U,,09/08/2018,"Frog Rock","Food : Restaurants","Food","Restaurants","",$7.39,$0.00,-$2613.94
"Discover",,U,,09/08/2018,"Frog Rock","Food : Restaurants","Food","Restaurants","",$30.63,$0.00,-$2644.57
"Discover",,U,,09/08/2018,"Sunoco","RV : gasoline","RV","gasoline","",$100.00,$0.00,-$2744.57
"Discover",,U,,09/10/2018,"Exxon mobile","Transportation : Gas","Transportation","Gas","",$19.39,$0.00,-$2763.96
"Discover",,U,,09/10/2018,"Dumpling House","Food : Restaurants","Food","Restaurants","newton",$34.32,$0.00,-$2798.28
"Discover",,U,,09/11/2018,"WIllimatic Brewing","Food : Restaurants","Food","Restaurants","With neal and ann",$100.52,$0.00,-$2898.80
"Discover",,U,,09/11/2018,"Wal-mart","Food : Groceries","Food","Groceries","",$109.91,$0.00,-$3008.71
"Discover",,U,,09/12/2018,"Exxon mobile","Transportation : Gas","Transportation","Gas","Marlboro",$18.82,$0.00,-$3027.53
"Discover",,U,,09/13/2018,"Mansfield Movie","Recreation : Entertainment","Recreation","Entertainment","",$19.00,$0.00,-$3046.53
"Discover",,U,,09/13/2018,"Peppertree","RV : Campgrounds","RV","Campgrounds","",$600.00,$0.00,-$3646.53
"Discover",,U,,09/14/2018,"SOle propriitor","Food : Restaurants","Food","Restaurants","Worcesto",$21.11,$0.00,-$3667.64
"Discover",,U,,09/15/2018,"Ocean State Joblot","RV : Equipment/Supplies","RV","Equipment/Supplies","",$0.00,$25.43,-$3642.21
"Discover",,U,,09/15/2018,"Ocean State Joblot","Recreation : Alyssa","Recreation","Alyssa","(Split 1/2) ",$60.00,$0.00,-$3751.86
"Discover",,U,,09/15/2018,"Ocean State Joblot","RV : Equipment/Supplies","RV","Equipment/Supplies","(Split 2/2) ",$49.65,$0.00,-$3751.86
"Discover",,U,,09/16/2018,"SUnoco Hudson NY","Transportation : Gas","Transportation","Gas","",$25.07,$0.00,-$3776.93
"Discover",,U,,09/16/2018,"The Point","Food : Restaurants","Food","Restaurants","Beers and apps with CARLSBURY",$64.27,$0.00,-$3841.20
"Discover",,U,,09/17/2018,"Main Street Cafe","Food : Restaurants","Food","Restaurants","Marlboro",$20.39,$0.00,-$3861.59
"Discover",,U,,09/17/2018,"Exxon mobile","Transportation : Gas","Transportation","Gas","Hopkinton",$20.89,$0.00,-$3882.48
"Discover",,U,,09/17/2018,"Trombetta","Personal : Gifts","Personal","Gifts","Plants",$28.97,$0.00,-$3911.45
"Discover",,U,,09/17/2018,"A1 auto","Transportation : Repairs & Maintenance","Transportation","Repairs & Maintenance","",$590.65,$0.00,-$4502.10
"Discover",,U,,09/18/2018,"Teeturtle","Personal : Gifts","Personal","Gifts","",$13.94,$0.00,-$4516.04
"Discover",,U,,09/19/2018,"Bushel n Pekc","Food : Groceries","Food","Groceries","",$11.14,$0.00,-$4527.18
"Discover",,U,,09/20/2018,"Francos Trattoria Sudbury","Food : Restaurants","Food","Restaurants","",$16.91,$0.00,-$4544.09
"Discover",,U,,09/20/2018,"RMV Services","Transportation : License Renewal","Transportation","License Renewal","",$50.00,$0.00,-$4594.09
"Discover",,U,,09/21/2018,"cvs","Personal : nom-prescription medication","Personal","nom-prescription medication",,$18.24,$0.00,-$4612.33
"Discover",,U,,09/21/2018,"Citgo Connecticut","Transportation : Gas","Transportation","Gas","",$26.36,$0.00,-$4638.69
"Discover",,U,,09/22/2018,"Price Chopper","Food : Groceries","Food","Groceries","",$9.99,$0.00,-$4648.68
"Discover",,U,,09/22/2018,"Blaze Pizza","Food : Restaurants","Food","Restaurants","",$36.75,$0.00,-$4685.43
"Discover",,U,,09/22/2018,"Price Chopper","Food : Groceries","Food","Groceries","Willamantic",$53.83,$0.00,-$4739.26
"Discover",,U,,09/23/2018,"Rons Ice Cream","Food : Restaurants","Food","Restaurants","Dedham",$24.75,$0.00,-$4764.01
"Discover",,U,,09/23/2018,"Exxon mobile","Transportation : Gas","Transportation","Gas","Stubridge",$26.09,$0.00,-$4790.10
"Discover",,U,,09/23/2018,"American Brain Tumor","Charity : Other","Charity","Other","Rose Runners",$100.00,$0.00,-$4890.10
"Discover",,U,,09/24/2018,"redbox","Recreation : Entertainment","Recreation","Entertainment","",$1.86,$0.00,-$4891.96
"Discover",,U,,09/24/2018,"USPS","RV : Equipment/Supplies","RV","Equipment/Supplies","",$10.00,$0.00,-$4901.96
"Discover",,U,,09/24/2018,"citgo pomfret","Transportation : Gas","Transportation","Gas","",$15.00,$0.00,-$4916.96
"Discover",,U,,09/24/2018,"stop & shop","Food : Groceries","Food","Groceries","Williamantic",$34.65,$0.00,-$4951.61
"Discover",,U,,09/27/2018,"luccas","Food : Restaurants","Food","Restaurants","Leominster DON and CINDIE",$54.00,$0.00,-$5005.61
"Discover",,U,,09/28/2018,"Haus Deli  Northboro","Food : Restaurants","Food","Restaurants","",$12.68,$0.00,-$5018.29
"Discover",,U,,09/28/2018,"Exxon mobile","Transportation : Gas","Transportation","Gas","Shrewsbury",$25.87,$0.00,-$5044.16
"Discover",,U,,09/28/2018,"outback","Food : Restaurants","Food","Restaurants","",$31.19,$0.00,-$5075.35
"Discover",,U,,09/28/2018,"Walmart","Food : Groceries","Food","Groceries","(Split 1/2) ",$80.00,$0.00,-$5235.33
"Discover",,U,,09/28/2018,"Walmart","Financial Help : Alyssa","Financial Help","Alyssa","(Split 2/2) ",$79.98,$0.00,-$5235.33
"Discover",,U,,09/28/2018,"Apple Store","Financial Help : Alyssa","Financial Help","Alyssa","Phone",$583.31,$0.00,-$5818.64
"Discover",,U,,09/29/2018,"Ashford shop","Personal : Gifts","Personal","Gifts","",$11.99,$0.00,-$5830.63
"Discover",,U,,09/29/2018,"Price Chopper","Food : Groceries","Food","Groceries","",$15.98,$0.00,-$5846.61
"Discover",,U,,09/30/2018,"speedway","Transportation : Gas","Transportation","Gas","",$0.95,$0.00,-$5847.56
"Discover",,U,,09/30/2018,"speedway","Transportation : Gas","Transportation","Gas","",$20.47,$0.00,-$5868.03
"Discover",,U,,09/30/2018,"Sweet Water Forest Campground","RV : Campgrounds","RV","Campgrounds","",$230.00,$0.00,-$6098.03
"Discover",Green,U,,10/01/2018,"redbox","Recreation : Entertainment","Recreation","Entertainment","",$1.86,$0.00,-$6099.89
"Discover",Green,U,,10/01/2018,"EHS Optical","Personal : Doctor, Dentist","Personal","Doctor, Dentist","Co-Pat",$10.00,$0.00,-$6109.89
"Discover",Green,U,,10/01/2018,"Primary Care Cape Cod","Personal : Doctor, Dentist","Personal","Doctor, Dentist","",$10.00,$0.00,-$6119.89
"Discover",Green,U,,10/01/2018,"Amazon","RV : Equipment/Supplies","RV","Equipment/Supplies","",$13.39,$0.00,-$6133.28
"Discover",Green,U,,10/01/2018,"RMV E-Services","Transportation : Registration","Transportation","Registration","",$50.00,$0.00,-$6183.28
"Discover",Green,U,,10/01/2018,"stop & shop","Food : Groceries","Food","Groceries","",$55.37,$0.00,-$6238.65
"Discover",Green,U,,10/01/2018,"cvs","Personal : nom-prescription medication","Personal","nom-prescription medication","",$62.57,$0.00,-$6301.22
"Discover",Green,U,,10/01/2018,"EHS Optical","Personal : Doctor, Dentist","Personal","Doctor, Dentist","Eye Glasses",$300.00,$0.00,-$6601.22
"Discover",Green,U,,10/02/2018,"cvs","Personal : nom-prescription medication","Personal","nom-prescription medication","",$11.12,$0.00,-$6612.34
"Discover",Green,U,,10/02/2018,"stop & shop","Food : Groceries","Food","Groceries","",$12.09,$0.00,-$6624.43
"Discover",Green,U,,10/02/2018,"star market","Food : Groceries","Food","Groceries","",$29.81,$0.00,-$6654.24
"Discover",Green,U,,10/02/2018,"Mondovi","Personal : Doctor, Dentist","Personal","Doctor, Dentist","",$149.00,$0.00,-$6803.24
"Discover",Green,U,,10/02/2018,"baskins Hardware","RV : Equipment/Supplies","RV","Equipment/Supplies","NEW WEBER GRILL",$243.31,$0.00,-$7046.55
"Discover",Green,U,,10/03/2018,"Sunoco","Transportation : Gas","Transportation","Gas","",$23.29,$0.00,-$7069.84
"Discover",Green,U,,10/03/2018,"Escapees RV Club","RV : clubs","RV","clubs","",$39.95,$0.00,-$7109.79
"Discover",,U,,10/03/2018,"albertos","Food : Restaurants","Food","Restaurants","",$61.00,$0.00,-$7170.79
"Discover",Green,U,,10/04/2018,"EHS Optical","Personal : Doctor, Dentist","Personal","Doctor, Dentist","co-pay",$18.00,$0.00,-$7188.79
"Discover",Green,U,,10/06/2018,"Transfer : Dcu Checking",,,,"",$0.00,$3008.71,-$4180.08
"Discover",Green,U,,10/06/2018,"speedway","Transportation : Gas","Transportation","Gas","",$19.84,$0.00,-$4199.92
"Discover",Green,U,,10/06/2018,"sir crickets fish & chip","Food : Restaurants","Food","Restaurants","With Ann and Neil",$30.87,$0.00,-$4230.79
"Discover",Green,U,,10/06/2018,"redbubble","Personal : cloths","Personal","cloths","Stuff from Alyssa",$53.66,$0.00,-$4284.45
"Discover",Green,U,,10/07/2018,"BSN SPORTS","Personal : Miscellaneous","Personal","Miscellaneous","WHAT IS THIS?",$79.66,$0.00,-$4364.11
"Discover",Green,U,,10/07/2018,"Wegmans","Food : Groceries","Food","Groceries","",$137.43,$0.00,-$4501.54
"Discover",Green,U,,10/08/2018,"stop & shop","Food : Groceries","Food","Groceries","",$22.59,$0.00,-$4524.13
"Discover",Green,U,,10/08/2018,"RMV","Transportation : License Renewal","Transportation","License Renewal","",$50.00,$0.00,-$4574.13
"Discover",Green,U,,10/09/2018,"cvs","Personal : nom-prescription medication","Personal","nom-prescription medication","",$8.35,$0.00,-$4582.48
"Discover",Green,U,,10/09/2018,"seven g's","Food : Groceries","Food","Groceries","",$24.99,$0.00,-$4607.47
"Discover",Green,U,,10/09/2018,"stop & shop","Food : Groceries","Food","Groceries","",$74.93,$0.00,-$4682.40
"Discover",Green,U,,10/09/2018,"Mondovi","Personal : Doctor, Dentist","Personal","Doctor, Dentist","",$149.00,$0.00,-$4831.40
"Discover",Green,U,,10/09/2018,"EHS Optical","Personal : Doctor, Dentist","Personal","Doctor, Dentist","Glasses",$258.10,$0.00,-$5089.50
"Discover",Green,U,,10/10/2018,"Amazon","RV : Equipment/Supplies","RV","Equipment/Supplies","",$8.49,$0.00,-$5097.99
"Discover",Green,U,,10/10/2018,"Shell","Transportation : Gas","Transportation","Gas","",$25.62,$0.00,-$5123.61
"Discover",Green,U,,10/10/2018,"cvs","Personal : nom-prescription medication","Personal","nom-prescription medication","",$45.83,$0.00,-$5169.44
"Discover",Green,U,,10/10/2018,"Plymouth and Brock","Transportation : Air/train/bus/etc","Transportation","Air/train/bus/etc","",$98.00,$0.00,-$5267.44
"Discover",Green,U,,10/10/2018,"airbnb","Recreation : Hotel","Recreation","Hotel","PARIS AIRB&B",$436.17,$0.00,-$5703.61
"Discover",Green,U,,10/11/2018,"Bopha Angkors Stir Crazy","Food : Restaurants","Food","Restaurants","",$34.00,$0.00,-$5737.61
"Discover",Green,U,,10/11/2018,"YCC Fundraising","Personal : Gifts","Personal","Gifts","fund raiser KATE?",$45.18,$0.00,-$5782.79
"Discover",Green,U,,10/11/2018,"Kays","Food : Restaurants","Food","Restaurants","with cliff",$53.00,$0.00,-$5835.79
"Discover",Green,U,,10/11/2018,"Mondovi","Personal : Doctor, Dentist","Personal","Doctor, Dentist","",$302.00,$0.00,-$6137.79
"Discover",Green,U,,10/12/2018,"cvs","Personal : nom-prescription medication","Personal","nom-prescription medication","",$9.00,$0.00,-$6146.79
"Discover",Green,U,,10/12/2018,"careington International","Personal : Doctor, Dentist","Personal","Doctor, Dentist","Discount dental plan",$109.00,$0.00,-$6255.79
"Discover",Green,U,,10/14/2018,"sbarro","Food : Restaurants","Food","Restaurants","airport - awful food",$19.98,$0.00,-$6275.77
"Discover",Green,U,,10/15/2018,"starbucks","Food : Restaurants","Food","Restaurants","IN Frankfort - took discover?",$17.08,$0.00,-$6292.85
"Discover",Green,U,,10/17/2018,"itunes","Recreation : Entertainment","Recreation","Entertainment","",$0.62,$0.00,-$6293.47
"Discover",Green,U,,11/02/2018,"workamper news","RV : clubs","RV","clubs","workampers site",$39.95,$0.00,-$6333.42
"Discover",Green,U,,11/02/2018,"stop & shop","Food : Groceries","Food","Groceries","Dennis Ma",$149.35,$0.00,-$6482.77
"Discover",Green,U,,11/03/2018,"actblue","Personal : Miscellaneous","Personal","Miscellaneous","Political contribution",$16.50,$0.00,-$6499.27
"Discover",Green,U,,11/03/2018,"speedway","Transportation : Gas","Transportation","Gas","Hyannis",$26.58,$0.00,-$6525.85
"Discover",Green,U,,11/05/2018,"Sangria","Food : Restaurants","Food","Restaurants","Newton Topas with family",$200.00,$0.00,-$6725.85
"Discover",Green,U,,11/06/2018,"Walmart","RV : Equipment/Supplies","RV","Equipment/Supplies","",$16.35,$0.00,-$6742.20
"Discover",Green,U,,11/06/2018,"speedway","Transportation : Gas","Transportation","Gas","Bellingham",$22.14,$0.00,-$6764.34
"Discover",Green,U,,11/06/2018,"stop & shop","Food : Groceries","Food","Groceries","Dennis",$46.52,$0.00,-$6810.86
"Discover",Green,U,,11/07/2018,"Transfer : Dcu Checking",,,,"",$0.00,$6193.79,-$617.07
"Discover",Green,U,,11/08/2018,"cvs","Personal : nom-prescription medication","Personal","nom-prescription medication","",$9.01,$0.00,-$626.08
"Discover",Green,U,,11/08/2018,"dunkin donuts","Food : Restaurants","Food","Restaurants","",$10.33,$0.00,-$636.41
"Discover",Green,U,,11/08/2018,"midcape","RV : Equipment/Supplies","RV","Equipment/Supplies","Boards for leveling",$22.87,$0.00,-$659.28
"Discover",Green,U,,11/08/2018,"monroe motors","Transportation : Repairs & Maintenance","Transportation","Repairs & Maintenance","Oil change",$37.11,$0.00,-$696.39
"Discover",Green,U,,11/08/2018,"stop & shop","Food : Groceries","Food","Groceries","Dennis",$147.18,$0.00,-$843.57
"Discover",Green,U,,11/09/2018,"stop & shop","Food : Groceries","Food","Groceries","dennis",$78.46,$0.00,-$922.03
"Discover",Green,U,,11/10/2018,"Gerardos Cupcakes","Food : Groceries","Food","Groceries","Bakery in westboro",$26.38,$0.00,-$948.41
"Discover",Green,U,,11/10/2018,"Briarcliff RV resort","RV : Campgrounds","RV","Campgrounds","",$41.20,$0.00,-$989.61
"Discover",Green,U,,11/10/2018,"ga park","RV : Campgrounds","RV","Campgrounds","",$44.94,$0.00,-$1034.55
"Discover",Green,U,,11/11/2018,"cliffhouse pizza","Food : Restaurants","Food","Restaurants","",$130.54,$0.00,-$1165.09
"Discover",Green,U,,11/11/2018,"Wegmans","Financial Help : Alyssa","Financial Help","Alyssa","(Split 1/2) ",$200.00,$0.00,-$1389.81
"Discover",Green,U,,11/11/2018,"Wegmans","Food : Groceries","Food","Groceries","(Split 2/2) ",$24.72,$0.00,-$1389.81
"Discover",Green,U,,11/12/2018,"Shell","RV : gasoline","RV","gasoline","cape code",$56.98,$0.00,-$1446.79
"Discover",Green,U,,11/12/2018,"Shell","RV : gasoline","RV","gasoline","dupont pa",$95.00,$0.00,-$1541.79
"Discover",Green,U,,11/13/2018,"americamp","RV : Campgrounds","RV","Campgrounds","Ashland VA",$42.49,$0.00,-$1584.28
"Discover",Green,U,,11/13/2018,"americamp","RV : propane","RV","propane","",$50.99,$0.00,-$1635.27
"Discover",Green,U,,11/13/2018,"greg normam","Food : Restaurants","Food","Restaurants","with TK and Barb SC",$75.82,$0.00,-$1711.09
"Discover",,U,,11/14/2018,"Loves gas","RV : gasoline","RV","gasoline","Skipers Va",$125.00,$0.00,-$1836.09
"Discover",Green,U,,11/14/2018,"American airlines","Financial Help : Alyssa","Financial Help","Alyssa","",$401.40,$0.00,-$2237.49
"Discover",,U,,11/15/2018,"redbox","Recreation : Entertainment","Recreation","Entertainment","",$1.85,$0.00,-$2239.34
"Discover",,U,,11/15/2018,"Ross Store","Personal : cloths","Personal","cloths","",$6.47,$0.00,-$2245.81
"Discover",,U,,11/15/2018,"Marshall's","Personal : cloths","Personal","cloths","",$48.59,$0.00,-$2294.40
"Discover",,U,,11/15/2018,"luigi's","Food : Restaurants","Food","Restaurants","",$53.37,$0.00,-$2347.77
"Discover",Green,U,,11/15/2018,"Grand Prix Driving School","Financial Help : Alyssa","Financial Help","Alyssa","",$60.00,$0.00,-$2407.77
"Discover",,U,,11/15/2018,"bi-lo","Food : Groceries","Food","Groceries","SC",$169.04,$0.00,-$2576.81
"Discover",,U,,11/16/2018,"redbox","Recreation : Entertainment","Recreation","Entertainment","",$1.85,$0.00,-$2578.66
"Discover",,U,,11/16/2018,"Brookgreen Gardens","Recreation : Entertainment","Recreation","Entertainment","",$36.00,$0.00,-$2614.66
"Discover",,U,,11/16/2018,"Food lion","Food : Groceries","Food","Groceries","",$43.16,$0.00,-$2657.82
"Discover",,U,,11/17/2018,"Applie Itunes","Recreation : Entertainment","Recreation","Entertainment",,$0.99,$0.00,-$2658.81
"Discover",,U,,11/17/2018,"Amazon","Recreation : Entertainment","Recreation","Entertainment","Bob Art Supplies",$15.81,$0.00,-$2674.62
"Discover",,U,,11/17/2018,"la bell ami vineyard","Recreation : Entertainment","Recreation","Entertainment","",$15.86,$0.00,-$2690.48
"Discover",,U,,11/17/2018,"Amazon","RV : Equipment/Supplies","RV","Equipment/Supplies","",$70.70,$0.00,-$2761.18
"Discover",,U,,11/18/2018,"Broward","RV : Campgrounds","RV","Campgrounds","",$313.60,$0.00,-$3074.78
"Discover",,U,,11/18/2018,"Broward","RV : Campgrounds","RV","Campgrounds","",$313.60,$0.00,-$3388.38
"Discover",,U,,11/19/2018,"Belkd Myrtle Beack","Personal : cloths","Personal","cloths","",$79.41,$0.00,-$3467.79
"Discover",,U,,11/19/2018,"Original Benjamiins","Food : Restaurants","Food","Restaurants","sc",$121.76,$0.00,-$3589.55
"Discover",,U,,11/20/2018,"upscale retail","Personal : cloths","Personal","cloths","",$51.80,$0.00,-$3641.35
"Discover",,U,,11/20/2018,"Wise Device","Personal : Miscellaneous","Personal","Miscellaneous","Phone Repair",$95.00,$0.00,-$3736.35
"Discover",,U,,11/20/2018,"Recreation.gov","RV : Campgrounds","RV","Campgrounds","alexander Springs Fl",$104.00,$0.00,-$3840.35
"Discover",,U,,11/20/2018,"brevard cty","RV : Campgrounds","RV","Campgrounds","",$407.68,$0.00,-$4248.03
"Discover",,U,,11/21/2018,"redbox","Recreation : Entertainment","Recreation","Entertainment","",$1.85,$0.00,-$4249.88
"Discover",,U,,11/21/2018,"Murphys","Transportation : Gas","Transportation","Gas","Surfside beach",$18.76,$0.00,-$4268.64
"Discover",,U,,11/21/2018,"fresh market","Food : Groceries","Food","Groceries","Myrtle",$23.84,$0.00,-$4292.48
"Discover",,U,,11/21/2018,"publxi","Food : Groceries","Food","Groceries","Myrtle beach",$35.41,$0.00,-$4327.89
"Discover",,U,,11/23/2018,"Ducatis","Food : Restaurants","Food","Restaurants","pizza with tk and barb",$33.58,$0.00,-$4361.47
"Discover",,U,,11/23/2018,"Walmart","RV : Equipment/Supplies","RV","Equipment/Supplies","Buzzer toilet paper...",$34.92,$0.00,-$4396.39
"Discover",,U,,11/24/2018,"Savanh bee","Personal : nom-prescription medication","Personal","nom-prescription medication","Hand stuff for lisa",$28.78,$0.00,-$4425.17
"Discover",,U,,11/24/2018,"Pilot","RV : gasoline","RV","gasoline","",$75.00,$0.00,-$4500.17
"Discover",,U,,11/25/2018,"Jalepenos","Food : Restaurants","Food","Restaurants","Savannah",$26.00,$0.00,-$4526.17
"Discover",,U,,11/25/2018,"Aspira ONE-GA","RV : Campgrounds","RV","Campgrounds","camping skidaway",$229.70,$0.00,-$4755.87
"Discover",,U,,11/26/2018,"redbox","Recreation : Entertainment","Recreation","Entertainment","",$1.87,$0.00,-$4757.74
"Discover",,U,,11/26/2018,"city of tybee","Transportation : Parking","Transportation","Parking","",$4.00,$0.00,-$4761.74
"Discover",,U,,11/26/2018,"USPS","RV : Equipment/Supplies","RV","Equipment/Supplies","",$5.54,$0.00,-$4767.28
"Discover",,U,,11/26/2018,"Tybean","Food : Restaurants","Food","Restaurants","coffee",$12.00,$0.00,-$4779.28
"Discover",,U,,11/26/2018,"Wal-mart","Food : Groceries","Food","Groceries","",$137.02,$0.00,-$4916.30
"Discover",,U,,11/27/2018,"district cafe","Food : Restaurants","Food","Restaurants","coffee in savannah",$8.28,$0.00,-$4924.58
"Discover",,U,,11/27/2018,"redbubble","Personal : Gifts","Personal","Gifts","",$53.08,$0.00,-$4977.66
"Discover",,U,,11/28/2018,"cvs","Personal : Prescriptions, Medicine","Personal","Prescriptions, Medicine","inhaler",$20.00,$0.00,-$4997.66
"Discover",,U,,11/28/2018,"Nat Park","Personal : Gifts","Personal","Gifts","",$50.00,$0.00,-$5047.66
"Discover",,U,,11/29/2018,"Wal-mart","Personal : Miscellaneous","Personal","Miscellaneous","",$0.00,$29.18,-$5018.48
"Discover",,U,,11/29/2018,"wow factory","Personal : Gifts","Personal","Gifts","",$16.54,$0.00,-$5035.02
"Discover",,U,,11/29/2018,"Amazon","Personal : Gifts","Personal","Gifts","",$20.20,$0.00,-$5055.22
"Discover",,U,,11/29/2018,"amc savanna","Recreation : Entertainment","Recreation","Entertainment","movies - Bohemina Rhapsody",$22.44,$0.00,-$5077.66
"Discover",,U,,11/29/2018,"walgreens","Personal : Miscellaneous","Personal","Miscellaneous","",$29.18,$0.00,-$5106.84
"Discover",,U,,11/30/2018,"recetrack","Transportation : Gas","Transportation","Gas","Eustis Fl",$16.03,$0.00,-$5122.87
"Discover",,U,,11/30/2018,"giant oil","RV : gasoline","RV","gasoline","",$100.00,$0.00,-$5222.87
"Discover",,U,,12/01/2018,"mt dora pizza","Food : Restaurants","Food","Restaurants","",$37.51,$0.00,-$5260.38
"Discover",,U,,12/01/2018,"Shiva Indian","Food : Restaurants","Food","Restaurants","mt dora",$80.00,$0.00,-$5340.38
"Discover",,U,,12/02/2018,"triple Z","Food : Groceries","Food","Groceries","",$37.61,$0.00,-$5377.99
"Discover",,U,,12/04/2018,"savanas rec area","RV : Campgrounds","RV","Campgrounds","",$145.00,$0.00,-$5522.99
"Discover",,U,,12/05/2018,"Red Box","Recreation : Entertainment","Recreation","Entertainment","",$1.86,$0.00,-$5524.85
"Discover",,U,,12/05/2018,"Family Dollar Hot springs","Personal : Gifts","Personal","Gifts","Gift Cards",$73.17,$0.00,-$5598.02
"Discover",,U,,12/05/2018,"win dixie","Food : Groceries","Food","Groceries","",$129.02,$0.00,-$5727.04
"Discover",,U,,12/06/2018,"Transfer : Dcu Checking",,,,"",$0.00,$1389.81,-$4337.23
"Discover",,U,,12/06/2018,"Publix Super market","Food : Groceries","Food","Groceries","",$5.45,$0.00,-$4342.68
"Discover",,U,,12/07/2018,"redbox","Recreation : Entertainment","Recreation","Entertainment","",$1.86,$0.00,-$4344.54
"Discover",,U,,12/07/2018,"Exxon mobile","Transportation : Gas","Transportation","Gas","jensen fl",$15.95,$0.00,-$4360.49
"Discover",,U,,12/07/2018,"carmelas","Food : Restaurants","Food","Restaurants","In Stuart at Xmas parade",$33.00,$0.00,-$4393.49
"Discover",,U,,12/08/2018,"Publix Super market","Food : Groceries","Food","Groceries","",$20.56,$0.00,-$4414.05
"Discover",,U,,12/08/2018,"american canser","Charity : Other","Charity","Other","",$50.00,$0.00,-$4464.05
"Discover",,U,,12/08/2018,"Walmart","Food : Groceries","Food","Groceries","(Split 1/2) ",$100.00,$0.00,-$4596.10
"Discover",,U,,12/08/2018,"Walmart","RV : Equipment/Supplies","RV","Equipment/Supplies","(Split 2/2) ",$32.05,$0.00,-$4596.10
"Discover",,U,,12/08/2018,"yankee freedom","Recreation : Entertainment","Recreation","Entertainment","",$490.00,$0.00,-$5086.10
"Discover",,U,,12/09/2018,"redbox","Recreation : Entertainment","Recreation","Entertainment","",$1.88,$0.00,-$5087.98
"Discover",,U,,12/09/2018,"SUn Pass","RV : Tolls","RV","Tolls","",$25.00,$0.00,-$5112.98
"Discover",,U,,12/09/2018,"7-eleven","RV : gasoline","RV","gasoline","",$100.00,$0.00,-$5212.98
"Discover",,U,,12/10/2018,"redbox","Recreation : Entertainment","Recreation","Entertainment","",$1.88,$0.00,-$5214.86
"Discover",,U,,12/10/2018,"win dixie","Food : Groceries","Food","Groceries","",$31.15,$0.00,-$5246.01
"Discover",,U,,12/10/2018,"bahia honda","Recreation : Entertainment","Recreation","Entertainment","Florida Park Pass",$134.00,$0.00,-$5380.01
"Discover",,U,,12/11/2018,"winn-dixie","Food : Groceries","Food","Groceries","",$12.99,$0.00,-$5393.00
"Discover",,U,,12/11/2018,"Amazon","Personal : Gifts","Personal","Gifts","",$21.45,$0.00,-$5414.45
"Discover",,U,,12/11/2018,"Amazon","Recreation : Entertainment","Recreation","Entertainment","bob snorkel mask",$63.90,$0.00,-$5478.35
"Discover",,U,,12/11/2018,"key shuttle","Financial Help : Alyssa","Financial Help","Alyssa","",$144.00,$0.00,-$5622.35
"Discover",,U,,12/11/2018,"Amazon","Recreation : Entertainment","Recreation","Entertainment","kayak",$321.41,$0.00,-$5943.76
"Discover",,U,,12/12/2018,"USPS","RV : Equipment/Supplies","RV","Equipment/Supplies","",$10.00,$0.00,-$5953.76
"Discover",,U,,12/12/2018,"salvation army","Personal : cloths","Personal","cloths","",$11.00,$0.00,-$5964.76
"Discover",,U,,12/12/2018,"key west visiters","Personal : Gifts","Personal","Gifts","",$12.87,$0.00,-$5977.63
"Discover",,U,,12/12/2018,"wordpress","Recreation : Entertainment","Recreation","Entertainment","",$48.00,$0.00,-$6025.63
"Discover",,U,,12/13/2018,"win dixie","Food : Groceries","Food","Groceries","",$55.29,$0.00,-$6080.92
"Discover",,U,,12/14/2018,"westmarine","Recreation : Entertainment","Recreation","Entertainment","under water bag",$16.65,$0.00,-$6097.57
"Discover",,U,,12/14/2018,"bucktooth rooster","Food : Restaurants","Food","Restaurants","",$104.47,$0.00,-$6202.04
"Discover",,U,,12/15/2018,"yankee freedom","Recreation : Entertainment","Recreation","Entertainment",,$0.00,$45.00,-$6157.04
"Discover",,U,,12/15/2018,"ny pasta","Food : Restaurants","Food","Restaurants","key west",$105.00,$0.00,-$6262.04
"Discover",,U,,12/16/2018,"redbox","Recreation : Entertainment","Recreation","Entertainment","",$3.76,$0.00,-$6265.80
"Discover",,U,,12/16/2018,"Turte Hospital Marathon","Recreation : Entertainment","Recreation","Entertainment","",$9.18,$0.00,-$6274.98
"Discover",,U,,12/16/2018,"Tom Thumb","Transportation : Gas","Transportation","Gas","Florida",$26.32,$0.00,-$6301.30
"Discover",,U,,12/16/2018,"Burdines","Food : Restaurants","Food","Restaurants","",$56.44,$0.00,-$6357.74
"Discover",,U,,12/16/2018,"Turte Hospital Marathon","Recreation : Entertainment","Recreation","Entertainment","",$75.00,$0.00,-$6432.74
"Discover",,U,,12/17/2018,"itunes","Recreation : Entertainment","Recreation","Entertainment","",$0.99,$0.00,-$6433.73
"Discover",,U,,12/17/2018,"redbox","Recreation : Entertainment","Recreation","Entertainment","",$1.88,$0.00,-$6435.61
"Discover",,U,,12/17/2018,"USPS","Personal : Gifts","Personal","Gifts","Mail",$20.80,$0.00,-$6456.41
"Discover",,U,,12/17/2018,"walgreens","Personal : Gifts","Personal","Gifts","",$42.46,$0.00,-$6498.87
"Discover",,U,,12/17/2018,"winn-dixie","Food : Groceries","Food","Groceries","keys",$51.05,$0.00,-$6549.92
"Discover",,U,,12/18/2018,"Big Pine key Bike","Recreation : Entertainment","Recreation","Entertainment","Tire Tube",$14.78,$0.00,-$6564.70
"Discover",,U,,12/18/2018,"Brick fire pizza","Personal : Gifts","Personal","Gifts","alyssa",$50.00,$0.00,-$6614.70
"Discover",,U,,12/19/2018,"Nytimes","Recreation : Entertainment","Recreation","Entertainment","",$4.00,$0.00,-$6618.70
"Discover",,U,,12/19/2018,"Amazon","Personal : Gifts","Personal","Gifts","",$37.88,$0.00,-$6656.58
"Discover",,U,,12/19/2018,"Harry and david","Personal : Gifts","Personal","Gifts","Sisters",$53.98,$0.00,-$6710.56
"Discover",,U,,12/19/2018,"Edible arrangements","Personal : Gifts","Personal","Gifts","marta",$64.94,$0.00,-$6775.50
"Discover",,U,,12/21/2018,"kmart","Personal : cloths","Personal","cloths","",$27.70,$0.00,-$6803.20
"Discover",,U,,12/21/2018,"Burdines","Food : Restaurants","Food","Restaurants","",$50.00,$0.00,-$6853.20
"Discover",,U,,12/21/2018,"Amazon","Personal : Gifts","Personal","Gifts","lisa",$51.44,$0.00,-$6904.64
"Discover",,U,,12/21/2018,"Good Sam","RV : MISC","RV","MISC","Roadside assistence",$149.95,$0.00,-$7054.59
"Discover",,U,,12/22/2018,"bealls","Personal : cloths","Personal","cloths","",$11.81,$0.00,-$7066.40
"Discover",,U,,12/22/2018,"Low Key Fisheries","Food : Groceries","Food","Groceries","",$20.40,$0.00,-$7086.80
"Discover",,U,,12/22/2018,"win dixie","Food : Groceries","Food","Groceries","liquor",$37.59,$0.00,-$7124.39
"Discover",,U,,12/22/2018,"winn-dixie","Food : Groceries","Food","Groceries","",$40.09,$0.00,-$7164.48
"Discover",,U,,12/23/2018,"redbox","Recreation : Entertainment","Recreation","Entertainment","",$2.15,$0.00,-$7166.63
"Discover",,U,,12/24/2018,"win dixie","Food : Groceries","Food","Groceries","liquor",$11.81,$0.00,-$7178.44
"Discover",,U,,12/26/2018,"Matheessens candy Key West","Food : Restaurants","Food","Restaurants","April and Kevin Key Lime",$36.18,$0.00,-$7214.62
"Discover",,U,,12/27/2018,"Kmart Marathon","Recreation : Entertainment","Recreation","Entertainment","Lisa Snorkel stuff",$45.12,$0.00,-$7259.74
"Discover",,U,,12/28/2018,"fresco Mas","Food : Groceries","Food","Groceries","Miami",$81.82,$0.00,-$7341.56
"Discover",,U,,12/28/2018,"Holiday RV","RV : Maintenance","RV","Maintenance","Junction Box Work around",$156.90,$0.00,-$7498.46
"Discover",,U,,12/29/2018,"taco rico","Food : Restaurants","Food","Restaurants","miami",$11.00,$0.00,-$7509.46
"Discover",,U,,12/29/2018,"Shell","Transportation : Gas","Transportation","Gas","Miami",$22.46,$0.00,-$7531.92
"Discover",,U,,12/29/2018,"miami zoo","Recreation : Entertainment","Recreation","Entertainment","NIght lights at Zoo",$34.13,$0.00,-$7566.05
"Discover",,U,,12/30/2018,"redbox","Recreation : Entertainment","Recreation","Entertainment","",$2.14,$0.00,-$7568.19
"Discover",,U,,12/30/2018,"Apple Store","Personal : Miscellaneous","Personal","Miscellaneous","Phone Repair",$31.03,$0.00,-$7599.22
"Discover",,U,,12/31/2018,"parking","Transportation : Parking","Transportation","Parking","miami",$5.25,$0.00,-$7604.47
"Discover",,U,,12/31/2018,"Vizcaya Miami","Recreation : Entertainment","Recreation","Entertainment","Great House and Garden",$44.00,$0.00,-$7648.47
"Discover",,U,,12/31/2018,"Farfalle","Food : Restaurants","Food","Restaurants","Met family from Denmark",$68.04,$0.00,-$7716.51
"Discover",,U,,01/02/2019,"SUn Pass","RV : Tolls","RV","Tolls","",$25.00,$0.00,-$7741.51
"Discover",,U,,01/03/2019,"Shell","Transportation : Gas","Transportation","Gas","",$20.64,$0.00,-$7762.15
"Discover",,U,,01/03/2019,"Yardie Spice","Food : Restaurants","Food","Restaurants","Jamican Place in Homestead (Owned by John Paul JP) with Neil and Anne",$100.00,$0.00,-$7862.15
"Discover",,U,,01/05/2019,"Coe Visitors Center","Personal : cloths","Personal","cloths","Bob Everglades Hat",$19.18,$0.00,-$7881.33
"Discover",,U,,01/06/2019,"Brothers Farmers Market","Food : Groceries","Food","Groceries","",$11.46,$0.00,-$7892.79
"Discover",,U,,01/07/2019,"Transfer : Dcu Checking",,,,"",$0.00,$5967.63,-$1925.16
"Discover",,U,,01/07/2019,"Sweet Sensations","Personal : Gifts","Personal","Gifts","oven mitt for Alyssa",$13.90,$0.00,-$1939.06
"Discover",,U,,01/07/2019,"Sweet Sensations","Food : Restaurants","Food","Restaurants","Ice Cream with Neil and Ann",$30.99,$0.00,-$1970.05
"Discover",,U,,01/08/2019,"Del Ray","Transportation : Parking","Transportation","Parking","",$1.00,$0.00,-$1971.05
"Discover",,U,,01/08/2019,"redbox","Recreation : Entertainment","Recreation","Entertainment","",$1.87,$0.00,-$1972.92
"Discover",,U,,01/08/2019,"publix","Food : Groceries","Food","Groceries","Manors Florida",$154.79,$0.00,-$2127.71
"Discover",,U,,01/09/2019,"redbox","Recreation : Entertainment","Recreation","Entertainment","",$1.87,$0.00,-$2129.58
"Discover",,U,,01/09/2019,"USPS","Personal : Gifts","Personal","Gifts","",$17.00,$0.00,-$2146.58
"Discover",,U,,01/09/2019,"publix","Food : Groceries","Food","Groceries","",$63.21,$0.00,-$2209.79
"Discover",,U,,01/10/2019,"Publix Super market","Food : Groceries","Food","Groceries","",$57.71,$0.00,-$2267.50
"Discover",,U,,01/10/2019,"Keys Diver","Recreation : Entertainment","Recreation","Entertainment","Birthday Snorkel Boat",$90.69,$0.00,-$2358.19
"Discover",,U,,01/11/2019,"Ameripark","RV : Campgrounds","RV","Campgrounds","",$3.00,$0.00,-$2361.19
"Discover",,U,,01/13/2019,"redbox","Recreation : Entertainment","Recreation","Entertainment","",$2.14,$0.00,-$2363.33
"Discover",,U,,01/13/2019,"speedway","Transportation : Gas","Transportation","Gas","",$17.76,$0.00,-$2381.09
"Discover",,U,,01/13/2019,"Utrecht Art","Recreation : Entertainment","Recreation","Entertainment","bob pens  pads art supplies",$28.23,$0.00,-$2409.32
"Discover",,U,,01/13/2019,"walgreens","Personal : nom-prescription medication","Personal","nom-prescription medication","",$31.80,$0.00,-$2441.12
"Discover",,U,,01/13/2019,"publix","Food : Groceries","Food","Groceries","",$43.82,$0.00,-$2484.94
"Discover",,U,,01/13/2019,"Childrends Dentistry","Financial Help : Alyssa","Financial Help","Alyssa","Alyssa Dental Bill",$106.66,$0.00,-$2591.60
"Discover",,U,,01/14/2019,"Key Thai","Food : Restaurants","Food","Restaurants","Birthday dinner",$53.44,$0.00,-$2645.04
"Discover",,U,,01/15/2019,"Romeo and Juliet Gelato","Food : Restaurants","Food","Restaurants","Birhday Desert?",$24.25,$0.00,-$2669.29
"Discover",,U,,01/15/2019,"Exxon mobile","RV : gasoline","RV","gasoline","",$100.00,$0.00,-$2769.29
"Discover",,U,,01/15/2019,"Margaret RV","RV : Campgrounds","RV","Campgrounds","",$275.00,$0.00,-$3044.29
"Discover",,U,,01/16/2019,"Nytimes","Recreation : Entertainment","Recreation","Entertainment","",$4.00,$0.00,-$3048.29
"Discover",,U,,01/17/2019,"itunes","Recreation : Entertainment","Recreation","Entertainment","",$0.99,$0.00,-$3049.28
"Discover",,U,,01/17/2019,"redbox","Recreation : Entertainment","Recreation","Entertainment","",$1.87,$0.00,-$3051.15
"Discover",,U,,01/17/2019,"Amazon","Recreation : Entertainment","Recreation","Entertainment","camera battery",$29.66,$0.00,-$3080.81
"Discover",,U,,01/17/2019,"publix","Food : Groceries","Food","Groceries","",$234.34,$0.00,-$3315.15
"Discover",,U,,01/18/2019,"publix","Food : Groceries","Food","Groceries","",$5.99,$0.00,-$3321.14
"Discover",,U,,01/18/2019,"Exxon mobile","Transportation : Gas","Transportation","Gas","",$17.00,$0.00,-$3338.14
"Discover",,U,,01/18/2019,"Amazon","Recreation : Entertainment","Recreation","Entertainment","Camera!!!!",$388.87,$0.00,-$3727.01
"Discover",,U,,01/19/2019,"Jetblue","Transportation : Air/train/bus/etc","Transportation","Air/train/bus/etc","",$136.59,$0.00,-$3863.60
"Discover",,U,,01/20/2019,"redbox","Recreation : Entertainment","Recreation","Entertainment","",$1.87,$0.00,-$3865.47
"Discover",,U,,01/21/2019,"Duffys Stuart","Food : Restaurants","Food","Restaurants","",$24.09,$0.00,-$3889.56
"Discover",,U,,01/21/2019,"cvs","Personal : Prescriptions, Medicine","Personal","Prescriptions, Medicine","",$30.00,$0.00,-$3919.56
"Discover",,U,,01/21/2019,"Stuart Art Supply","Recreation : Entertainment","Recreation","Entertainment","Lisa panting",$39.61,$0.00,-$3959.17
"Discover",,U,,01/21/2019,"wlalmart","Food : Groceries","Food","Groceries","(Split 1/2) ",$50.00,$0.00,-$4057.10
"Discover",,U,,01/21/2019,"wlalmart","RV : Equipment/Supplies","RV","Equipment/Supplies","(Split 2/2) ",$47.93,$0.00,-$4057.10
"Discover",,U,,01/23/2019,"redbox","Recreation : Entertainment","Recreation","Entertainment","",$1.87,$0.00,-$4058.97
"Discover",,U,,01/23/2019,"Shell","Transportation : Gas","Transportation","Gas","",$18.92,$0.00,-$4077.89
"Discover",,U,,01/25/2019,"win dixie","Food : Groceries","Food","Groceries","",$48.07,$0.00,-$4125.96
"Discover",,U,,01/27/2019,"ducmar","Food : Restaurants","Food","Restaurants","port charlotte with tom and barb",$71.92,$0.00,-$4197.88
"Discover",,U,,01/28/2019,"cvs","Personal : Prescriptions, Medicine","Personal","Prescriptions, Medicine","",$13.66,$0.00,-$4211.54
"Discover",,U,,01/28/2019,"7 days avon park","Transportation : Gas","Transportation","Gas","",$17.59,$0.00,-$4229.13
"Discover",,U,,01/28/2019,"dutchers diner","Food : Restaurants","Food","Restaurants","",$26.00,$0.00,-$4255.13
"Discover",,U,,01/28/2019,"Stewarts Mobile village","RV : Maintenance","RV","Maintenance","Fix electric",$330.00,$0.00,-$4585.13
"Discover",,U,,01/30/2019,"Stewarts Mobile village","RV : Maintenance","RV","Maintenance","Refund for overcharge",$0.00,$110.00,-$4475.13
"Discover",,U,,01/30/2019,"Zoet Punta Gorda","Food : Restaurants","Food","Restaurants","Coffee and Frap",$8.00,$0.00,-$4483.13
"Discover",,U,,01/31/2019,"raceway","Transportation : Gas","Transportation","Gas","",$15.36,$0.00,-$4498.49
"Discover",,U,,01/31/2019,"Winn Dixie","Food : Groceries","Food","Groceries","",$74.60,$0.00,-$4573.09
"Discover",,U,,02/01/2019,"Burger  21","Food : Restaurants","Food","Restaurants","Tampa Airport",$9.95,$0.00,-$4583.04
"Discover",,U,,02/01/2019,"Master Wok South Station Boston","Food : Restaurants","Food","Restaurants","",$11.32,$0.00,-$4594.36
"Discover",,U,,02/02/2019,"peterson market dennis","Food : Groceries","Food","Groceries","",$40.07,$0.00,-$4634.43
"Discover",,U,,02/03/2019,"redbubble","Personal : Gifts","Personal","Gifts","",$44.49,$0.00,-$4678.92
"Discover",,U,,02/04/2019,"stop & shop","Food : Groceries","Food","Groceries","",$36.04,$0.00,-$4714.96
"Discover",,U,,02/05/2019,"Fort Lonsome Lithia Fl","Transportation : Gas","Transportation","Gas","",$17.97,$0.00,-$4732.93
"Discover",,U,,02/05/2019,"Walmart","Food : Groceries","Food","Groceries","",$43.92,$0.00,-$4776.85
"Discover",,U,,02/06/2019,"Transfer : Dcu Checking",,,,"",$0.00,$2358.19,-$2418.66
"Discover",,U,,02/06/2019,"Marshall's","Personal : cloths","Personal","cloths","",$36.83,$0.00,-$2455.49
"Discover",,U,,02/06/2019,"stop & shop","Food : Groceries","Food","Groceries","",$70.03,$0.00,-$2525.52
"Discover",,U,,02/07/2019,"peterson market dennis","Food : Groceries","Food","Groceries","",$3.58,$0.00,-$2529.10
"Discover",,U,,02/09/2019,"Gas","Transportation : Gas","Transportation","Gas","",$12.18,$0.00,-$2541.28
"Discover",,U,,02/09/2019,"Plymouth and Brock","Transportation : Air/train/bus/etc","Transportation","Air/train/bus/etc","",$21.00,$0.00,-$2562.28
"Discover",,U,,02/09/2019,"Milkweed Boston","Food : Restaurants","Food","Restaurants","WIth Anne Swinton",$51.52,$0.00,-$2613.80
"Discover",,U,,02/10/2019,"cosi","Food : Restaurants","Food","Restaurants","ask Lisa",$11.53,$0.00,-$2625.33
"Discover",,U,,02/11/2019,"redbox","Recreation : Entertainment","Recreation","Entertainment","",$1.87,$0.00,-$2627.20
"Discover",,U,,02/11/2019,"SUn Pass","RV : Tolls","RV","Tolls",,$25.00,$0.00,-$2652.20
"Discover",,U,,02/11/2019,"Winn Dixie","Food : Groceries","Food","Groceries","",$100.18,$0.00,-$2752.38
"Discover",,U,,02/12/2019,"selby  Gardens","Recreation : Entertainment","Recreation","Entertainment","",$10.00,$0.00,-$2762.38
"Discover",,U,,02/12/2019,"Marathon","Transportation : Gas","Transportation","Gas","",$17.85,$0.00,-$2780.23
"Discover",,U,,02/13/2019,"Nytimes","Recreation : Entertainment","Recreation","Entertainment","",$4.00,$0.00,-$2784.23
"Discover",,U,,02/13/2019,"codys original","Food : Restaurants","Food","Restaurants","SKP crowd",$39.60,$0.00,-$2823.83
"Discover",,U,,02/15/2019,"# pepper Burrito","Food : Restaurants","Food","Restaurants","At Music walk in Fort Myers",$19.55,$0.00,-$2843.38
"Discover",,U,,02/15/2019,"Edison Ford Summer Homes","Recreation : Entertainment","Recreation","Entertainment","(Split 1/2) Plants Lisa",$15.00,$0.00,-$2874.36
"Discover",,U,,02/15/2019,"Edison Ford Summer Homes","Personal : Gifts","Personal","Gifts","(Split 2/2) Plants Lisa",$15.98,$0.00,-$2874.36
"Discover",,U,,02/17/2019,"itunes","Recreation : Entertainment","Recreation","Entertainment","",$0.99,$0.00,-$2875.35
"Discover",,U,,02/17/2019,"Murphys","Transportation : Gas","Transportation","Gas","Wachula",$18.70,$0.00,-$2894.05
"Discover",,U,,02/17/2019,"Walmart","Food : Groceries","Food","Groceries","(Split 1/2) ",$45.00,$0.00,-$2978.32
"Discover",,U,,02/17/2019,"Walmart","RV : Equipment/Supplies","RV","Equipment/Supplies","(Split 2/2) ",$39.27,$0.00,-$2978.32
"Discover",,U,,02/18/2019,"Winn Dixie","Food : Groceries","Food","Groceries","",$4.79,$0.00,-$2983.11
"Discover",,U,,02/18/2019,"cvs","Personal : Prescriptions, Medicine","Personal","Prescriptions, Medicine","",$10.78,$0.00,-$2993.89
"Discover",,U,,02/18/2019,"publix","Food : Groceries","Food","Groceries","",$186.87,$0.00,-$3180.76
"Discover",,U,,02/19/2019,"Ybor","Personal : cloths","Personal","cloths","",$16.05,$0.00,-$3196.81
"Discover",,U,,02/19/2019,"azanpetro","Transportation : Gas","Transportation","Gas","",$21.04,$0.00,-$3217.85
"Discover",,U,,02/19/2019,"Thia asiatic","Food : Restaurants","Food","Restaurants","Tampa Fl",$29.00,$0.00,-$3246.85
"Discover",,U,,02/21/2019,"Walmart","Food : Groceries","Food","Groceries","",$0.00,$4.22,-$3242.63
"Discover",,U,,02/21/2019,"Ace hardware","Recreation : Entertainment","Recreation","Entertainment","Soil",$5.35,$0.00,-$3247.98
"Discover",,U,,02/21/2019,"USPS","Personal : Gifts","Personal","Gifts","Mailed chocolate to doug",$17.84,$0.00,-$3265.82
"Discover",,U,,02/22/2019,"redbox","Recreation : Entertainment","Recreation","Entertainment","",$1.87,$0.00,-$3267.69
"Discover",,U,,02/22/2019,"Winn Dixie","Food : Groceries","Food","Groceries","",$10.69,$0.00,-$3278.38
"Discover",,U,,02/23/2019,"manatee viewing center","Personal : Gifts","Personal","Gifts","",$15.68,$0.00,-$3294.06
"Discover",,U,,02/23/2019,"speedway","Transportation : Gas","Transportation","Gas","",$20.56,$0.00,-$3314.62
"Discover",,U,,02/23/2019,"Goodson Farms","Food : Restaurants","Food","Restaurants","With Donna Hay",$24.50,$0.00,-$3339.12
"Discover",,U,,02/24/2019,"Amazon","Personal : Miscellaneous","Personal","Miscellaneous","Turbo tax",$74.36,$0.00,-$3413.48
"Discover",,U,,02/25/2019,"cvs","Personal : Prescriptions, Medicine","Personal","Prescriptions, Medicine","",$6.87,$0.00,-$3420.35
"Discover",,U,,02/25/2019,"Lakesshore 8","Recreation : Entertainment","Recreation","Entertainment","",$20.42,$0.00,-$3440.77
"Discover",,U,,02/25/2019,"Serinity Massage","Personal : Miscellaneous","Personal","Miscellaneous","message",$65.00,$0.00,-$3505.77
"Discover",,U,,02/26/2019,"Winn Dixie","Food : Groceries","Food","Groceries","",$91.45,$0.00,-$3597.22
"Discover",,U,,03/02/2019,"Mamma Rosa Pizza","Food : Restaurants","Food","Restaurants","",$38.01,$0.00,-$3635.23
"Discover",,U,,03/03/2019,"publix","Food : Groceries","Food","Groceries","",$25.11,$0.00,-$3660.34
"Discover",,U,,03/03/2019,"canaveral ns","Recreation : Entertainment","Recreation","Entertainment","National park pass",$80.00,$0.00,-$3740.34
"Discover",,U,,03/04/2019,"racetrack","Transportation : Gas","Transportation","Gas","",$21.89,$0.00,-$3762.23
"Discover",,U,,03/04/2019,"publix","Food : Groceries","Food","Groceries",,$65.81,$0.00,-$3828.04
"Discover",,U,,03/05/2019,"Aldi","Food : Groceries","Food","Groceries","",$109.64,$0.00,-$3937.68
"Discover",,U,,03/06/2019,"publix","Food : Groceries","Food","Groceries","",$20.89,$0.00,-$3958.57
"Discover",,U,,03/06/2019,"Jpans Perfect pie","Food : Restaurants","Food","Restaurants","",$24.85,$0.00,-$3983.42
"Discover",,U,,03/06/2019,"ralphs art","Recreation : Entertainment","Recreation","Entertainment","bob drawing stuff",$36.98,$0.00,-$4020.40
"Discover",,U,,03/07/2019,"Transfer : Dcu Checking",,,,"",$0.00,$2762.38,-$1258.02
"Discover",,U,,03/07/2019,"redbox","Recreation : Entertainment","Recreation","Entertainment","",$1.87,$0.00,-$1259.89
"Discover",,U,,03/09/2019,"redbox","Recreation : Entertainment","Recreation","Entertainment","",$1.87,$0.00,-$1261.76
"Discover",,U,,03/09/2019,"Panera Bread","Food : Restaurants","Food","Restaurants","",$3.26,$0.00,-$1265.02
"Discover",,U,,03/09/2019,"Shell","Transportation : Gas","Transportation","Gas","",$23.04,$0.00,-$1288.06
"Discover",,U,,03/09/2019,"pannullos","Food : Restaurants","Food","Restaurants","",$88.49,$0.00,-$1376.55
"Discover",,U,,03/10/2019,"publix","Food : Groceries","Food","Groceries","",$108.14,$0.00,-$1484.69
"Discover",,U,,03/11/2019,"SUn Pass","RV : Tolls","RV","Tolls",,$25.00,$0.00,-$1509.69
"Discover",,U,,03/12/2019,"bealls","RV : MISC","RV","MISC","Comforter",$67.39,$0.00,-$1577.08
"Discover",,U,,03/13/2019,"Nytimes","Recreation : Entertainment","Recreation","Entertainment","",$4.00,$0.00,-$1581.08
"Discover",,U,,03/13/2019,"Sams house","Personal : cloths","Personal","cloths","t-Shirt",$12.84,$0.00,-$1593.92
"Discover",,U,,03/14/2019,"Wicked Pineapple","Food : Restaurants","Food","Restaurants","coffee",$5.63,$0.00,-$1599.55
"Discover",,U,,03/14/2019,"Gas","Transportation : Gas","Transportation","Gas","",$24.14,$0.00,-$1623.69
"Discover",,U,,03/14/2019,"Wicked Pineapple","Food : Restaurants","Food","Restaurants","With Glo",$26.33,$0.00,-$1650.02
"Discover",,U,,03/14/2019,"mamasan","Food : Restaurants","Food","Restaurants","",$41.12,$0.00,-$1691.14
"Discover",,U,,03/15/2019,"Jimmie Hulas","Food : Restaurants","Food","Restaurants","",$35.00,$0.00,-$1726.14
"Discover",,U,,03/15/2019,"gasoline","RV : gasoline","RV","gasoline","Titusville",$100.00,$0.00,-$1826.14
"Discover",,U,,03/16/2019,"cvs","Personal : Prescriptions, Medicine","Personal","Prescriptions, Medicine","",$6.62,$0.00,-$1832.76
"Discover",,U,,03/16/2019,"hershey","Food : Restaurants","Food","Restaurants","Ice cream",$11.40,$0.00,-$1844.16
"Discover",,U,,03/16/2019,"Gas","Transportation : Gas","Transportation","Gas","Orlando",$18.94,$0.00,-$1863.10
"Discover",,U,,03/16/2019,"intuit","Financial Help : Alyssa","Financial Help","Alyssa","electronic filing alyssa",$24.99,$0.00,-$1888.09
"Discover",,U,,03/16/2019,"intuit","Personal : Miscellaneous","Personal","Miscellaneous","Electronic filing",$24.99,$0.00,-$1913.08
"Discover",,U,,03/16/2019,"Winn Dixie","Food : Groceries","Food","Groceries","",$75.28,$0.00,-$1988.36
"Discover",,U,,03/16/2019,"publix","Food : Groceries","Food","Groceries",,$81.22,$0.00,-$2069.58
"Discover",,U,,03/16/2019,"Pelliceer","RV : Campgrounds","RV","Campgrounds","",$225.00,$0.00,-$2294.58
"Discover",,U,,03/17/2019,"itunes","Recreation : Entertainment","Recreation","Entertainment","",$0.99,$0.00,-$2295.57
"Discover",,U,,03/17/2019,"publix","Food : Groceries","Food","Groceries","",$10.00,$0.00,-$2305.57
"Discover",,U,,03/17/2019,"Distillary","Personal : cloths","Personal","cloths","",$46.86,$0.00,-$2352.43
"Discover",,U,,03/17/2019,"Shaugnessy","Food : Restaurants","Food","Restaurants","",$80.00,$0.00,-$2432.43
"Discover",,U,,03/18/2019,"parking","Transportation : Parking","Transportation","Parking","St Augustine",$5.00,$0.00,-$2437.43
"Discover",,U,,03/19/2019,"publix","Food : Groceries","Food","Groceries","",$35.04,$0.00,-$2472.47
"Discover",,U,,03/20/2019,"Gas","Transportation : Gas","Transportation","Gas","",$23.57,$0.00,-$2496.04
"Discover",,U,,03/20/2019,"hulls' Seafood Ormond Beach","Food : Groceries","Food","Groceries","",$31.19,$0.00,-$2527.23
"Discover",,U,,03/20/2019,"Nut house Enterprices","Personal : Gifts","Personal","Gifts","",$49.94,$0.00,-$2577.17
"Discover",,U,,03/21/2019,"Jacksonvill Bakery","Food : Restaurants","Food","Restaurants","",$11.80,$0.00,-$2588.97
"Discover",,U,,03/21/2019,"blacksheep Res","Food : Restaurants","Food","Restaurants","",$30.22,$0.00,-$2619.19
"Discover",,U,,03/22/2019,"Winn Dixie","Food : Groceries","Food","Groceries","",$62.81,$0.00,-$2682.00
"Discover",,U,,03/22/2019,"Birp Rec Brunswick","RV : Campgrounds","RV","Campgrounds","",$224.00,$0.00,-$2906.00
"Discover",,U,,03/23/2019,"Aroi Thai","Food : Restaurants","Food","Restaurants","",$34.00,$0.00,-$2940.00
"Discover",,U,,03/25/2019,"national transplant fund","Charity : Other","Charity","Other","",$10.00,$0.00,-$2950.00
"Discover",,U,,03/25/2019,"SC Park Service","RV : Campgrounds","RV","Campgrounds","",$43.20,$0.00,-$2993.20
"Discover",,U,,03/25/2019,"win dixie","Food : Groceries","Food","Groceries","",$76.41,$0.00,-$3069.61
"Discover",,U,,03/25/2019,"jj tires","Transportation : Repairs & Maintenance","Transportation","Repairs & Maintenance","new tires",$458.68,$0.00,-$3528.29
"Discover",,U,,03/26/2019,"Jekyll Entrace","Recreation : Entertainment","Recreation","Entertainment","",$6.00,$0.00,-$3534.29
"Discover",,U,,03/26/2019,"piot","Transportation : Gas","Transportation","Gas","Brunsick ga",$22.32,$0.00,-$3556.61
"Discover",,U,,03/27/2019,"SC Park Service","RV : Campgrounds","RV","Campgrounds","",$63.22,$0.00,-$3619.83
"Discover",,U,,03/27/2019,"racetrack","RV : gasoline","RV","gasoline","Brunswich GA",$99.00,$0.00,-$3718.83
"Discover",,U,,03/29/2019,"Pilot","RV : gasoline","RV","gasoline","",$75.00,$0.00,-$3793.83
"Discover",,U,,03/30/2019,"cvs","Personal : Prescriptions, Medicine","Personal","Prescriptions, Medicine","Anti Bio for TICK BITE",$1.26,$0.00,-$3795.09
"Discover",,U,,03/30/2019,"NC STATE PARKS","RV : Campgrounds","RV","Campgrounds","Medoc Mountain State Park",$31.00,$0.00,-$3826.09
"Discover",,U,,03/30/2019,"VA State Parks","RV : Campgrounds","RV","Campgrounds","Powhatan State Park",$125.04,$0.00,-$3951.13
"Discover",,U,,03/30/2019,"Food lion","Food : Groceries","Food","Groceries","",$132.00,$0.00,-$4083.13
"Discover",,U,,04/01/2019,"Pilot","RV : gasoline","RV","gasoline","",$75.00,$0.00,-$4158.13
"Discover",,U,,04/01/2019,"Wegmans","Food : Groceries","Food","Groceries","Henrico VA",$99.71,$0.00,-$4257.84
"Discover",,U,,04/02/2019,"Harbor grill block Isl","RV : Campgrounds","RV","Campgrounds","",$82.74,$0.00,-$4340.58
"Discover",,U,,04/02/2019,"Harborview","RV : Campgrounds","RV","Campgrounds","",$107.80,$0.00,-$4448.38
"Discover",,U,,04/02/2019,"Virgina State Parks","RV : Campgrounds","RV","Campgrounds","",$131.36,$0.00,-$4579.74
"Discover",,U,,04/03/2019,"cvs","Personal : Prescriptions, Medicine","Personal","Prescriptions, Medicine","",$10.00,$0.00,-$4589.74
"Discover",,U,,04/03/2019,"Shell","Transportation : Gas","Transportation","Gas","",$22.61,$0.00,-$4612.35
"Discover",,U,,04/04/2019,"VA State Parks","RV : Campgrounds","RV","Campgrounds","",$0.00,$70.03,-$4542.32
"Discover",,U,,04/04/2019,"VA State Parks","RV : Campgrounds","RV","Campgrounds","",$0.00,$40.01,-$4502.31
"Discover",,U,,04/04/2019,"Parking Richmond","Transportation : Parking","Transportation","Parking","",$3.00,$0.00,-$4505.31
"Discover",,U,,04/04/2019,"Plaza Art","Recreation : Entertainment","Recreation","Entertainment","",$30.82,$0.00,-$4536.13
"Discover",,U,,04/04/2019,"Kokonut Grill","Food : Restaurants","Food","Restaurants","",$43.26,$0.00,-$4579.39
"Discover",,U,,04/05/2019,"Fas Mart","RV : gasoline","RV","gasoline","",$100.00,$0.00,-$4679.39
"Discover",,U,,04/06/2019,"Transfer : Dcu Checking",,,,"",$0.00,$1509.69,-$3169.70
"Discover",,U,,04/06/2019,"Birddogs County Store","Personal : Gifts","Personal","Gifts","",$7.97,$0.00,-$3177.67
"Discover",,U,,04/06/2019,"Deleware Campgrounds","RV : Campgrounds","RV","Campgrounds","",$68.00,$0.00,-$3245.67
"Discover",,U,,04/07/2019,"parking","Transportation : Parking","Transportation","Parking","DC",$12.00,$0.00,-$3257.67
"Discover",,U,,04/07/2019,"Bindasas Indian","Food : Restaurants","Food","Restaurants","Washington",$74.50,$0.00,-$3332.17
"Discover",,U,,04/07/2019,"Walmart","Food : Groceries","Food","Groceries","(Split 1/2) ",$60.00,$0.00,-$3450.92
"Discover",,U,,04/07/2019,"Walmart","RV : Equipment/Supplies","RV","Equipment/Supplies","(Split 2/2) ",$58.75,$0.00,-$3450.92
"Discover",,U,,04/08/2019,"Gas","Transportation : Gas","Transportation","Gas","",$19.72,$0.00,-$3470.64
"Discover",,U,,04/09/2019,"Coffeehouse","Food : Restaurants","Food","Restaurants","David and Lisa",$19.40,$0.00,-$3490.04
"Discover",,U,,04/09/2019,"NJ Campgrounds","RV : Campgrounds","RV","Campgrounds","",$55.00,$0.00,-$3545.04
"Discover",,U,,04/10/2019,"Red Box","Recreation : Entertainment","Recreation","Entertainment","",$1.78,$0.00,-$3546.82
"Discover",,U,,04/10/2019,"Nytimes","Recreation : Entertainment","Recreation","Entertainment","",$4.00,$0.00,-$3550.82
"Discover",,U,,04/10/2019,"safeway","Food : Groceries","Food","Groceries","Newark DE",$130.04,$0.00,-$3680.86
"Discover",,U,,04/11/2019,"cvs","Personal : Prescriptions, Medicine","Personal","Prescriptions, Medicine","",$10.84,$0.00,-$3691.70
"Discover",,U,,04/11/2019,"acme grocery","Food : Groceries","Food","Groceries","Bear DE",$25.95,$0.00,-$3717.65
"Discover",,U,,04/12/2019,"NJ Campgrounds","RV : Campgrounds","RV","Campgrounds","Worthington State Park",$0.00,$50.00,-$3667.65
"Discover",,U,,04/12/2019,"NJ Campgrounds","RV : Campgrounds","RV","Campgrounds","",$52.00,$0.00,-$3719.65
"Discover",,U,,04/13/2019,"Exxon mobile","Transportation : Gas","Transportation","Gas","Columbia NJ",$21.12,$0.00,-$3740.77
"Discover",,U,,04/13/2019,"Jack Williams Tires","Transportation : Repairs & Maintenance","Transportation","Repairs & Maintenance","TIre from going over curb",$106.94,$0.00,-$3847.71
"Discover",,U,,04/14/2019,"RI Park Service","RV : Campgrounds","RV","Campgrounds","RI Geoge Washington State Campground",$28.75,$0.00,-$3876.46
"Discover",,U,,04/14/2019,"Kays","Food : Restaurants","Food","Restaurants","",$76.00,$0.00,-$3952.46
"Discover",,U,,04/14/2019,"Citgo","RV : gasoline","RV","gasoline","CT",$100.00,$0.00,-$4052.46
"Discover",,U,,04/14/2019,"Exxon mobile","RV : gasoline","RV","gasoline","CT",$100.00,$0.00,-$4152.46
"Discover",,U,,04/16/2019,"agway","Personal : Gifts","Personal","Gifts","Mulch 32 longfellow",$92.45,$0.00,-$4244.91
"Discover",,U,,04/17/2019,"itunes","Recreation : Entertainment","Recreation","Entertainment","",$0.86,$0.00,-$4245.77
"Discover",,U,,04/17/2019,"itunes","Recreation : Entertainment","Recreation","Entertainment","",$0.99,$0.00,-$4246.76
"Discover",,U,,04/18/2019,"rvtripwiz","RV : Equipment/Supplies","RV","Equipment/Supplies",,$39.00,$0.00,-$4285.76
"Discover",,U,,04/19/2019,"cvs","Personal : Prescriptions, Medicine","Personal","Prescriptions, Medicine","",$6.58,$0.00,-$4292.34
"Discover",,U,,04/19/2019,"gas Sinclair","Transportation : Gas","Transportation","Gas","Dennis Ma",$24.06,$0.00,-$4316.40
"Discover",,U,,04/19/2019,"Yoga Center of cape code","Recreation : Entertainment","Recreation","Entertainment","",$80.00,$0.00,-$4396.40
"Discover",,U,,04/20/2019,"RIng Brothers Market place","Food : Groceries","Food","Groceries","",$128.34,$0.00,-$4524.74
"Discover",,U,,04/21/2019,"Entertainment Cinemas","Recreation : Entertainment","Recreation","Entertainment","",$43.75,$0.00,-$4568.49
"Discover",,U,,04/21/2019,"Sweet Water Forest Propate","RV : propane","RV","propane","",$71.83,$0.00,-$4640.32
"Discover",,U,,04/22/2019,"EHS Optical","Personal : Doctor, Dentist","Personal","Doctor, Dentist","BOB EYE DOCTOR",$18.00,$0.00,-$4658.32
"Discover",,U,,04/22/2019,"stop & shop","Food : Groceries","Food","Groceries","Dennis",$110.72,$0.00,-$4769.04
"Discover",,U,,04/22/2019,"Sweetwater camground","RV : Campgrounds","RV","Campgrounds","",$486.00,$0.00,-$5255.04
"Discover",,U,,04/23/2019,"Buckies Biscotti","Food : Restaurants","Food","Restaurants","",$6.90,$0.00,-$5261.94
"Discover",,U,,04/23/2019,"Buckies Biscotti","Food : Restaurants","Food","Restaurants","",$7.95,$0.00,-$5269.89
"Discover",,U,,04/23/2019,"Amazon","Personal : Gifts","Personal","Gifts","",$8.87,$0.00,-$5278.76
"Discover",,U,,04/23/2019,"Amazon","Personal : Prescriptions, Medicine","Personal","Prescriptions, Medicine","(Split 1/2) BOB KNEE BRACES",$55.00,$0.00,-$5399.81
"Discover",,U,,04/23/2019,"Amazon","Personal : Gifts","Personal","Gifts","(Split 2/2) ",$66.05,$0.00,-$5399.81
"Discover",,U,,04/24/2019,"Local Flavor","Food : Restaurants","Food","Restaurants","",$7.37,$0.00,-$5407.18
"Discover",,U,,04/25/2019,"dunkin donuts","Food : Restaurants","Food","Restaurants","",$9.71,$0.00,-$5416.89
"Discover",,U,,04/26/2019,"peterson market dennis","Food : Groceries","Food","Groceries","",$36.07,$0.00,-$5452.96
"Discover",,U,,04/26/2019,"AAA membership","Personal : Gifts","Personal","Gifts","Mom and Dad",$124.00,$0.00,-$5576.96
"Discover",,U,,04/27/2019,"Pizzadora","Food : Restaurants","Food","Restaurants","Food at Karinas",$85.47,$0.00,-$5662.43
"Discover",,U,,04/28/2019,"speedway","Transportation : Gas","Transportation","Gas","Needham",$23.37,$0.00,-$5685.80
"Discover",,U,,04/28/2019,"Ramins","Food : Restaurants","Food","Restaurants","Ramis with Neil and Ann",$81.67,$0.00,-$5767.47
"Discover",,U,,04/29/2019,"Autozone","Financial Help : Mom And Dad","Financial Help","Mom And Dad","Car Battery",$86.11,$0.00,-$5853.58
"Discover",,U,,04/30/2019,"monroe motors","Transportation : Repairs & Maintenance","Transportation","Repairs & Maintenance","Oil fit",$39.78,$0.00,-$5893.36
"Discover",,U,,04/30/2019,"Mondovi","Personal : Doctor, Dentist","Personal","Doctor, Dentist","Teeth Cleaning",$218.00,$0.00,-$6111.36
"Discover",,U,,05/01/2019,"stop & shop","Food : Groceries","Food","Groceries","",$161.71,$0.00,-$6273.07
"Discover",,U,,05/02/2019,"Shell","Transportation : Gas","Transportation","Gas","Milford",$25.21,$0.00,-$6298.28
"Discover",,U,,05/02/2019,"O'Reilly Auto","Transportation : Repairs & Maintenance","Transportation","Repairs & Maintenance","Headlights",$31.85,$0.00,-$6330.13
"Discover",,U,,05/04/2019,"Cumberland Farms","Transportation : Gas","Transportation","Gas","Ashford CT",$24.48,$0.00,-$6354.61
"Discover",,U,,05/05/2019,"Wegmans","Financial Help : Alyssa","Financial Help","Alyssa","(Split 1/2) ",$65.00,$0.00,-$6501.61
"Discover",,U,,05/05/2019,"Wegmans","Food : Groceries","Food","Groceries","(Split 2/2) ",$82.00,$0.00,-$6501.61
"Discover",,U,,05/07/2019,"Transfer : Dcu Checking",,,,"",$0.00,$3680.86,-$2820.75
"Discover",,U,,05/07/2019,"chipolte","Food : Restaurants","Food","Restaurants","marlboro",$18.08,$0.00,-$2838.83
"Discover",,U,,05/08/2019,"Nytimes","Recreation : Entertainment","Recreation","Entertainment","",$4.00,$0.00,-$2842.83
"Discover",,U,,05/08/2019,"Exxon mobile","Transportation : Gas","Transportation","Gas","Lincoln",$25.26,$0.00,-$2868.09
"Discover",,U,,05/08/2019,"trader Joes","Food : Groceries","Food","Groceries","",$62.38,$0.00,-$2930.47
"Discover",,U,,05/09/2019,"Market bskt","Food : Groceries","Food","Groceries","",$85.33,$0.00,-$3015.80
"Discover",,U,,05/10/2019,"Brick fire pizza","Food : Restaurants","Food","Restaurants","Newton",$26.75,$0.00,-$3042.55
"Discover",,U,,05/11/2019,"Hopkinton drugs","Personal : Gifts","Personal","Gifts","card Renee",$3.92,$0.00,-$3046.47
"Discover",,U,,05/11/2019,"Highpoint Liquour","Food : Groceries","Food","Groceries","beer",$10.00,$0.00,-$3056.47
"Discover",,U,,05/11/2019,"Zitis","Food : Restaurants","Food","Restaurants","westboro",$18.53,$0.00,-$3075.00
"Discover",,U,,05/11/2019,"Cumberland Farms","Transportation : Gas","Transportation","Gas","Hopkinton",$26.33,$0.00,-$3101.33
"Discover",,U,,05/11/2019,"Fire works","Personal : Gifts","Personal","Gifts","Pottery Ann Swinton",$106.25,$0.00,-$3207.58
"Discover",,U,,05/11/2019,"foxboro bike","Recreation : Entertainment","Recreation","Entertainment","Bike repair",$150.47,$0.00,-$3358.05
"Discover",,U,,05/12/2019,"Sunoco","Transportation : Gas","Transportation","Gas","Plymouth",$14.52,$0.00,-$3372.57
"Discover",,U,,05/12/2019,"Kreme and Kone","Food : Restaurants","Food","Restaurants","Mom's meal",$108.02,$0.00,-$3480.59
"Discover",,U,,05/13/2019,"dunkin donuts","Food : Restaurants","Food","Restaurants","",$4.96,$0.00,-$3485.55
"Discover",,U,,05/13/2019,"Walmart","RV : Equipment/Supplies","RV","Equipment/Supplies","toilet paper, propane",$36.56,$0.00,-$3522.11
"Discover",,U,,05/13/2019,"CAVICCHIO GREENHOUSES","Lisa Business : Business expenses","Lisa Business","Business expenses","",$38.25,$0.00,-$3560.36
"Discover",,U,,05/13/2019,"Market bskt","Food : Groceries","Food","Groceries","bellingham",$90.81,$0.00,-$3651.17
"Discover",,U,,05/14/2019,"Shell","Transportation : Gas","Transportation","Gas","",$26.40,$0.00,-$3677.57
"Discover",,U,,05/16/2019,"Apple Tunes","Personal : Gifts","Personal","Gifts",,$0.99,$0.00,-$3678.56
"Discover",,U,,05/16/2019,"itunes","Recreation : Entertainment","Recreation","Entertainment","",$0.99,$0.00,-$3679.55
"Discover",,U,,05/16/2019,"savers marlboro","Personal : cloths","Personal","cloths","",$13.47,$0.00,-$3693.02
"Discover",,U,,05/16/2019,"Lowe's plainview","Lisa Business : Equipment Rental","Lisa Business","Equipment Rental","ASK LISA ?",$22.74,$0.00,-$3715.76
"Discover",,U,,05/16/2019,"foxboro bike","Recreation : Entertainment","Recreation","Entertainment","",$32.65,$0.00,-$3748.41
"Discover",,U,,05/16/2019,"Ocean State Joblot","Lisa Business : Supplies","Lisa Business","Supplies","?? ASK LISA",$39.27,$0.00,-$3787.68
"Discover",,U,,05/17/2019,"gulfmart ludlow","Transportation : Gas","Transportation","Gas","",$28.12,$0.00,-$3815.80
"Discover",,U,,05/18/2019,"tst pg","Food : Restaurants","Food","Restaurants","pizza trip to Isa's",$7.47,$0.00,-$3823.27
"Discover",,U,,05/18/2019,"cvs","Personal : nom-prescription medication","Personal","nom-prescription medication","COlD Medicine",$22.98,$0.00,-$3846.25
"Discover",,U,,05/18/2019,"Chicolattes Boston","Food : Restaurants","Food","Restaurants","Lisa and Alyssa Mexican",$38.72,$0.00,-$3884.97
"Discover",,U,,05/19/2019,"operation underground","Charity : Other","Charity","Other","",$25.75,$0.00,-$3910.72
"Discover",,U,,05/19/2019,"Sunoco","Transportation : Gas","Transportation","Gas","",$26.08,$0.00,-$3936.80
"Discover",,U,,05/19/2019,"Bartlet house","Food : Restaurants","Food","Restaurants","With Anna Isa Karina - near isa",$76.14,$0.00,-$4012.94
"Discover",,U,,05/19/2019,"Bopha Angkors Stir Crazy","Food : Restaurants","Food","Restaurants","",$78.16,$0.00,-$4091.10
"Discover",,U,,05/21/2019,"Hot Topic","Personal : Gifts","Personal","Gifts","ALyssa?",$29.91,$0.00,-$4121.01
"Discover",,U,,05/22/2019,"AC MOORE","Recreation : Entertainment","Recreation","Entertainment","art supplies pencils",$10.61,$0.00,-$4131.62
"Discover",,U,,05/22/2019,"trader Joes","Food : Groceries","Food","Groceries","",$87.70,$0.00,-$4219.32
"Discover",,U,,05/24/2019,"cardsmart","Personal : Gifts","Personal","Gifts","",$10.87,$0.00,-$4230.19
"Discover",,U,,05/24/2019,"Shell","Transportation : Gas","Transportation","Gas","Wrentham",$23.47,$0.00,-$4253.66
"Discover",,U,,05/25/2019,"cvs","Personal : nom-prescription medication","Personal","nom-prescription medication","",$14.94,$0.00,-$4268.60
"Discover",,U,,05/25/2019,"stop & shop","Food : Groceries","Food","Groceries","Dennis",$87.54,$0.00,-$4356.14
"Discover",,U,,05/26/2019,"peterson market dennis","Food : Groceries","Food","Groceries","",$26.64,$0.00,-$4382.78
"Discover",,U,,05/28/2019,"Exxon mobile","Transportation : Gas","Transportation","Gas","Ayer",$24.73,$0.00,-$4407.51
"Discover",,U,,05/28/2019,"trader Joes","Food : Groceries","Food","Groceries","",$74.43,$0.00,-$4481.94
"Discover",,U,,05/30/2019,"dunkin donuts","Food : Restaurants","Food","Restaurants","",$5.61,$0.00,-$4487.55
"Discover",,U,,05/30/2019,"CAVICCHIO GREENHOUSES","Lisa Business : Business expenses","Lisa Business","Business expenses","",$289.21,$0.00,-$4776.76
"Discover",,U,,05/30/2019,"CAVICCHIO GREENHOUSES","Lisa Business : Business expenses","Lisa Business","Business expenses","",$392.06,$0.00,-$5168.82
"Discover",,U,,05/31/2019,"Lowe's of plainville","RV : MISC","RV","MISC","Garden stuff",$21.30,$0.00,-$5190.12
"Discover",,U,,05/31/2019,"Shell","Transportation : Gas","Transportation","Gas","",$25.53,$0.00,-$5215.65
"Discover",,U,,05/31/2019,"grubhub","Food : Restaurants","Food","Restaurants","Lunch Marlboro - wrong meals",$29.96,$0.00,-$5245.61
"Discover",,U,,06/01/2019,"cvs","Personal : nom-prescription medication","Personal","nom-prescription medication","",$10.00,$0.00,-$5255.61
"Discover",,U,,06/01/2019,"stop & shop","Food : Groceries","Food","Groceries","",$11.89,$0.00,-$5267.50
"Discover",,U,,06/01/2019,"russells garden center","Personal : Gifts","Personal","Gifts","",$75.04,$0.00,-$5342.54
"Discover",,U,,06/01/2019,"Progressive Insurance","RV : Insurance","RV","Insurance","",$1681.00,$0.00,-$7023.54
"Discover",,U,,06/02/2019,"trader Joes","Food : Groceries","Food","Groceries","",$98.70,$0.00,-$7122.24
"Discover",,U,,06/03/2019,"lowes","RV : Equipment/Supplies","RV","Equipment/Supplies","garden",$34.12,$0.00,-$7156.36
"Discover",,U,,06/03/2019,"comfort suites","RV : Hotel","RV","Hotel","Maine For Kate Grad",$144.96,$0.00,-$7301.32
"Discover",,U,,06/04/2019,"Shell","Transportation : Gas","Transportation","Gas","",$23.12,$0.00,-$7324.44
"Discover",,U,,06/04/2019,"Normandy Farms","RV : Campgrounds","RV","Campgrounds","Electric",$125.84,$0.00,-$7450.28
"Discover",,U,,06/05/2019,"Nytimes","Recreation : Entertainment","Recreation","Entertainment","",$4.00,$0.00,-$7454.28
"Discover",,U,,06/05/2019,"cvs","Personal : nom-prescription medication","Personal","nom-prescription medication","medfield",$21.53,$0.00,-$7475.81
"Discover",,U,,06/06/2019,"Transfer : Dcu Checking",,,,"",$0.00,$3466.07,-$4009.74
"Discover",,U,,06/06/2019,"Don's diner","Food : Restaurants","Food","Restaurants","",$23.42,$0.00,-$4033.16
"Discover",,U,,06/06/2019,"Lowe's plainview","RV : MISC","RV","MISC","plants",$30.65,$0.00,-$4063.81
"Discover",,U,,06/06/2019,"T&D auto and truck","RV : Maintenance","RV","Maintenance","Oil change and generator",$266.54,$0.00,-$4330.35
"Discover",,U,,06/07/2019,"Normandy Farms","RV : Campgrounds","RV","Campgrounds","Guest fee",$30.00,$0.00,-$4360.35
"Discover",,U,,06/07/2019,"trader Joes","Food : Groceries","Food","Groceries","",$109.40,$0.00,-$4469.75
"Discover",,U,,06/08/2019,"Market bskt","Food : Groceries","Food","Groceries","Lunch on trip to main",$16.59,$0.00,-$4486.34
"Discover",,U,,06/09/2019,"Portland me parking","Transportation : Parking","Transportation","Parking","",$10.00,$0.00,-$4496.34
"Discover",,U,,06/09/2019,"Big Apple Portland","Transportation : Gas","Transportation","Gas","",$24.28,$0.00,-$4520.62
"Discover",,U,,06/09/2019,"Casa Vllarta","Food : Restaurants","Food","Restaurants","Saugus",$58.12,$0.00,-$4578.74
"Discover",,U,,06/16/2019,"itunes","Recreation : Entertainment","Recreation","Entertainment","",$0.99,$0.00,-$4579.73
"Discover",,U,,06/16/2019,"itunes","Recreation : Entertainment","Recreation","Entertainment","",$0.99,$0.00,-$4580.72
"Discover",,U,,06/16/2019,"stop & shop","Food : Groceries","Food","Groceries","dennis",$10.87,$0.00,-$4591.59
"Discover",,U,,06/16/2019,"speedway","Transportation : Gas","Transportation","Gas","Buzzards Bay",$22.58,$0.00,-$4614.17
"Discover",,U,,06/16/2019,"RIng Brothers Market place","Food : Groceries","Food","Groceries","",$23.76,$0.00,-$4637.93
"Discover",,U,,06/16/2019,"RIng Brothers Market place","Food : Groceries","Food","Groceries","",$25.00,$0.00,-$4662.93
"Discover",,U,,06/17/2019,"McDonalds","Food : Restaurants","Food","Restaurants","",$1.07,$0.00,-$4664.00
"Discover",,U,,06/17/2019,"Plymouth and Brock","Transportation : Air/train/bus/etc","Transportation","Air/train/bus/etc","",$9.00,$0.00,-$4673.00
"Discover",,U,,06/17/2019,"trader Joes","Food : Groceries","Food","Groceries","",$42.46,$0.00,-$4715.46
"Discover",,U,,06/17/2019,"verlock","Recreation : Entertainment","Recreation","Entertainment","Class for Alyssa and I",$840.00,$0.00,-$5555.46
"Discover",,U,,06/19/2019,"Ocean State Joblot","RV : Equipment/Supplies","RV","Equipment/Supplies","",$12.22,$0.00,-$5567.68
"Discover",,U,,06/19/2019,"Lords Pizza","Food : Restaurants","Food","Restaurants","",$26.11,$0.00,-$5593.79
"Discover",,U,,06/20/2019,"Plymouth and Brock","Transportation : Air/train/bus/etc","Transportation","Air/train/bus/etc","",$11.00,$0.00,-$5604.79
"Discover",,U,,06/20/2019,"netflix","Recreation : Entertainment","Recreation","Entertainment","",$12.99,$0.00,-$5617.78
"Discover",,U,,06/20/2019,"Hoyt Solomon pond mall","Recreation : Entertainment","Recreation","Entertainment","",$27.40,$0.00,-$5645.18
"Discover",,U,,06/21/2019,"Shell","Transportation : Gas","Transportation","Gas","",$15.92,$0.00,-$5661.10
"Discover",,U,,06/21/2019,"Sullivan tire","Financial Help : Mom And Dad","Financial Help","Mom And Dad","Tires dads car",$412.86,$0.00,-$6073.96
"Discover",,U,,06/23/2019,"redbox","Recreation : Entertainment","Recreation","Entertainment","",$2.39,$0.00,-$6076.35
"Discover",,U,,06/23/2019,"Normandy Farms","RV : Campgrounds","RV","Campgrounds","Firewood",$7.00,$0.00,-$6083.35
"Discover",,U,,06/23/2019,"trader Joes","Food : Groceries","Food","Groceries","",$68.11,$0.00,-$6151.46
"Discover",,U,,06/24/2019,"cvs","Personal : Prescriptions, Medicine","Personal","Prescriptions, Medicine","",$10.00,$0.00,-$6161.46
"Discover",,U,,06/24/2019,"Plymouth and Brock","Transportation : Air/train/bus/etc","Transportation","Air/train/bus/etc","",$11.00,$0.00,-$6172.46
"Discover",,U,,06/24/2019,"Allergy and Asma","Personal : Doctor, Dentist","Personal","Doctor, Dentist","",$18.00,$0.00,-$6190.46
"Discover",,U,,06/24/2019,"RMV Attleboro","Financial Help : Alyssa","Financial Help","Alyssa","RMV",$30.00,$0.00,-$6220.46
"Discover",,U,,06/24/2019,"stop & shop","Food : Groceries","Food","Groceries","",$50.25,$0.00,-$6270.71
"Discover",,U,,06/26/2019,"Gulf express","Transportation : Gas","Transportation","Gas","Foxboro",$23.02,$0.00,-$6293.73
"Discover",,U,,06/27/2019,"new city ice cream","Food : Restaurants","Food","Restaurants","",$26.34,$0.00,-$6320.07
"Discover",,U,,06/27/2019,"trader Joes","Food : Groceries","Food","Groceries","Foxboro",$72.73,$0.00,-$6392.80
"Discover",,U,,06/27/2019,"verizon wireless","RV : Cell Phones and Data","RV","Cell Phones and Data","New Phone",$464.99,$0.00,-$6857.79
"Discover",,U,,06/29/2019,"Lizzy's","Food : Restaurants","Food","Restaurants","ice cream Waltham",$14.74,$0.00,-$6872.53
"Discover",,U,,06/30/2019,"Shell","Transportation : Gas","Transportation","Gas","",$25.20,$0.00,-$6897.73
"Discover",,U,,06/30/2019,"Market bskt","Food : Groceries","Food","Groceries","",$29.58,$0.00,-$6927.31
"Discover",,U,,07/01/2019,"lowes plainville","Recreation : Entertainment","Recreation","Entertainment","garden",$5.51,$0.00,-$6932.82
"Discover",,U,,07/02/2019,"open season","Food : Restaurants","Food","Restaurants","campground rest",$49.37,$0.00,-$6982.19
"Discover",,U,,07/02/2019,"Market bskt","Food : Groceries","Food","Groceries","",$96.07,$0.00,-$7078.26
"Discover",,U,,07/02/2019,"Normandy Farms","RV : Campgrounds","RV","Campgrounds","electrice and guests",$156.28,$0.00,-$7234.54
"Discover",,U,,07/03/2019,"Nytimes","Recreation : Entertainment","Recreation","Entertainment","",$4.00,$0.00,-$7238.54
"Discover",,U,,07/04/2019,"trader Joes","Food : Groceries","Food","Groceries","",$45.59,$0.00,-$7284.13
"Discover",,U,,07/06/2019,"Transfer : Dcu Checking",,,,"",$0.00,$4544.46,-$2739.67
"Discover",,U,,07/06/2019,"dunkin donuts","Food : Restaurants","Food","Restaurants","",$6.47,$0.00,-$2746.14
"Discover",,U,,07/06/2019,"Hoyts Solomon pind","Recreation : Entertainment","Recreation","Entertainment","movies",$22.40,$0.00,-$2768.54
"Discover",,U,,07/06/2019,"Shell","Transportation : Gas","Transportation","Gas","Berlin",$26.22,$0.00,-$2794.76
"Discover",,U,,07/06/2019,"open season","Food : Restaurants","Food","Restaurants","campground rest",$29.39,$0.00,-$2824.15
"Discover",,U,,07/06/2019,"Normandy Farms","RV : Campgrounds","RV","Campgrounds","guests",$30.00,$0.00,-$2854.15
"Discover",,U,,07/07/2019,"Patel Brothers","Food : Groceries","Food","Groceries","north attleboro",$19.51,$0.00,-$2873.66
"Discover",,U,,07/07/2019,"cvs","Personal : Prescriptions, Medicine","Personal","Prescriptions, Medicine","",$32.00,$0.00,-$2905.66
"Discover",,U,,07/07/2019,"Walmart","RV : Equipment/Supplies","RV","Equipment/Supplies","(Split 1/2) ",$20.00,$0.00,-$2967.32
"Discover",,U,,07/07/2019,"Walmart","Food : Groceries","Food","Groceries","(Split 2/2) ",$41.66,$0.00,-$2967.32
"Discover",,U,,07/08/2019,"linguines","Food : Restaurants","Food","Restaurants","Dinner with Tom and Barb",$98.91,$0.00,-$3066.23
"Discover",,U,,07/09/2019,"dunkin donuts","Food : Restaurants","Food","Restaurants","",$3.41,$0.00,-$3069.64
"Discover",,U,,07/09/2019,"speedway","Transportation : Gas","Transportation","Gas","Franklin",$18.09,$0.00,-$3087.73
"Discover",,U,,07/11/2019,"Cnsmg","Personal : Doctor, Dentist","Personal","Doctor, Dentist","Othopedic Dr Susan Chabot",$18.00,$0.00,-$3105.73
"Discover",,U,,07/11/2019,"Cts Store Foxboro","Personal : Miscellaneous","Personal","Miscellaneous","",$18.16,$0.00,-$3123.89
"Discover",,U,,07/11/2019,"fuller craft museam","Recreation : Entertainment","Recreation","Entertainment","With Anna Karina Mary and Anna friend Kathy",$24.00,$0.00,-$3147.89
"Discover",,U,,07/11/2019,"trader Joes","Food : Groceries","Food","Groceries","",$71.97,$0.00,-$3219.86
"Discover",,U,,07/12/2019,"Normandy Farms","RV : Campgrounds","RV","Campgrounds","Guest fee",$15.00,$0.00,-$3234.86
"Discover",,U,,07/13/2019,"Berry Fram Chatham NY","Food : Groceries","Food","Groceries","at Isas",$17.20,$0.00,-$3252.06
"Discover",,U,,07/13/2019,"Shell Wrentham","Transportation : Gas","Transportation","Gas","",$21.78,$0.00,-$3273.84
"Discover",,U,,07/13/2019,"Chilacotes","Food : Restaurants","Food","Restaurants","Friday Dinner with Alyssa",$30.74,$0.00,-$3304.58
"Discover",,U,,07/14/2019,"Daily Bread","Food : Groceries","Food","Groceries","",$3.24,$0.00,-$3307.82
"Discover",,U,,07/14/2019,"Ludlow","Food : Restaurants","Food","Restaurants","on Mass Pike",$9.12,$0.00,-$3316.94
"Discover",,U,,07/14/2019,"Daily Bread","Food : Groceries","Food","Groceries","",$27.00,$0.00,-$3343.94
"Discover",,U,,07/15/2019,"McDonalds","Food : Restaurants","Food","Restaurants","coffee",$6.83,$0.00,-$3350.77
"Discover",,U,,07/15/2019,"Shell","Transportation : Gas","Transportation","Gas","Berlin Ma",$24.57,$0.00,-$3375.34
"Discover",,U,,07/15/2019,"Old chatham","Food : Restaurants","Food","Restaurants","Ann Josh Isa Breakfast",$84.26,$0.00,-$3459.60
"Discover",,U,,07/16/2019,"itunes","Recreation : Entertainment","Recreation","Entertainment","",$0.99,$0.00,-$3460.59
"Discover",,U,,07/16/2019,"itunes","Recreation : Entertainment","Recreation","Entertainment","",$0.99,$0.00,-$3461.58
"Discover",,U,,07/16/2019,"dunkin donuts","Food : Restaurants","Food","Restaurants","",$7.68,$0.00,-$3469.26
"Discover",,U,,07/16/2019,"United airline","Transportation : Air/train/bus/etc","Transportation","Air/train/bus/etc","Trip to Texas to help marta drive back",$159.30,$0.00,-$3628.56
"Discover",,U,,07/18/2019,"Cape Ann brewing","Food : Restaurants","Food","Restaurants","Farnando Irene Doug Linda",$151.14,$0.00,-$3779.70
"Discover",,U,,07/19/2019,"Exxon mobile","Transportation : Gas","Transportation","Gas","Essex Ma",$26.73,$0.00,-$3806.43
"Discover",,U,,07/19/2019,"Woodmans","Food : Restaurants","Food","Restaurants","Lunch with Lisa",$29.72,$0.00,-$3836.15
"Discover",,U,,07/20/2019,"dennis public market","Food : Groceries","Food","Groceries","",$24.92,$0.00,-$3861.07
"Discover",,U,,07/22/2019,"Primary Care Cape Cod","Personal : Doctor, Dentist","Personal","Doctor, Dentist","",$10.00,$0.00,-$3871.07
"Discover",,U,,07/22/2019,"EHS Optical","Personal : Doctor, Dentist","Personal","Doctor, Dentist","",$18.00,$0.00,-$3889.07
"Discover",,U,,07/22/2019,"Exxon mobile","Transportation : Gas","Transportation","Gas","",$26.98,$0.00,-$3916.05
"Discover",,U,,07/22/2019,"Hyannis country Garden","Personal : Gifts","Personal","Gifts","Plants for Mom and Dad Cape house",$59.45,$0.00,-$3975.50
"Discover",,U,,07/23/2019,"paypal Fax zero","Personal : Health Insurance","Personal","Health Insurance","FAX to Health connector",$1.99,$0.00,-$3977.49
"Discover",,U,,07/23/2019,"trader Joes","Food : Groceries","Food","Groceries","",$130.06,$0.00,-$4107.55
"Discover",,U,,07/25/2019,"redbox","Recreation : Entertainment","Recreation","Entertainment","",$1.86,$0.00,-$4109.41
"Discover",,U,,07/25/2019,"dunkin donuts","Food : Restaurants","Food","Restaurants","Groton",$7.36,$0.00,-$4116.77
"Discover",,U,,07/26/2019,"cvs","Personal : Prescriptions, Medicine","Personal","Prescriptions, Medicine","",$3.00,$0.00,-$4119.77
"Discover",,U,,07/26/2019,"Roslindale house of pizza","Food : Restaurants","Food","Restaurants","",$8.99,$0.00,-$4128.76
"Discover",,U,,07/26/2019,"bspt","Personal : Doctor, Dentist","Personal","Doctor, Dentist","PHysical therapy",$10.00,$0.00,-$4138.76
"Discover",,U,,07/26/2019,"McDonalds","Food : Restaurants","Food","Restaurants","",$10.24,$0.00,-$4149.00
"Discover",,U,,07/26/2019,"Brick fire pizza","Food : Restaurants","Food","Restaurants","",$10.43,$0.00,-$4159.43
"Discover",,U,,07/26/2019,"Exxon mobile","Transportation : Gas","Transportation","Gas","Foxboro",$24.09,$0.00,-$4183.52
"Discover",,U,,07/26/2019,"stop & shop","Food : Groceries","Food","Groceries","Plainville",$37.91,$0.00,-$4221.43
"Discover",,U,,07/27/2019,"dunkin donuts","Food : Restaurants","Food","Restaurants","",$19.28,$0.00,-$4240.71
"Discover",,U,,07/27/2019,"Steve Connelly Seafood","Food : Groceries","Food","Groceries","FISH GLOUCESTER",$69.00,$0.00,-$4309.71
"Discover",,U,,07/29/2019,"bspt","Personal : Doctor, Dentist","Personal","Doctor, Dentist","",$10.00,$0.00,-$4319.71
"Discover",,U,,07/29/2019,"trader Joes","Food : Groceries","Food","Groceries","",$40.28,$0.00,-$4359.99
"Discover",,U,,07/29/2019,"Childrends Dentistry","Financial Help : Alyssa","Financial Help","Alyssa","",$92.50,$0.00,-$4452.49
"Discover",,U,,07/30/2019,"itunes","Recreation : Entertainment","Recreation","Entertainment","",$2.38,$0.00,-$4454.87
"Discover",,U,,07/30/2019,"speedway","Transportation : Gas","Transportation","Gas","Bellingham",$23.94,$0.00,-$4478.81
"Discover",,U,,07/30/2019,"Market bskt","Food : Groceries","Food","Groceries","",$26.77,$0.00,-$4505.58
"Discover",,U,,07/30/2019,"open season","Food : Restaurants","Food","Restaurants","Lunch with hung",$31.62,$0.00,-$4537.20
"Discover",,U,,07/31/2019,"Nytimes","Recreation : Entertainment","Recreation","Entertainment","",$4.00,$0.00,-$4541.20
"Discover",,U,,07/31/2019,"USPS","Personal : Miscellaneous","Personal","Miscellaneous","Stamps?",$11.70,$0.00,-$4552.90
"Discover",,U,,07/31/2019,"Wegmans","Food : Restaurants","Food","Restaurants","",$34.63,$0.00,-$4587.53
"Discover",,U,,07/31/2019,"Wegmans","Financial Help : Alyssa","Financial Help","Alyssa","",$89.74,$0.00,-$4677.27
"Discover",,U,,08/01/2019,"PEETS COFFEEE SSFO","Food : Restaurants","Food","Restaurants","",$9.31,$0.00,-$4686.58
"Discover",,U,,08/01/2019,"bspt","Personal : Doctor, Dentist","Personal","Doctor, Dentist","",$10.00,$0.00,-$4696.58
"Discover",,U,,08/01/2019,"Amazon","Recreation : Entertainment","Recreation","Entertainment","",$24.85,$0.00,-$4721.43
"Discover",,U,,08/02/2019,"Brick fire pizza","Food : Restaurants","Food","Restaurants","",$8.29,$0.00,-$4729.72
"Discover",,U,,08/02/2019,"cvs","Personal : Prescriptions, Medicine","Personal","Prescriptions, Medicine","",$14.11,$0.00,-$4743.83
"Discover",,U,,08/02/2019,"starbucks","Food : Restaurants","Food","Restaurants","",$25.01,$0.00,-$4768.84
"Discover",,U,,08/03/2019,"Pilot","Transportation : Gas","Transportation","Gas","",$10.89,$0.00,-$4779.73
"Discover",,U,,08/03/2019,"Pappadeaux seafood","Food : Restaurants","Food","Restaurants","texas trip marta drive",$14.72,$0.00,-$4794.45
"Discover",,U,,08/04/2019,"Amazon","Recreation : Entertainment","Recreation","Entertainment","",$1.98,$0.00,-$4796.43
"Discover",,U,,08/04/2019,"subway","Food : Restaurants","Food","Restaurants","",$13.06,$0.00,-$4809.49
"Discover",,U,,08/04/2019,"cvs","Personal : Prescriptions, Medicine","Personal","Prescriptions, Medicine","newton",$16.49,$0.00,-$4825.98
"Discover",,U,,08/04/2019,"Sunoco","Transportation : Gas","Transportation","Gas","Newton",$26.37,$0.00,-$4852.35
"Discover",,U,,08/04/2019,"stone l'oven pizza","Food : Restaurants","Food","Restaurants","Waban Ma",$27.00,$0.00,-$4879.35
"Discover",,U,,08/04/2019,"Dublin omelette shop","Food : Restaurants","Food","Restaurants","",$28.76,$0.00,-$4908.11
"Discover",,U,,08/05/2019,"restaurants","Food : Restaurants","Food","Restaurants","Pilot  VA trip with marta",$7.27,$0.00,-$4915.38
"Discover",,U,,08/05/2019,"walgreens","Personal : nom-prescription medication","Personal","nom-prescription medication","",$8.27,$0.00,-$4923.65
"Discover",,U,,08/05/2019,"bspt","Personal : Doctor, Dentist","Personal","Doctor, Dentist","",$10.00,$0.00,-$4933.65
"Discover",,U,,08/05/2019,"Amazon","Recreation : Entertainment","Recreation","Entertainment","",$31.82,$0.00,-$4965.47
"Discover",,U,,08/05/2019,"trader Joes","Food : Groceries","Food","Groceries","",$44.84,$0.00,-$5010.31
"Discover",,U,,08/06/2019,"Transfer : Dcu Checking",,,,"",$0.00,$3105.73,-$1904.58
"Discover",,U,,08/06/2019,"cvs","Personal : Prescriptions, Medicine","Personal","Prescriptions, Medicine","dennis ma",$5.40,$0.00,-$1909.98
"Discover",,U,,08/06/2019,"Primary Care Cape Cod","Personal : Doctor, Dentist","Personal","Doctor, Dentist","",$10.00,$0.00,-$1919.98
"Discover",,U,,08/06/2019,"speedway","Transportation : Gas","Transportation","Gas","",$15.60,$0.00,-$1935.58
"Discover",,U,,08/06/2019,"stop & shop","Food : Groceries","Food","Groceries","mansfield",$27.44,$0.00,-$1963.02
"Discover",,U,,08/06/2019,"cvs","Personal : Prescriptions, Medicine","Personal","Prescriptions, Medicine","dennis ma",$49.49,$0.00,-$2012.51
"Discover",,U,,08/08/2019,"Dunn Gatherin","Food : Restaurants","Food","Restaurants","Lisa and alyssa",$57.13,$0.00,-$2069.64
"Discover",,U,,08/09/2019,"bspt","Personal : Doctor, Dentist","Personal","Doctor, Dentist",,$10.00,$0.00,-$2079.64
"Discover",,U,,08/09/2019,"open season","Food : Restaurants","Food","Restaurants","",$10.68,$0.00,-$2090.32
"Discover",,U,,08/09/2019,"Normandy Farms","RV : Campgrounds","RV","Campgrounds","guests",$15.00,$0.00,-$2105.32
"Discover",,U,,08/09/2019,"Cumberland Farms","Transportation : Gas","Transportation","Gas","",$23.47,$0.00,-$2128.79
"Discover",,U,,08/09/2019,"stop & shop","Food : Groceries","Food","Groceries","",$57.58,$0.00,-$2186.37
"Discover",,U,,08/10/2019,"Chicolattes Boston","Food : Restaurants","Food","Restaurants","",$15.96,$0.00,-$2202.33
"Discover",,U,,08/10/2019,"trader Joes","Food : Groceries","Food","Groceries","",$57.83,$0.00,-$2260.16
"Discover",,U,,08/11/2019,"Normandy Farms","RV : Campgrounds","RV","Campgrounds","guests",$45.00,$0.00,-$2305.16
"Discover",,U,,08/11/2019,"stop & shop","Food : Groceries","Food","Groceries","",$85.44,$0.00,-$2390.60
"Discover",,U,,08/12/2019,"redbox","Recreation : Entertainment","Recreation","Entertainment","",$1.86,$0.00,-$2392.46
"Discover",,U,,08/12/2019,"bspt","Personal : Doctor, Dentist","Personal","Doctor, Dentist","",$10.00,$0.00,-$2402.46
"Discover",,U,,08/12/2019,"99rant marlboro","Food : Restaurants","Food","Restaurants","",$14.58,$0.00,-$2417.04
"Discover",,U,,08/12/2019,"cvs","Personal : Prescriptions, Medicine","Personal","Prescriptions, Medicine","",$16.36,$0.00,-$2433.40
"Discover",,U,,08/12/2019,"Exxon mobile","Transportation : Gas","Transportation","Gas","",$22.52,$0.00,-$2455.92
"Discover",,U,,08/14/2019,"Panera Bread","Food : Restaurants","Food","Restaurants","",$19.77,$0.00,-$2475.69
"Discover",,U,,08/15/2019,"bspt","Personal : Doctor, Dentist","Personal","Doctor, Dentist","",$10.00,$0.00,-$2485.69
"Discover",,U,,08/15/2019,"foxboro dental","Personal : Doctor, Dentist","Personal","Doctor, Dentist","Bob Sore Tooth",$87.00,$0.00,-$2572.69
"Discover",,U,,08/15/2019,"Normandy Farms","RV : Equipment/Supplies","RV","Equipment/Supplies","chairs",$95.63,$0.00,-$2668.32
"Discover",,U,,08/15/2019,"trader Joes","Food : Groceries","Food","Groceries","",$124.75,$0.00,-$2793.07
"Discover",,U,,08/16/2019,"Dr Chabot","Personal : Doctor, Dentist","Personal","Doctor, Dentist","",$18.00,$0.00,-$2811.07
"Discover",,U,,08/16/2019,"Brick fire pizza","Food : Restaurants","Food","Restaurants","",$22.47,$0.00,-$2833.54
"Discover",,U,,08/16/2019,"Exxon mobile","Transportation : Gas","Transportation","Gas","",$22.56,$0.00,-$2856.10
"Discover",,U,,08/16/2019,"Normandy Farms","RV : Campgrounds","RV","Campgrounds","",$30.00,$0.00,-$2886.10
"Discover",,U,,08/16/2019,"Normandy Farms","RV : Campgrounds","RV","Campgrounds","guests",$30.00,$0.00,-$2916.10
"Discover",,U,,08/16/2019,"Normandy Farms","RV : Campgrounds","RV","Campgrounds","guests",$60.00,$0.00,-$2976.10
"Discover",,U,,08/17/2019,"itunes","Recreation : Entertainment","Recreation","Entertainment","",$0.99,$0.00,-$2977.09
"Discover",,U,,08/17/2019,"Normandy Farms","RV : Equipment/Supplies","RV","Equipment/Supplies","",$10.58,$0.00,-$2987.67
"Discover",,U,,08/17/2019,"Normandy Farms","RV : Campgrounds","RV","Campgrounds","",$15.00,$0.00,-$3002.67
"Discover",,U,,08/17/2019,"Wal-mart","RV : Equipment/Supplies","RV","Equipment/Supplies","Propane sewer hose toilet paper",$57.90,$0.00,-$3060.57
"Discover",,U,,08/17/2019,"Market bskt","Food : Groceries","Food","Groceries","",$126.73,$0.00,-$3187.30
"Discover",,U,,08/17/2019,"Normandy Farms","RV : Campgrounds","RV","Campgrounds","Guests and electirc",$177.70,$0.00,-$3365.00
"Discover",,U,,08/19/2019,"Normandy Farms","RV : Campgrounds","RV","Campgrounds","Foxboro Ma",$0.00,$20.00,-$3345.00
"Discover",,U,,08/19/2019,"cvs","Personal : Prescriptions, Medicine","Personal","Prescriptions, Medicine","",$5.30,$0.00,-$3350.30
"Discover",,U,,08/19/2019,"bspt","Personal : Doctor, Dentist","Personal","Doctor, Dentist","",$10.00,$0.00,-$3360.30
"Discover",,U,,08/19/2019,"cibo Matto caffee","Food : Restaurants","Food","Restaurants","Anniversary DInner Mansfield Ma",$138.00,$0.00,-$3498.30
"Discover",,U,,08/21/2019,"open season","Food : Restaurants","Food","Restaurants","",$10.16,$0.00,-$3508.46
"Discover",,U,,08/21/2019,"antonias Italian","Food : Restaurants","Food","Restaurants","Pizza luke cliff",$19.77,$0.00,-$3528.23
"Discover",,U,,08/21/2019,"kendal green","Transportation : Gas","Transportation","Gas","",$28.14,$0.00,-$3556.37
"Discover",,U,,08/22/2019,"bspt","Personal : Doctor, Dentist","Personal","Doctor, Dentist","",$10.00,$0.00,-$3566.37
"Discover",,U,,08/22/2019,"A1 auto","Transportation : Repairs & Maintenance","Transportation","Repairs & Maintenance","Oil change fix slow leak",$65.88,$0.00,-$3632.25
"Discover",,U,,08/22/2019,"House of fortune","Food : Restaurants","Food","Restaurants","Chinese - Pretty good",$88.46,$0.00,-$3720.71
"Discover",,U,,08/23/2019,"mass audobon","Recreation : Entertainment","Recreation","Entertainment","walk at audobon",$8.00,$0.00,-$3728.71
"Discover",,U,,08/23/2019,"samscott Garden","Food : Restaurants","Food","Restaurants","food at Isas BBQ",$9.49,$0.00,-$3738.20
"Discover",,U,,08/24/2019,"Gulfmart","Transportation : Gas","Transportation","Gas","",$19.19,$0.00,-$3757.39
"Discover",,U,,08/24/2019,"Ula cafe","Food : Restaurants","Food","Restaurants","with alyssa",$21.62,$0.00,-$3779.01
"Discover",,U,,08/24/2019,"redbubble","Personal : Gifts","Personal","Gifts","",$30.55,$0.00,-$3809.56
"Discover",,U,,08/25/2019,"McDonalds","Food : Restaurants","Food","Restaurants","coffee",$3.41,$0.00,-$3812.97
"Discover",,U,,08/25/2019,"union house","Food : Restaurants","Food","Restaurants","",$47.57,$0.00,-$3860.54
"Discover",,U,,08/26/2019,"bspt","Personal : Doctor, Dentist","Personal","Doctor, Dentist","",$10.00,$0.00,-$3870.54
"Discover",,U,,08/26/2019,"Cumberland Farms","Transportation : Gas","Transportation","Gas","",$20.13,$0.00,-$3890.67
"Discover",,U,,08/26/2019,"trader Joes","Food : Groceries","Food","Groceries","",$115.55,$0.00,-$4006.22
"Discover",,U,,08/28/2019,"Nytimes","Recreation : Entertainment","Recreation","Entertainment","",$4.00,$0.00,-$4010.22
"Discover",,U,,08/29/2019,"bspt","Personal : Doctor, Dentist","Personal","Doctor, Dentist","",$10.00,$0.00,-$4020.22
"Discover",,U,,08/29/2019,"Normandy Farms","RV : Campgrounds","RV","Campgrounds","guest",$15.00,$0.00,-$4035.22
"Discover",,U,,08/29/2019,"Shell","Transportation : Gas","Transportation","Gas","Wrentham",$19.83,$0.00,-$4055.05
"Discover",,U,,08/30/2019,"itunes","Recreation : Entertainment","Recreation","Entertainment","",$2.99,$0.00,-$4058.04
"Discover",,U,,08/30/2019,"Brick fire pizza","Food : Restaurants","Food","Restaurants","",$19.26,$0.00,-$4077.30
"Discover",,U,,08/30/2019,"Amazon","Recreation : Entertainment","Recreation","Entertainment","",$22.38,$0.00,-$4099.68
"Discover",,U,,08/31/2019,"mass audobon","Recreation : Entertainment","Recreation","Entertainment","",$11.00,$0.00,-$4110.68
"Discover",,U,,08/31/2019,"trader Joes","Food : Groceries","Food","Groceries","",$129.30,$0.00,-$4239.98
"Discover",,U,,09/01/2019,"walnut Grill","Food : Restaurants","Food","Restaurants","Neil and Ann - thanks for helping move Alyssa",$80.95,$0.00,-$4320.93
"Discover",,U,,09/02/2019,"Amazon","Recreation : Entertainment","Recreation","Entertainment","",$15.93,$0.00,-$4336.86
"Discover",,U,,09/02/2019,"Rons Ice Cream","Food : Restaurants","Food","Restaurants","Take out at Karina's with Lana",$16.50,$0.00,-$4353.36
"Discover",,U,,09/02/2019,"Shell","Transportation : Gas","Transportation","Gas","Wrentham",$23.50,$0.00,-$4376.86
"Discover",,U,,09/02/2019,"cvs","Personal : Prescriptions, Medicine","Personal","Prescriptions, Medicine","",$23.99,$0.00,-$4400.85
"Discover",,U,,09/02/2019,"narrows Too Resort","RV : Campgrounds","RV","Campgrounds","",$37.61,$0.00,-$4438.46
"Discover",,U,,09/02/2019,"narrows Too Resort","RV : Campgrounds","RV","Campgrounds","Maine Near Arcadia",$128.40,$0.00,-$4566.86
"Discover",,U,,09/02/2019,"Amazon","RV : Equipment/Supplies","RV","Equipment/Supplies","(Split 1/2) ",$70.00,$0.00,-$4705.56
"Discover",,U,,09/02/2019,"Amazon","Recreation : Entertainment","Recreation","Entertainment","(Split 2/2) ",$68.70,$0.00,-$4705.56
"Discover",,U,,09/03/2019,"Dsw Shops","Financial Help : Alyssa","Financial Help","Alyssa","Shoes",$59.99,$0.00,-$4765.55
"Discover",,U,,09/04/2019,"Normandy Farms","Food : Groceries","Food","Groceries","",$3.95,$0.00,-$4769.50
"Discover",,U,,09/04/2019,"walgreens","Personal : nom-prescription medication","Personal","nom-prescription medication","",$9.76,$0.00,-$4779.26
"Discover",,U,,09/05/2019,"bspt","Personal : Doctor, Dentist","Personal","Doctor, Dentist","",$10.00,$0.00,-$4789.26
"Discover",,U,,09/05/2019,"Shell","Transportation : Gas","Transportation","Gas","",$20.23,$0.00,-$4809.49
"Discover",,U,,09/05/2019,"Strand theatre","Recreation : Entertainment","Recreation","Entertainment","With Neil and Ann",$22.00,$0.00,-$4831.49
"Discover",,U,,09/06/2019,"Transfer : Dcu Checking",,,,"",$0.00,$2400.60,-$2430.89
"Discover",,U,,09/07/2019,"Exxon mobile","Transportation : Gas","Transportation","Gas","",$24.71,$0.00,-$2455.60
"Discover",,U,,09/07/2019,"Olivers","Food : Restaurants","Food","Restaurants","",$133.44,$0.00,-$2589.04
"Discover",,U,,09/08/2019,"Barnes and Noble","Recreation : Entertainment","Recreation","Entertainment","",$3.19,$0.00,-$2592.23
"Discover",,U,,09/08/2019,"Micheals","Recreation : Entertainment","Recreation","Entertainment","",$27.07,$0.00,-$2619.30
"Discover",,U,,09/08/2019,"stop & shop","Food : Groceries","Food","Groceries","",$172.53,$0.00,-$2791.83
"Discover",,U,,09/10/2019,"Exxon mobile","Transportation : Gas","Transportation","Gas","",$23.03,$0.00,-$2814.86
"Discover",,U,,09/10/2019,"trader Joes","Food : Groceries","Food","Groceries","",$31.42,$0.00,-$2846.28
"Discover",,U,,09/10/2019,"TicketLeapTickets","Recreation : Entertainment","Recreation","Entertainment","McKenzie Concert",$97.50,$0.00,-$2943.78
"Discover",,U,,09/11/2019,"Amazon","Recreation : Entertainment","Recreation","Entertainment","Bob  Gymnasitc rings",$37.95,$0.00,-$2981.73
"Discover",,U,,09/12/2019,"bspt","Personal : Doctor, Dentist","Personal","Doctor, Dentist","",$10.00,$0.00,-$2991.73
"Discover",,U,,09/12/2019,"bella Costa","Food : Restaurants","Food","Restaurants","With April and Kevin",$134.62,$0.00,-$3126.35
"Discover",,U,,09/14/2019,"Market bskt","Food : Groceries","Food","Groceries","",$18.95,$0.00,-$3145.30
"Discover",,U,,09/14/2019,"Mainst liquor","Food : Groceries","Food","Groceries","Wine at Lauras",$19.98,$0.00,-$3165.28
"Discover",,U,,09/14/2019,"Cumberland Farms","Transportation : Gas","Transportation","Gas","",$24.59,$0.00,-$3189.87
"Discover",,U,,09/15/2019,"AC MOORE","Recreation : Entertainment","Recreation","Entertainment","",$21.23,$0.00,-$3211.10
"Discover",,U,,09/16/2019,"Native plant trust","Personal : Gifts","Personal","Gifts","",$21.51,$0.00,-$3232.61
"Discover",,U,,09/16/2019,"savers Framingham","Personal : cloths","Personal","cloths","Bob Suite and shirt",$39.07,$0.00,-$3271.68
"Discover",,U,,09/16/2019,"Dsw","Personal : cloths","Personal","cloths","",$55.99,$0.00,-$3327.67
"Discover",,U,,09/16/2019,"Green leaf","Food : Restaurants","Food","Restaurants","WIth Rachel",$85.64,$0.00,-$3413.31
"Discover",,U,,09/16/2019,"Wegmans","Food : Groceries","Food","Groceries","",$113.12,$0.00,-$3526.43
"Discover",,U,,09/17/2019,"itunes","Recreation : Entertainment","Recreation","Entertainment","",$0.99,$0.00,-$3527.42
"Discover",,U,,09/17/2019,"UPS","RV : Equipment/Supplies","RV","Equipment/Supplies","",$18.09,$0.00,-$3545.51
"Discover",,U,,09/17/2019,"Exxon mobile","Transportation : Gas","Transportation","Gas","Groton",$22.74,$0.00,-$3568.25
"Discover",,U,,09/19/2019,"bspt","Personal : Doctor, Dentist","Personal","Doctor, Dentist","",$10.00,$0.00,-$3578.25
"Discover",,U,,09/20/2019,"Dons Diner","Food : Restaurants","Food","Restaurants","with guy and eileen Plainville Ma",$50.00,$0.00,-$3628.25
"Discover",,U,,09/20/2019,"Delfino","Food : Restaurants","Food","Restaurants","",$285.61,$0.00,-$3913.86
"Discover",,U,,09/21/2019,"gulf","Transportation : Gas","Transportation","Gas","",$20.62,$0.00,-$3934.48
"Discover",,U,,09/21/2019,"pho dakao","Food : Restaurants","Food","Restaurants","",$60.00,$0.00,-$3994.48
"Discover",,U,,09/21/2019,"Market bskt","Food : Groceries","Food","Groceries","",$162.64,$0.00,-$4157.12
"Discover",,U,,09/21/2019,"Walmart","RV : Equipment/Supplies","RV","Equipment/Supplies","",$214.60,$0.00,-$4371.72
"Discover",,U,,09/22/2019,"uno chicago grill","Food : Restaurants","Food","Restaurants","",$73.59,$0.00,-$4445.31
"Discover",,U,,09/23/2019,"cvs","Personal : Prescriptions, Medicine","Personal","Prescriptions, Medicine","",$56.62,$0.00,-$4501.93
"Discover",,U,,09/23/2019,"Cumberland Farms","RV : gasoline","RV","gasoline","",$98.16,$0.00,-$4600.09
"Discover",,U,,09/24/2019,"McDonalds","Food : Restaurants","Food","Restaurants","",$8.11,$0.00,-$4608.20
"Discover",,U,,09/24/2019,"Shell","Transportation : Gas","Transportation","Gas","",$25.40,$0.00,-$4633.60
"Discover",,U,,09/25/2019,"Nytimes","Recreation : Entertainment","Recreation","Entertainment","",$4.00,$0.00,-$4637.60
"Discover",,U,,09/25/2019,"NH liquor","Food : Groceries","Food","Groceries","liquour",$13.97,$0.00,-$4651.57
"Discover",,U,,09/25/2019,"narrows Too Resort","RV : Campgrounds","RV","Campgrounds",,$37.60,$0.00,-$4689.17
"Discover",,U,,09/25/2019,"gas maine","RV : gasoline","RV","gasoline","",$76.31,$0.00,-$4765.48
"Discover",,U,,09/26/2019,"redbubble","Personal : Gifts","Personal","Gifts","For Linday at PT",$27.59,$0.00,-$4793.07
"Discover",,U,,09/26/2019,"Chapter Two Corea ME","Personal : Gifts","Personal","Gifts","",$35.34,$0.00,-$4828.41
"Discover",,U,,09/28/2019,"town of barr harbor","Transportation : Parking","Transportation","Parking","",$4.00,$0.00,-$4832.41
"Discover",,U,,09/28/2019,"Mount Desert Island Ice Bar","Food : Restaurants","Food","Restaurants","icecream",$13.23,$0.00,-$4845.64
"Discover",,U,,09/28/2019,"Cool as a moose","Personal : cloths","Personal","cloths","Maine",$21.09,$0.00,-$4866.73
"Discover",,U,,09/29/2019,"itunes","Recreation : Entertainment","Recreation","Entertainment","",$2.99,$0.00,-$4869.72
"Discover",,U,,09/29/2019,"starbucks","Food : Restaurants","Food","Restaurants","",$9.45,$0.00,-$4879.17
"Discover",,U,,09/29/2019,"trader Joes","Food : Groceries","Food","Groceries","",$117.93,$0.00,-$4997.10
"Discover",,U,,09/30/2019,"Exxon mobile","Transportation : Gas","Transportation","Gas","yarnouth",$24.24,$0.00,-$5021.34
"Discover",,U,,09/30/2019,"Daily Paper","Food : Restaurants","Food","Restaurants","Hyannis",$27.00,$0.00,-$5048.34
"Discover",,U,,09/30/2019,"stop & shop","Food : Groceries","Food","Groceries","",$38.99,$0.00,-$5087.33
"Discover",,U,,10/01/2019,"WESTFORD DERMERTOLOGY","Personal : Doctor, Dentist","Personal","Doctor, Dentist","",$18.00,$0.00,-$5105.33
"Discover",,U,,10/02/2019,"exxon newton","Transportation : Gas","Transportation","Gas","",$24.59,$0.00,-$5129.92
"Discover",,U,,10/02/2019,"B GOOD","Food : Restaurants","Food","Restaurants","newton",$46.21,$0.00,-$5176.13
"Discover",,U,,10/02/2019,"Primark","Personal : cloths","Personal","cloths","",$49.21,$0.00,-$5225.34
"Discover",,U,,10/02/2019,"RMV","Transportation : Registration","Transportation","Registration","",$60.00,$0.00,-$5285.34
"Discover",,U,,10/02/2019,"Wegmans","Food : Groceries","Food","Groceries","westwood ma",$81.88,$0.00,-$5367.22
"Discover",,U,,10/03/2019,"redbox","Recreation : Entertainment","Recreation","Entertainment","",$3.72,$0.00,-$5370.94
"Discover",,U,,10/03/2019,"Bertucci","Food : Restaurants","Food","Restaurants","",$130.36,$0.00,-$5501.30
"Discover",,U,,10/04/2019,"cvs","Personal : Prescriptions, Medicine","Personal","Prescriptions, Medicine","",$25.00,$0.00,-$5526.30
"Discover",,U,,10/04/2019,"cvs","Personal : Prescriptions, Medicine","Personal","Prescriptions, Medicine","",$31.53,$0.00,-$5557.83
"Discover",,U,,10/04/2019,"ubreakifix","Personal : Miscellaneous","Personal","Miscellaneous","Phone Repair",$116.86,$0.00,-$5674.69
"Discover",,U,,10/05/2019,"peterson market dennis","Food : Restaurants","Food","Restaurants","Piza",$19.25,$0.00,-$5693.94
"Discover",,U,,10/05/2019,"Exxon mobile","Transportation : Gas","Transportation","Gas","",$23.53,$0.00,-$5717.47
"Discover",,U,,10/05/2019,"eggs & thai","Food : Restaurants","Food","Restaurants","",$82.20,$0.00,-$5799.67
"Discover",,U,,10/06/2019,"Transfer : Dcu Checking",,,,"",$0.00,$2991.73,-$2807.94
"Discover",,U,,10/06/2019,"Amazon","Recreation : Entertainment","Recreation","Entertainment","",$12.70,$0.00,-$2820.64
"Discover",,U,,10/07/2019,"Shell","Transportation : Gas","Transportation","Gas","",$17.86,$0.00,-$2838.50
"Discover",,U,,10/07/2019,"Allergy and Shtma","Personal : Doctor, Dentist","Personal","Doctor, Dentist","",$18.00,$0.00,-$2856.50
"Discover",,U,,10/07/2019,"V Care Pharmacy","Personal : Miscellaneous","Personal","Miscellaneous","",$35.00,$0.00,-$2891.50
"Discover",,U,,10/08/2019,"stop & shop","Food : Groceries","Food","Groceries","Dennis",$64.78,$0.00,-$2956.28
"Discover",,U,,10/09/2019,"cvs","Food : Groceries","Food","Groceries","",$14.64,$0.00,-$2970.92
"Discover",,U,,10/09/2019,"cvs","Personal : Prescriptions, Medicine","Personal","Prescriptions, Medicine","(Split 1/3) presciptions",$30.00,$0.00,-$3027.89
"Discover",,U,,10/09/2019,"cvs","RV : Equipment/Supplies","RV","Equipment/Supplies","(Split 2/3) equ",$20.00,$0.00,-$3027.89
"Discover",,U,,10/09/2019,"cvs","Food : Groceries","Food","Groceries","(Split 3/3) ",$6.97,$0.00,-$3027.89
"Discover",,U,,10/10/2019,"Best Buy","RV : Equipment/Supplies","RV","Equipment/Supplies","",$36.10,$0.00,-$3063.99
"Discover",,U,,10/11/2019,"SQ 4","Food : Restaurants","Food","Restaurants","pizza",$20.49,$0.00,-$3084.48
"Discover",,U,,10/12/2019,"stop & shop","Food : Groceries","Food","Groceries","",$64.87,$0.00,-$3149.35
"Discover",,U,,10/12/2019,"Blossom Florist","Personal : Gifts","Personal","Gifts","Carol Funeral",$116.25,$0.00,-$3265.60
"Discover",,U,,10/13/2019,"Shell","Transportation : Gas","Transportation","Gas","",$22.76,$0.00,-$3288.36
"Discover",,U,,10/13/2019,"cts west Ma","Personal : Gifts","Personal","Gifts","",$29.81,$0.00,-$3318.17
"Discover",,U,,10/14/2019,"RMV","Transportation : Registration","Transportation","Registration","",$50.00,$0.00,-$3368.17
"Discover",,U,,10/15/2019,"trader Joes","Food : Groceries","Food","Groceries","",$47.75,$0.00,-$3415.92
"Discover",,U,,10/15/2019,"austin east Koa","RV : Campgrounds","RV","Campgrounds","",$60.00,$0.00,-$3475.92
"Discover",,U,,10/16/2019,"cvs","Personal : Prescriptions, Medicine","Personal","Prescriptions, Medicine","",$26.85,$0.00,-$3502.77
"Discover",,U,,10/16/2019,"Ancient Oaks Rv park","RV : Campgrounds","RV","Campgrounds","",$35.00,$0.00,-$3537.77
"Discover",,U,,10/16/2019,"Ancient Oaks Rv park","RV : Campgrounds","RV","Campgrounds","",$45.00,$0.00,-$3582.77
"Discover",,U,,10/16/2019,"lajitas golf resort a","RV : Campgrounds","RV","Campgrounds","Maverick ranch rv",$54.00,$0.00,-$3636.77
"Discover",,U,,10/16/2019,"Thai tamarind westboro","Food : Restaurants","Food","Restaurants","Dinner with nick",$57.99,$0.00,-$3694.76
"Discover",,U,,10/16/2019,"austin east Koa","RV : Campgrounds","RV","Campgrounds","",$60.00,$0.00,-$3754.76
"Discover",,U,,10/17/2019,"Shell","Transportation : Gas","Transportation","Gas","Wrentham",$22.06,$0.00,-$3776.82
"Discover",,U,,10/17/2019,"vistaprint","RV : Equipment/Supplies","RV","Equipment/Supplies","Business cards",$30.17,$0.00,-$3806.99
"Discover",,U,,10/18/2019,"itunes","Recreation : Entertainment","Recreation","Entertainment","",$0.99,$0.00,-$3807.98
"Discover",,U,,10/18/2019,"Columbia Sportswear","Personal : cloths","Personal","cloths","Bob pants",$29.95,$0.00,-$3837.93
"Discover",,U,,10/18/2019,"Merril","Personal : cloths","Personal","cloths","bob rain jacket",$35.98,$0.00,-$3873.91
"Discover",,U,,10/18/2019,"reebok","Personal : cloths","Personal","cloths","bob shoes",$40.00,$0.00,-$3913.91
"Discover",,U,,10/18/2019,"rebok","Financial Help : Alyssa","Financial Help","Alyssa","Shoes for alyssa",$49.00,$0.00,-$3962.91
"Discover",,U,,10/19/2019,"Derby ridge farms","Food : Groceries","Food","Groceries","",$13.10,$0.00,-$3976.01
"Discover",,U,,10/19/2019,"Boltbus","Financial Help : Alyssa","Financial Help","Alyssa","Bus trip",$21.25,$0.00,-$3997.26
"Discover",,U,,10/19/2019,"Sunoco","Transportation : Gas","Transportation","Gas","",$25.00,$0.00,-$4022.26
"Discover",,U,,10/20/2019,"redbox","Recreation : Entertainment","Recreation","Entertainment","",$3.72,$0.00,-$4025.98
"Discover",,U,,10/21/2019,"cvs","Personal : Prescriptions, Medicine","Personal","Prescriptions, Medicine","",$15.50,$0.00,-$4041.48
"Discover",,U,,10/21/2019,"stop & shop","Food : Groceries","Food","Groceries","",$17.16,$0.00,-$4058.64
"Discover",,U,,10/21/2019,"trader Joes","Food : Groceries","Food","Groceries","",$37.49,$0.00,-$4096.13
"Discover",,U,,10/22/2019,"paypal","Personal : Gifts","Personal","Gifts","",$4.05,$0.00,-$4100.18
"Discover",,U,,10/22/2019,"cvs","Personal : Prescriptions, Medicine","Personal","Prescriptions, Medicine","",$12.14,$0.00,-$4112.32
"Discover",,U,,10/22/2019,"paypal","Personal : Gifts","Personal","Gifts","",$64.73,$0.00,-$4177.05
"Discover",,U,,10/23/2019,"Nytimes","Recreation : Entertainment","Recreation","Entertainment","",$4.00,$0.00,-$4181.05
"Discover",,U,,10/23/2019,"Amazon","Financial Help : Alyssa","Financial Help","Alyssa","",$7.26,$0.00,-$4188.31
"Discover",,U,,10/23/2019,"cvs","Personal : Prescriptions, Medicine","Personal","Prescriptions, Medicine","",$36.37,$0.00,-$4224.68
"Discover",,U,,10/23/2019,"stop & shop","Food : Groceries","Food","Groceries","",$103.42,$0.00,-$4328.10
"Discover",,U,,10/24/2019,"stonegate gardens","Personal : Gifts","Personal","Gifts","Kennedies",$15.93,$0.00,-$4344.03
"Discover",,U,,10/24/2019,"lincoln Gas","Transportation : Gas","Transportation","Gas","Lincoln",$23.61,$0.00,-$4367.64
"Discover",,U,,10/25/2019,"Normandy Farms","RV : Campgrounds","RV","Campgrounds","guests cliff luke",$20.00,$0.00,-$4387.64
"Discover",,U,,10/25/2019,"cvs","Personal : Prescriptions, Medicine","Personal","Prescriptions, Medicine","",$37.50,$0.00,-$4425.14
"Discover",,U,,10/25/2019,"stop & shop","Food : Groceries","Food","Groceries","",$49.80,$0.00,-$4474.94
"Discover",,U,,10/26/2019,"Primary Care Cape Cod","Personal : Doctor, Dentist","Personal","Doctor, Dentist","",$10.00,$0.00,-$4484.94
"Discover",,U,,10/28/2019,"AC MOORE","Recreation : Entertainment","Recreation","Entertainment",,$9.02,$0.00,-$4493.96
"Discover",,U,,10/28/2019,"AC MOORE","Financial Help : Alyssa","Financial Help","Alyssa","",$15.40,$0.00,-$4509.36
"Discover",,U,,10/28/2019,"yarmouth gas","Transportation : Gas","Transportation","Gas","",$25.01,$0.00,-$4534.37
"Discover",,U,,10/29/2019,"Bernies Dining Depot","Food : Restaurants","Food","Restaurants","Chicopee MA - with ANNA.  we didn't partake but PRIME RIBS were HUGE!!!",$52.71,$0.00,-$4587.08
"Discover",,U,,10/30/2019,"itunes","Recreation : Entertainment","Recreation","Entertainment","",$2.99,$0.00,-$4590.07
"Discover",,U,,10/30/2019,"Wegmans","Food : Groceries","Food","Groceries","Bought Alyssas too.",$248.98,$0.00,-$4839.05
"Discover",,U,,10/31/2019,"trader Joes","Food : Groceries","Food","Groceries","",$48.64,$0.00,-$4887.69
"Discover",,U,,11/01/2019,"Normandy Farms","RV : Equipment/Supplies","RV","Equipment/Supplies","",$3.59,$0.00,-$4891.28
"Discover",,U,,11/01/2019,"Normandy Farms","RV : Equipment/Supplies","RV","Equipment/Supplies","",$13.22,$0.00,-$4904.50
"Discover",,U,,11/01/2019,"ScotsRUn RV","RV : Campgrounds","RV","Campgrounds","",$90.20,$0.00,-$4994.70
"Discover",,U,,11/01/2019,"Exxon mobile","RV : gasoline","RV","gasoline","",$100.00,$0.00,-$5094.70
"Discover",,U,,11/01/2019,"Normandy Farms","RV : propane","RV","propane","Holly Shit they overcharge",$188.54,$0.00,-$5283.24
"Discover",,U,,11/01/2019,"Normandy Farms","RV : Campgrounds","RV","Campgrounds","",$258.50,$0.00,-$5541.74
"Discover",,U,,11/02/2019,"Douglas Tailwater Campground","RV : Campgrounds","RV","Campgrounds","",$34.00,$0.00,-$5575.74
"Discover",,U,,11/03/2019,"Pilot","RV : gasoline","RV","gasoline","Clear Brook VA",$75.00,$0.00,-$5650.74
"Discover",,U,,11/04/2019,"Glen Maury Park","RV : Campgrounds","RV","Campgrounds","Beuna Vista VA",$19.48,$0.00,-$5670.22
"Discover",,U,,11/04/2019,"Douglas Tailwater Campground","RV : Campgrounds","RV","Campgrounds","",$29.00,$0.00,-$5699.22
"Discover",,U,,11/04/2019,"Pilot","RV : gasoline","RV","gasoline","Greenevliie TN",$75.00,$0.00,-$5774.22
"Discover",,U,,11/04/2019,"Exxon mobile","RV : gasoline","RV","gasoline","Beana Vista VA",$100.00,$0.00,-$5874.22
"Discover",,U,,11/05/2019,"Exxon mobile","Transportation : Gas","Transportation","Gas","",$17.66,$0.00,-$5891.88
"Discover",,U,,11/05/2019,"Walmart","Food : Groceries","Food","Groceries","(Split 1/2) ",$75.00,$0.00,-$6018.20
"Discover",,U,,11/05/2019,"Walmart","RV : Equipment/Supplies","RV","Equipment/Supplies","(Split 2/2) ",$51.32,$0.00,-$6018.20
"Discover",,U,,11/06/2019,"circle k","Transportation : Gas","Transportation","Gas","Scottsboro AL",$24.26,$0.00,-$6042.46
"Discover",,U,,11/06/2019,"El Rancheroe Loco","Food : Restaurants","Food","Restaurants","Pigeon Fort TN Near Dollywood",$41.58,$0.00,-$6084.04
"Discover",,U,,11/07/2019,"Transfer : Dcu Checking",,,,"",$0.00,$3200.73,-$2883.31
"Discover",,U,,11/07/2019,"redbox","Recreation : Entertainment","Recreation","Entertainment","",$1.87,$0.00,-$2885.18
"Discover",,U,,11/07/2019,"Sp Soul Source","Financial Help : Mom And Dad","Financial Help","Mom And Dad","Don't ask",$23.98,$0.00,-$2909.16
"Discover",,U,,11/08/2019,"redbox","Recreation : Entertainment","Recreation","Entertainment","",$1.87,$0.00,-$2911.03
"Discover",,U,,11/09/2019,"redbox","Recreation : Entertainment","Recreation","Entertainment","",$1.87,$0.00,-$2912.90
"Discover",,U,,11/09/2019,"Family Dollar Hot springs","RV : Equipment/Supplies","RV","Equipment/Supplies","Belmont MS",$6.42,$0.00,-$2919.32
"Discover",,U,,11/09/2019,"piggly wiggley","RV : Equipment/Supplies","RV","Equipment/Supplies","Heat lamp for bays",$31.00,$0.00,-$2950.32
"Discover",,U,,11/10/2019,"piggly wiggley","Food : Groceries","Food","Groceries","",$29.89,$0.00,-$2980.21
"Discover",,U,,11/11/2019,"redbox","Recreation : Entertainment","Recreation","Entertainment","",$1.87,$0.00,-$2982.08
"Discover",,U,,11/11/2019,"Dollar general","RV : Equipment/Supplies","RV","Equipment/Supplies","Belmont MS",$16.64,$0.00,-$2998.72
"Discover",,U,,11/11/2019,"Belmont Pharmacy","Personal : Prescriptions, Medicine","Personal","Prescriptions, Medicine","",$29.30,$0.00,-$3028.02
"Discover",,U,,11/12/2019,"redbox","Recreation : Entertainment","Recreation","Entertainment","",$1.87,$0.00,-$3029.89
"Discover",,U,,11/12/2019,"USPS","RV : Equipment/Supplies","RV","Equipment/Supplies","Stamps",$14.12,$0.00,-$3044.01
"Discover",,U,,11/12/2019,"Sparks Drive in","Food : Restaurants","Food","Restaurants","Belmont MS",$14.23,$0.00,-$3058.24
"Discover",,U,,11/13/2019,"redbox","Recreation : Entertainment","Recreation","Entertainment","",$1.87,$0.00,-$3060.11
"Discover",,U,,11/14/2019,"Belmont Pharmacy","Personal : Prescriptions, Medicine","Personal","Prescriptions, Medicine","",$6.08,$0.00,-$3066.19
"Discover",,U,,11/14/2019,"Monroe Regional Hospital","Personal : Doctor, Dentist","Personal","Doctor, Dentist","Lisa",$10.00,$0.00,-$3076.19
"Discover",,U,,11/14/2019,"Piexons","Food : Restaurants","Food","Restaurants","Fulton Mississippi  MS- STAN THE MAN pizza dough champ",$39.00,$0.00,-$3115.19
"Discover",,U,,11/14/2019,"Walmart","RV : Equipment/Supplies","RV","Equipment/Supplies","",$44.39,$0.00,-$3159.58
"Discover",,U,,11/14/2019,"Cholangiocarcinoma","Charity : Other","Charity","Other","Kristan Cancer research",$50.00,$0.00,-$3209.58
"Discover",,U,,11/14/2019,"Normandy Farms","RV : Campgrounds","RV","Campgrounds","Deposit for next year",$200.00,$0.00,-$3409.58
"Discover",,U,,11/15/2019,"Belmont Pharmacy","Personal : Prescriptions, Medicine","Personal","Prescriptions, Medicine","",$25.00,$0.00,-$3434.58
"Discover",,U,,11/15/2019,"Fourth St Grill","Food : Restaurants","Food","Restaurants","Red Bay AL, Alabama",$36.84,$0.00,-$3471.42
"Discover",,U,,11/15/2019,"Thompson Gas","RV : propane","RV","propane","Red Bay",$45.95,$0.00,-$3517.37
"Discover",,U,,11/15/2019,"Dollar general","RV : gasoline","RV","gasoline","Cheap Gas - Waited for women with groceries",$100.00,$0.00,-$3617.37
"Discover",,U,,11/16/2019,"itunes","Recreation : Entertainment","Recreation","Entertainment","",$0.99,$0.00,-$3618.36
"Discover",,U,,11/16/2019,"redbox","Recreation : Entertainment","Recreation","Entertainment","",$3.75,$0.00,-$3622.11
"Discover",,U,,11/16/2019,"Dismal Canyons","Recreation : Entertainment","Recreation","Entertainment","Franklin County Al, Alabama",$23.00,$0.00,-$3645.11
"Discover",,U,,11/16/2019,"Bigstar","Food : Groceries","Food","Groceries","",$25.48,$0.00,-$3670.59
"Discover",,U,,11/17/2019,"Red Box","Recreation : Entertainment","Recreation","Entertainment","",$1.87,$0.00,-$3672.46
"Discover",,U,,11/17/2019,"family dollar","RV : Equipment/Supplies","RV","Equipment/Supplies","Belmont MS",$6.42,$0.00,-$3678.88
"Discover",,U,,11/17/2019,"piggly wiggley","Food : Groceries","Food","Groceries","",$20.58,$0.00,-$3699.46
"Discover",,U,,11/18/2019,"subway","Food : Restaurants","Food","Restaurants","",$14.93,$0.00,-$3714.39
"Discover",,U,,11/18/2019,"cchc Foundation","Charity : Other","Charity","Other","For Carol",$25.00,$0.00,-$3739.39
"Discover",,U,,11/18/2019,"cchc Foundation","Charity : Other","Charity","Other","For Carol",$25.00,$0.00,-$3764.39
"Discover",,U,,11/18/2019,"costa oaxaquena","Food : Restaurants","Food","Restaurants","Good Mexican in Belmont MS",$29.92,$0.00,-$3794.31
"Discover",,U,,11/18/2019,"TOm Sawyer West Memphis AR","RV : Campgrounds","RV","Campgrounds","West Memphis Arkansas AR",$38.00,$0.00,-$3832.31
"Discover",,U,,11/19/2019,"Memphis Parking","Lisa Business : Parking","Lisa Business","Parking","",$6.80,$0.00,-$3839.11
"Discover",,U,,11/19/2019,"Citgo","Transportation : Gas","Transportation","Gas","",$15.00,$0.00,-$3854.11
"Discover",,U,,11/19/2019,"TOm Sawyer West Memphis AR","RV : Campgrounds","RV","Campgrounds","",$38.00,$0.00,-$3892.11
"Discover",,U,,11/19/2019,"Escapees RV Club","RV : clubs","RV","clubs","",$39.95,$0.00,-$3932.06
"Discover",,U,,11/19/2019,"Blues Cafe","Food : Restaurants","Food","Restaurants","Memphis",$69.17,$0.00,-$4001.23
"Discover",,U,,11/20/2019,"Nytimes","Recreation : Entertainment","Recreation","Entertainment","",$4.00,$0.00,-$4005.23
"Discover",,U,,11/20/2019,"Pho Binh","Food : Restaurants","Food","Restaurants","Memphis",$30.46,$0.00,-$4035.69
"Discover",,U,,11/20/2019,"QUapaw Paths","Recreation : Entertainment","Recreation","Entertainment","Lisa salt bath",$38.33,$0.00,-$4074.02
"Discover",,U,,11/20/2019,"Loves  Fresh Pasta","RV : gasoline","RV","gasoline","",$103.45,$0.00,-$4177.47
"Discover",,U,,11/22/2019,"redbox","Recreation : Entertainment","Recreation","Entertainment","",$1.93,$0.00,-$4179.40
"Discover",,U,,11/22/2019,"Walmart","Food : Groceries","Food","Groceries","(Split 1/2) ",$100.00,$0.00,-$4360.11
"Discover",,U,,11/22/2019,"Walmart","RV : Equipment/Supplies","RV","Equipment/Supplies","(Split 2/2) ",$80.71,$0.00,-$4360.11
"Discover",,U,,11/24/2019,"buccees","Food : Restaurants","Food","Restaurants","",$11.02,$0.00,-$4371.13
"Discover",,U,,11/24/2019,"racetrack","Transportation : Gas","Transportation","Gas","Lewisville TX",$17.67,$0.00,-$4388.80
"Discover",,U,,11/24/2019,"Nick Piza","Food : Restaurants","Food","Restaurants","Lewisville Texas TX - Bad Sauce, Bad Bread - plastic in Strombolli - JUST BAD",$31.77,$0.00,-$4420.57
"Discover",,U,,11/24/2019,"bucees","RV : gasoline","RV","gasoline","",$128.09,$0.00,-$4548.66
"Discover",,U,,11/25/2019,"cvs","Personal : Prescriptions, Medicine","Personal","Prescriptions, Medicine","",$8.68,$0.00,-$4557.34
"Discover",,U,,11/25/2019,"Primacare","Personal : Doctor, Dentist","Personal","Doctor, Dentist","Walkin Clinic",$22.00,$0.00,-$4579.34
"Discover",,U,,11/26/2019,"Nashar Scuplture","Recreation : Entertainment","Recreation","Entertainment","Museum Dallas",$20.00,$0.00,-$4599.34
"Discover",,U,,11/26/2019,"SP Spirit Pieces","Personal : Gifts","Personal","Gifts","aunty Carol Ashes",$119.00,$0.00,-$4718.34
"Discover",,U,,11/27/2019,"redbox","Recreation : Entertainment","Recreation","Entertainment","",$3.79,$0.00,-$4722.13
"Discover",,U,,11/27/2019,"H-E-B","Food : Groceries","Food","Groceries","",$51.93,$0.00,-$4774.06
"Discover",,U,,11/27/2019,"austin east Koa","RV : Campgrounds","RV","Campgrounds","",$420.00,$0.00,-$5194.06
"Discover",,U,,11/29/2019,"Coinmachine","RV : Laundry","RV","Laundry",,$2.00,$0.00,-$5196.06
"Discover",,U,,11/29/2019,"Coinmachine","RV : Laundry","RV","Laundry","",$2.00,$0.00,-$5198.06
"Discover",,U,,11/29/2019,"Coinmachine","RV : Laundry","RV","Laundry","",$2.00,$0.00,-$5200.06
"Discover",,U,,11/29/2019,"Coinmachine","RV : Laundry","RV","Laundry","",$2.25,$0.00,-$5202.31
"Discover",,U,,11/29/2019,"Coinmachine","RV : Laundry","RV","Laundry","",$2.25,$0.00,-$5204.56
"Discover",,U,,11/29/2019,"conmachine","RV : Laundry","RV","Laundry","",$2.25,$0.00,-$5206.81
"Discover",,U,,11/29/2019,"itunes","Recreation : Entertainment","Recreation","Entertainment","",$2.99,$0.00,-$5209.80
"Discover",,U,,11/29/2019,"Sparetime","Recreation : Entertainment","Recreation","Entertainment","Bowling",$21.07,$0.00,-$5230.87
"Discover",,U,,11/30/2019,"Dragonfly sage","Personal : Gifts","Personal","Gifts","alyssa postcards, Georgetown Texas",$5.69,$0.00,-$5236.56
"Discover",,U,,11/30/2019,"Greehhouse craft","Food : Restaurants","Food","Restaurants","Round Rock Texas With Alyssa Marta Isabelle",$45.30,$0.00,-$5281.86
"Discover",,U,,12/01/2019,"Chex zee","Food : Restaurants","Food","Restaurants","Austin",$55.33,$0.00,-$5337.19
"Discover",,U,,12/01/2019,"Austin craft","Recreation : Entertainment","Recreation","Entertainment","Crafts  in Austin for alyssa BDAY",$96.12,$0.00,-$5433.31
"Discover",,U,,12/01/2019,"Eldorado Cafe","Food : Restaurants","Food","Restaurants","Alyssa Birthday dinner - Great queso",$149.00,$0.00,-$5582.31
"Discover",,U,,12/02/2019,"umlauf","Recreation : Entertainment","Recreation","Entertainment","TIckets for night visit - it was GREAT",$15.45,$0.00,-$5597.76
"Discover",,U,,12/02/2019,"USPS","RV : Equipment/Supplies","RV","Equipment/Supplies","",$26.20,$0.00,-$5623.96
"Discover",,U,,12/02/2019,"jinya ramen","Food : Restaurants","Food","Restaurants","Austen Texas, With Isabelle Alyssa",$55.49,$0.00,-$5679.45
"Discover",,U,,12/03/2019,"Coa Parking","Transportation : Parking","Transportation","Parking","austin",$2.50,$0.00,-$5681.95
"Discover",,U,,12/03/2019,"White horse","Food : Restaurants","Food","Restaurants","Blues plays austin beer",$9.00,$0.00,-$5690.95
"Discover",,U,,12/03/2019,"San Jac Saloon","Recreation : Entertainment","Recreation","Entertainment","Cool place good band nice bartenders (irish accent)",$15.00,$0.00,-$5705.95
"Discover",,U,,12/03/2019,"Texas state parks","Recreation : Entertainment","Recreation","Entertainment","Mckinnely lake state park",$18.00,$0.00,-$5723.95
"Discover",,U,,12/03/2019,"Book people austion","Recreation : Entertainment","Recreation","Entertainment","Van Gogh and Badlnd book",$25.91,$0.00,-$5749.86
"Discover",,U,,12/03/2019,"Prohibitions","Food : Restaurants","Food","Restaurants","Alcoholic Iecream",$27.23,$0.00,-$5777.09
"Discover",,U,,12/04/2019,"Coa Parking","Transportation : Parking","Transportation","Parking","",$3.00,$0.00,-$5780.09
"Discover",,U,,12/04/2019,"lucy in disguise","Personal : Gifts","Personal","Gifts","",$6.48,$0.00,-$5786.57
"Discover",,U,,12/04/2019,"trader Joes","Food : Groceries","Food","Groceries","",$7.36,$0.00,-$5793.93
"Discover",,U,,12/04/2019,"limbo jewlery","Personal : Gifts","Personal","Gifts","",$10.83,$0.00,-$5804.76
"Discover",,U,,12/04/2019,"Javi's best","Food : Restaurants","Food","Restaurants","Breakfast with alyssa in way airport",$23.43,$0.00,-$5828.19
"Discover",,U,,12/04/2019,"trader Joes","Food : Groceries","Food","Groceries","",$49.19,$0.00,-$5877.38
"Discover",,U,,12/04/2019,"Parts and labor","Personal : Gifts","Personal","Gifts","?",$53.04,$0.00,-$5930.42
"Discover",,U,,12/04/2019,"True food kitchen","Food : Restaurants","Food","Restaurants","Plano TX ?",$100.78,$0.00,-$6031.20
"Discover",,U,,12/05/2019,"marriot sn antonio","Food : Restaurants","Food","Restaurants","coffee San Antonio TX Texas",$7.22,$0.00,-$6038.42
"Discover",,U,,12/05/2019,"marble slam creamery","Food : Restaurants","Food","Restaurants","Night of the Mariache ICE CREAM",$8.42,$0.00,-$6046.84
"Discover",,U,,12/05/2019,"wordpress","Recreation : Entertainment","Recreation","Entertainment","",$18.00,$0.00,-$6064.84
"Discover",,U,,12/05/2019,"buccees","Food : Restaurants","Food","Restaurants","(Split 1/2) ",$22.00,$0.00,-$6112.20
"Discover",,U,,12/05/2019,"buccees","Personal : Gifts","Personal","Gifts","(Split 2/2) ",$25.36,$0.00,-$6112.20
"Discover",,U,,12/05/2019,"wordpress","Recreation : Entertainment","Recreation","Entertainment","",$51.00,$0.00,-$6163.20
"Discover",,U,,12/05/2019,"buccees","RV : gasoline","RV","gasoline","Cheap gas",$91.79,$0.00,-$6254.99
"Discover",,U,,12/05/2019,"FP Braaunig Lake","RV : Campgrounds","RV","Campgrounds","5 nights discount passport america",$135.00,$0.00,-$6389.99
"Discover",,U,,12/06/2019,"Transfer : Dcu Checking",,,,"",$0.00,$3028.02,-$3361.97
"Discover",,U,,12/06/2019,"corner bakery","Food : Restaurants","Food","Restaurants","",$7.99,$0.00,-$3369.96
"Discover",,U,,12/06/2019,"Corner Store","Transportation : Gas","Transportation","Gas","",$16.51,$0.00,-$3386.47
"Discover",,U,,12/06/2019,"Comedy Sportz","Recreation : Entertainment","Recreation","Entertainment","TERRIBLE COMEDY",$24.00,$0.00,-$3410.47
"Discover",,U,,12/06/2019,"Pesto Restaurante","Food : Restaurants","Food","Restaurants","GOOD RESTAURANT NEAR SAN ANTONIO< TExas - expensive neighborhood",$78.00,$0.00,-$3488.47
"Discover",,U,,12/07/2019,"Meter San antonio","Transportation : Parking","Transportation","Parking","",$3.75,$0.00,-$3492.22
"Discover",,U,,12/07/2019,"cvs","Personal : Prescriptions, Medicine","Personal","Prescriptions, Medicine","",$20.53,$0.00,-$3512.75
"Discover",,U,,12/07/2019,"Tenko Ramen","Food : Restaurants","Food","Restaurants","AT FARMER MARKET IN SAN ANTIONIO",$28.01,$0.00,-$3540.76
"Discover",,U,,12/09/2019,"SA Botanical Garden","Recreation : Entertainment","Recreation","Entertainment","",$5.40,$0.00,-$3546.16
"Discover",,U,,12/09/2019,"Scargo cafe","Personal : Gifts","Personal","Gifts","",$25.00,$0.00,-$3571.16
"Discover",,U,,12/09/2019,"Ring Bors","Personal : Gifts","Personal","Gifts","",$26.00,$0.00,-$3597.16
"Discover",,U,,12/09/2019,"etsy","Personal : Gifts","Personal","Gifts","",$29.26,$0.00,-$3626.42
"Discover",,U,,12/09/2019,"trader Joes","Food : Groceries","Food","Groceries","",$240.14,$0.00,-$3866.56
"Discover",,U,,12/09/2019,"Jetblue","Transportation : Air/train/bus/etc","Transportation","Air/train/bus/etc","",$301.61,$0.00,-$4168.17
"Discover",,U,,12/10/2019,"Braunig Lake RV","RV : Campgrounds","RV","Campgrounds","",$27.00,$0.00,-$4195.17
"Discover",,U,,12/10/2019,"SA Museum of ART","Personal : Gifts","Personal","Gifts","",$31.00,$0.00,-$4226.17
"Discover",,U,,12/11/2019,"peggy's Cakes","Food : Groceries","Food","Groceries","farmers Market",$13.00,$0.00,-$4239.17
"Discover",,U,,12/11/2019,"Amazon","Personal : Gifts","Personal","Gifts","",$58.42,$0.00,-$4297.59
"Discover",,U,,12/12/2019,"Aloe Ranch","Personal : nom-prescription medication","Personal","nom-prescription medication","ALoe cream",$22.00,$0.00,-$4319.59
"Discover",,U,,12/13/2019,"Hilltop gardens","Personal : Gifts","Personal","Gifts","",$12.00,$0.00,-$4331.59
"Discover",,U,,12/13/2019,"UPS","Personal : Gifts","Personal","Gifts","mailing cost",$27.17,$0.00,-$4358.76
"Discover",,U,,12/13/2019,"Texas Gift Fruit","Personal : Gifts","Personal","Gifts","",$46.90,$0.00,-$4405.66
"Discover",,U,,12/14/2019,"Dollar general","RV : gasoline","RV","gasoline","",$4.13,$0.00,-$4409.79
"Discover",,U,,12/14/2019,"O'Reilly Auto","Transportation : Repairs & Maintenance","Transportation","Repairs & Maintenance","headlights",$29.75,$0.00,-$4439.54
"Discover",,U,,12/15/2019,"West Marine","Personal : Gifts","Personal","Gifts","ask Lisa",$16.88,$0.00,-$4456.42
"Discover",,U,,12/15/2019,"cvs","Personal : Prescriptions, Medicine","Personal","Prescriptions, Medicine","",$21.37,$0.00,-$4477.79
"Discover",,U,,12/15/2019,"Passport America","RV : clubs","RV","clubs","",$44.00,$0.00,-$4521.79
"Discover",,U,,12/15/2019,"West Marine","Personal : Gifts","Personal","Gifts","ask Lisa",$50.00,$0.00,-$4571.79
"Discover",,U,,12/16/2019,"HEB GAS","Transportation : Gas","Transportation","Gas","",$18.58,$0.00,-$4590.37
"Discover",,U,,12/17/2019,"itunes","Recreation : Entertainment","Recreation","Entertainment","",$0.99,$0.00,-$4591.36
"Discover",,U,,12/17/2019,"SP Park Trotters","Personal : Gifts","Personal","Gifts","",$13.99,$0.00,-$4605.35
"Discover",,U,,12/17/2019,"Marshall's","Personal : cloths","Personal","cloths","",$27.05,$0.00,-$4632.40
"Discover",,U,,12/17/2019,"Breaktime Harlingen","Transportation : Gas","Transportation","Gas","Eileens car",$27.91,$0.00,-$4660.31
"Discover",,U,,12/17/2019,"SP Park Trotters","Personal : Gifts","Personal","Gifts","ask lisa",$33.92,$0.00,-$4694.23
"Discover",,U,,12/17/2019,"Ross Store","Personal : cloths","Personal","cloths","",$58.39,$0.00,-$4752.62
"Discover",,U,,12/17/2019,"Marshall's","Personal : cloths","Personal","cloths","",$58.46,$0.00,-$4811.08
"Discover",,U,,12/17/2019,"Amazon","Personal : Gifts","Personal","Gifts","",$121.35,$0.00,-$4932.43
"Discover",,U,,12/18/2019,"Nytimes","Recreation : Entertainment","Recreation","Entertainment","",$4.00,$0.00,-$4936.43
"Discover",,U,,12/19/2019,"redbox","Recreation : Entertainment","Recreation","Entertainment","",$1.89,$0.00,-$4938.32
"Discover",,U,,12/19/2019,"Show Carnival","Personal : cloths","Personal","cloths","harlingen",$32.45,$0.00,-$4970.77
"Discover",,U,,12/19/2019,"Walmart","RV : Equipment/Supplies","RV","Equipment/Supplies","",$65.05,$0.00,-$5035.82
"Discover",,U,,12/19/2019,"longhorn Steak","Food : Restaurants","Food","Restaurants","with Guy and Eileen",$103.00,$0.00,-$5138.82
"Discover",,U,,12/20/2019,"HEB","Food : Groceries","Food","Groceries","",$12.90,$0.00,-$5151.72
"Discover",,U,,12/20/2019,"Amazon","Personal : Gifts","Personal","Gifts","",$35.39,$0.00,-$5187.11
"Discover",,U,,12/21/2019,"Amazon","Personal : Gifts","Personal","Gifts","",$48.66,$0.00,-$5235.77
"Discover",,U,,12/22/2019,"Cafe on beach","Food : Restaurants","Food","Restaurants","South Padre",$75.37,$0.00,-$5311.14
"Discover",,U,,12/23/2019,"USPS","Personal : Gifts","Personal","Gifts","postage",$14.35,$0.00,-$5325.49
"Discover",,U,,12/23/2019,"Stuart Place Nursury","Personal : Gifts","Personal","Gifts","",$27.05,$0.00,-$5352.54
"Discover",,U,,12/24/2019,"Walmart","RV : Equipment/Supplies","RV","Equipment/Supplies","",$29.51,$0.00,-$5382.05
"Discover",,U,,12/24/2019,"Harry and david","Personal : Gifts","Personal","Gifts","Charlotte",$64.27,$0.00,-$5446.32
"Discover",,U,,12/26/2019,"Shell Portland TX","RV : gasoline","RV","gasoline","",$95.00,$0.00,-$5541.32
"Discover",,U,,12/27/2019,"Ancient Oaks Rv park","RV : Campgrounds","RV","Campgrounds","",$26.00,$0.00,-$5567.32
"Discover",,U,,12/27/2019,"Floers Shrimp Market","Food : Groceries","Food","Groceries","Rockport TX",$36.00,$0.00,-$5603.32
"Discover",,U,,12/28/2019,"Ross Store","Personal : cloths","Personal","cloths","",$0.00,$7.78,-$5595.54
"Discover",,U,,12/28/2019,"Amazon","Personal : Gifts","Personal","Gifts","Discs for guy",$33.70,$0.00,-$5629.24
"Discover",,U,,12/28/2019,"sprouts","Food : Groceries","Food","Groceries","",$176.54,$0.00,-$5805.78
"Discover",,U,,12/29/2019,"itunes","Recreation : Entertainment","Recreation","Entertainment","",$2.99,$0.00,-$5808.77
"Discover",,U,,12/30/2019,"redbox","Recreation : Entertainment","Recreation","Entertainment","",$1.95,$0.00,-$5810.72
"Discover",,U,,12/30/2019,"WNPA Padre Island","Personal : Gifts","Personal","Gifts","",$3.20,$0.00,-$5813.92
"Discover",,U,,12/30/2019,"Walmart","RV : Equipment/Supplies","RV","Equipment/Supplies","",$23.98,$0.00,-$5837.90
"Discover",,U,,12/30/2019,"USS Lexington","Recreation : Entertainment","Recreation","Entertainment","BIg Ship Corpus Cristi",$45.85,$0.00,-$5883.75
"Discover",,U,,01/01/2020,"Flowers Shrimp","Food : Groceries","Food","Groceries","",$30.00,$0.00,-$5913.75
"Discover",,U,,01/01/2020,"H-E-B","Food : Groceries","Food","Groceries","",$40.65,$0.00,-$5954.40
"Discover",,U,,01/02/2020,"Pilot San antomion","RV : gasoline","RV","gasoline","",$75.00,$0.00,-$6029.40
"Discover",,U,,01/03/2020,"cvs","Personal : Prescriptions, Medicine","Personal","Prescriptions, Medicine","",$1.50,$0.00,-$6030.90
"Discover",,U,,01/03/2020,"Broke Mill RV Park","RV : Campgrounds","RV","Campgrounds","Del Rio TX",$33.30,$0.00,-$6064.20
"Discover",,U,,01/03/2020,"H-E-B","Food : Groceries","Food","Groceries","Del Rio",$60.80,$0.00,-$6125.00
"Discover",,U,,01/04/2020,"Tx State Parks","RV : Campgrounds","RV","Campgrounds","Tx state park pass",$75.95,$0.00,-$6200.95
"Discover",,U,,01/04/2020,"Exxon mobile","RV : gasoline","RV","gasoline","Del Rio TX",$83.91,$0.00,-$6284.86
"Discover",,U,,01/07/2020,"Transfer : Dcu Checking",,,,"",$0.00,$4319.59,-$1965.27
"Discover",,U,,01/08/2020,"Cotton Wood General store","Personal : Gifts","Personal","Gifts","Terlingua TX",$29.04,$0.00,-$1994.31
"Discover",,U,,01/10/2020,"Christinas World","Personal : Gifts","Personal","Gifts","lajitas tx",$9.74,$0.00,-$2004.05
"Discover",,U,,01/11/2020,"terlingua Trading Company","Personal : Gifts","Personal","Gifts","",$64.79,$0.00,-$2068.84
"Discover",,U,,01/11/2020,"Starlight Thearter","Food : Restaurants","Food","Restaurants","Terlingua Neals Birthday",$118.25,$0.00,-$2187.09
"Discover",,U,,01/12/2020,"Sunoco","RV : gasoline","RV","gasoline","Alpine Tx",$100.00,$0.00,-$2287.09
"Discover",,U,,01/12/2020,"lajitas golf resort a","RV : Campgrounds","RV","Campgrounds","Maverich RV Park",$329.00,$0.00,-$2616.09
"Discover",,U,,01/14/2020,"SqCedar Coffee","Food : Restaurants","Food","Restaurants","",$4.75,$0.00,-$2620.84
"Discover",,U,,01/14/2020,"Unclies","Transportation : Gas","Transportation","Gas","Alpine",$22.60,$0.00,-$2643.44
"Discover",,U,,01/14/2020,"porters thriftway","Food : Groceries","Food","Groceries","",$36.00,$0.00,-$2679.44
"Discover",,U,,01/15/2020,"Nytimes","Recreation : Entertainment","Recreation","Entertainment","",$4.00,$0.00,-$2683.44
"Discover",,U,,01/16/2020,"Davist Mountina","Personal : Gifts","Personal","Gifts","NUts",$20.45,$0.00,-$2703.89
"Discover",,U,,01/16/2020,"Javelina's and Hollyhocks","Personal : Gifts","Personal","Gifts","Fort Davis",$23.71,$0.00,-$2727.60
"Discover",,U,,01/16/2020,"Chihuahuan Desert","Personal : Gifts","Personal","Gifts","Botanical Garden gift shop fort davis",$32.48,$0.00,-$2760.08
"Discover",,U,,01/17/2020,"itunes","Recreation : Entertainment","Recreation","Entertainment","",$0.99,$0.00,-$2761.07
"Discover",,U,,01/17/2020,"GAS Midland Tx","RV : gasoline","RV","gasoline","",$100.00,$0.00,-$2861.07
"Discover",,U,,01/18/2020,"carlsbad caverns","Personal : Gifts","Personal","Gifts","",$3.99,$0.00,-$2865.06
"Discover",,U,,01/19/2020,"Luna Rosa","Food : Restaurants","Food","Restaurants","In Deming (new las Cruces) - nice italian restaurant and winery date night",$45.00,$0.00,-$2910.06
"Discover",,U,,01/19/2020,"Hacienda RV resort","RV : Campgrounds","RV","Campgrounds","",$48.90,$0.00,-$2958.96
"Discover",,U,,01/19/2020,"Hacienda RV resort","RV : Campgrounds","RV","Campgrounds","Near Las Cruces",$48.91,$0.00,-$3007.87
"Discover",,U,,01/20/2020,"Chalass wood Fired Grills","Food : Restaurants","Food","Restaurants","Mexican with Neil and Ann  near las cruces",$41.62,$0.00,-$3049.49
"Discover",,U,,01/20/2020,"Hacienda RV resort","RV : Campgrounds","RV","Campgrounds","",$97.81,$0.00,-$3147.30
"Discover",,U,,01/21/2020,"Fallas 500","Personal : cloths","Personal","cloths","",$7.57,$0.00,-$3154.87
"Discover",,U,,01/21/2020,"Fallas 500","Personal : cloths","Personal","cloths","Cheap CLoths",$18.38,$0.00,-$3173.25
"Discover",,U,,01/21/2020,"big lots","RV : Equipment/Supplies","RV","Equipment/Supplies","",$28.78,$0.00,-$3202.03
"Discover",,U,,01/21/2020,"sprouts","Food : Groceries","Food","Groceries","Las Cruces",$214.61,$0.00,-$3416.64
"Discover",,U,,01/22/2020,"Adobe Modern","Personal : Gifts","Personal","Gifts","",$20.56,$0.00,-$3437.20
"Discover",,U,,01/22/2020,"Heart of the Desert","Personal : Gifts","Personal","Gifts","Mesilla NM",$24.85,$0.00,-$3462.05
"Discover",,U,,01/22/2020,"Bowlinss Mesilla Book","Recreation : Entertainment","Recreation","Entertainment","",$32.87,$0.00,-$3494.92
"Discover",,U,,01/23/2020,"redbox","Recreation : Entertainment","Recreation","Entertainment","",$1.90,$0.00,-$3496.82
"Discover",,U,,01/23/2020,"FROST GELETO","Food : Restaurants","Food","Restaurants","ALBURQUEQUE",$6.70,$0.00,-$3503.52
"Discover",,U,,01/23/2020,"Union 76","RV : gasoline","RV","gasoline","",$50.04,$0.00,-$3553.56
"Discover",,U,,01/23/2020,"Walmart","RV : Equipment/Supplies","RV","Equipment/Supplies","(Split 1/2) ",$40.00,$0.00,-$3766.68
"Discover",,U,,01/23/2020,"Walmart","Food : Groceries","Food","Groceries","(Split 2/2) ",$173.12,$0.00,-$3766.68
"Discover",,U,,01/24/2020,"Barnes and Noble","Food : Restaurants","Food","Restaurants","",$2.43,$0.00,-$3769.11
"Discover",,U,,01/24/2020,"Barnes and Noble","Food : Restaurants","Food","Restaurants","",$7.53,$0.00,-$3776.64
"Discover",,U,,01/24/2020,"ALLSUPS","Transportation : Gas","Transportation","Gas","",$10.73,$0.00,-$3787.37
"Discover",,U,,01/24/2020,"Chevron","Transportation : Gas","Transportation","Gas","",$20.63,$0.00,-$3808.00
"Discover",,U,,01/24/2020,"Thai Vegan","Food : Restaurants","Food","Restaurants","albuquerque NM",$40.11,$0.00,-$3848.11
"Discover",,U,,01/25/2020,"POINT BLANC WINARY","Food : Restaurants","Food","Restaurants","",$7.49,$0.00,-$3855.60
"Discover",,U,,01/25/2020,"POINT BLANC WINARY","Food : Restaurants","Food","Restaurants","",$50.00,$0.00,-$3905.60
"Discover",,U,,01/26/2020,"SAN ANTONIO GENERAL STOR","Personal : Gifts","Personal","Gifts","",$21.99,$0.00,-$3927.59
"Discover",,U,,01/26/2020,"San antonio Crane","Food : Restaurants","Food","Restaurants","",$45.00,$0.00,-$3972.59
"Discover",,U,,01/26/2020,"GEOLOGY","Recreation : Entertainment","Recreation","Entertainment","SOCORRO",$46.42,$0.00,-$4019.01
"Discover",,U,,01/27/2020,"THREE BROTHERS","Food : Groceries","Food","Groceries","CHILIS IN HATCH",$17.00,$0.00,-$4036.01
"Discover",,U,,01/27/2020,"subway","Food : Restaurants","Food","Restaurants","",$18.84,$0.00,-$4054.85
"Discover",,U,,01/27/2020,"5r Travel Center","RV : gasoline","RV","gasoline","",$100.00,$0.00,-$4154.85
"Discover",,U,,01/28/2020,"SKP SAGUARO","RV : Campgrounds","RV","Campgrounds","",$11.16,$0.00,-$4166.01
"Discover",,U,,01/28/2020,"circle k","Transportation : Gas","Transportation","Gas","",$21.11,$0.00,-$4187.12
"Discover",,U,,01/28/2020,"Mi Casa","Food : Restaurants","Food","Restaurants","Benson AZ",$59.09,$0.00,-$4246.21
"Discover",,U,,01/29/2020,"SKP SAGUARO","RV : Campgrounds","RV","Campgrounds","",$372.60,$0.00,-$4618.81
"Discover",,U,,01/30/2020,"itunes","Recreation : Entertainment","Recreation","Entertainment","",$2.99,$0.00,-$4621.80
"Discover",,U,,01/30/2020,"adalphos Taco","Food : Restaurants","Food","Restaurants","Benzon AZ",$46.56,$0.00,-$4668.36
"Discover",,U,,01/30/2020,"Thre Bread and Honey","Food : Restaurants","Food","Restaurants","Phonix with Karina and Linda",$58.87,$0.00,-$4727.23
"Discover",,U,,01/31/2020,"Benson Fuel","Transportation : Gas","Transportation","Gas","",$20.92,$0.00,-$4748.15
"Discover",,U,,01/31/2020,"Safeway Benson","Food : Groceries","Food","Groceries","",$55.06,$0.00,-$4803.21
"Discover",,U,,02/01/2020,"Plymouth and Brock","Transportation : Air/train/bus/etc","Transportation","Air/train/bus/etc","",$56.50,$0.00,-$4859.71
"Discover",,U,,02/01/2020,"stop & shop","Food : Groceries","Food","Groceries","(Split 1/2) ",$50.00,$0.00,-$4989.48
"Discover",,U,,02/01/2020,"stop & shop","Financial Help : Mom And Dad","Financial Help","Mom And Dad","(Split 2/2) ",$79.77,$0.00,-$4989.48
"Discover",,U,,02/02/2020,"Safeway Benson","Food : Groceries","Food","Groceries",,$2.47,$0.00,-$4991.95
"Discover",,U,,02/02/2020,"High Desert Cafe","Food : Restaurants","Food","Restaurants","Bisbee",$9.81,$0.00,-$5001.76
"Discover",,U,,02/02/2020,"circle k","Transportation : Gas","Transportation","Gas","Tombstone",$23.22,$0.00,-$5024.98
"Discover",,U,,02/02/2020,"anazon","Personal : Gifts","Personal","Gifts","(Split 1/2) ",$16.00,$0.00,-$5075.86
"Discover",,U,,02/02/2020,"anazon","Recreation : Entertainment","Recreation","Entertainment","(Split 2/2) ",$34.88,$0.00,-$5075.86
"Discover",,U,,02/02/2020,"Safeway Benson","Food : Groceries","Food","Groceries","",$78.92,$0.00,-$5154.78
"Discover",,U,,02/03/2020,"Los Olivos Pizza","Food : Restaurants","Food","Restaurants","Karina Favorite in Tuscon",$14.92,$0.00,-$5169.70
"Discover",,U,,02/04/2020,"Primary Care Cape Cod","Personal : Doctor, Dentist","Personal","Doctor, Dentist","",$10.00,$0.00,-$5179.70
"Discover",,U,,02/04/2020,"speedway","Transportation : Gas","Transportation","Gas","Hyannis",$24.14,$0.00,-$5203.84
"Discover",,U,,02/05/2020,"cvs","Personal : Prescriptions, Medicine","Personal","Prescriptions, Medicine","",$10.00,$0.00,-$5213.84
"Discover",,U,,02/05/2020,"RIng Brothers Market place","Food : Restaurants","Food","Restaurants","",$10.48,$0.00,-$5224.32
"Discover",,U,,02/05/2020,"whole foods","Food : Groceries","Food","Groceries","",$16.20,$0.00,-$5240.52
"Discover",,U,,02/05/2020,"Solstice Day Spa","Personal : Gifts","Personal","Gifts","",$25.50,$0.00,-$5266.02
"Discover",,U,,02/05/2020,"Mi Casa","Food : Restaurants","Food","Restaurants","",$42.00,$0.00,-$5308.02
"Discover",,U,,02/05/2020,"Solstice Day Spa","Personal : Gifts","Personal","Gifts","for Kin",$86.00,$0.00,-$5394.02
"Discover",,U,,02/05/2020,"Solstice Day Spa","Recreation : Entertainment","Recreation","Entertainment","Hyannis Kim and Lisa",$86.00,$0.00,-$5480.02
"Discover",,U,,02/06/2020,"Transfer : Dcu Checking",,,,"",$0.00,$2187.09,-$3292.93
"Discover",,U,,02/06/2020,"Tubac Deli","Food : Restaurants","Food","Restaurants","",$8.66,$0.00,-$3301.59
"Discover",,U,,02/06/2020,"cvs","RV : Equipment/Supplies","RV","Equipment/Supplies","",$17.11,$0.00,-$3318.70
"Discover",,U,,02/06/2020,"Fry's Fuel","Transportation : Gas","Transportation","Gas","Sahuarita az",$17.55,$0.00,-$3336.25
"Discover",,U,,02/06/2020,"Tubac Art and Gifts","Recreation : Entertainment","Recreation","Entertainment","Gift for Lisa",$21.30,$0.00,-$3357.55
"Discover",,U,,02/06/2020,"The sleek Greek","Food : Restaurants","Food","Restaurants","Gyros at art fair",$27.02,$0.00,-$3384.57
"Discover",,U,,02/07/2020,"cvs","RV : Equipment/Supplies","RV","Equipment/Supplies","Cooler for meds",$20.44,$0.00,-$3405.01
"Discover",,U,,02/08/2020,"Nancy;s Candy","Personal : Gifts","Personal","Gifts","",$11.97,$0.00,-$3416.98
"Discover",,U,,02/09/2020,"Circl K","Transportation : Gas","Transportation","Gas","Benson",$16.13,$0.00,-$3433.11
"Discover",,U,,02/09/2020,"Plymouth and Brock","Transportation : Air/train/bus/etc","Transportation","Air/train/bus/etc","",$23.50,$0.00,-$3456.61
"Discover",,U,,02/10/2020,"Rons Ice Cream","Food : Restaurants","Food","Restaurants","",$9.00,$0.00,-$3465.61
"Discover",,U,,02/10/2020,"Old navy","Financial Help : Alyssa","Financial Help","Alyssa","",$13.53,$0.00,-$3479.14
"Discover",,U,,02/10/2020,"Cinema","Recreation : Entertainment","Recreation","Entertainment","Movie Dedham",$29.00,$0.00,-$3508.14
"Discover",,U,,02/10/2020,"Supercuts","Financial Help : Alyssa","Financial Help","Alyssa","",$29.95,$0.00,-$3538.09
"Discover",,U,,02/10/2020,"Shell","Transportation : Gas","Transportation","Gas","westwood ma",$30.13,$0.00,-$3568.22
"Discover",,U,,02/10/2020,"Mai Place Canton ma","Food : Restaurants","Food","Restaurants","",$46.03,$0.00,-$3614.25
"Discover",,U,,02/10/2020,"cheesecake Factory","Food : Restaurants","Food","Restaurants","",$50.64,$0.00,-$3664.89
"Discover",,U,,02/10/2020,"AC MOORE","Recreation : Entertainment","Recreation","Entertainment","",$59.22,$0.00,-$3724.11
"Discover",,U,,02/10/2020,"Wegmans","Financial Help : Alyssa","Financial Help","Alyssa","",$149.72,$0.00,-$3873.83
"Discover",,U,,02/11/2020,"starbucks","Food : Restaurants","Food","Restaurants","",$2.88,$0.00,-$3876.71
"Discover",,U,,02/11/2020,"starbucks","Food : Restaurants","Food","Restaurants","",$2.99,$0.00,-$3879.70
"Discover",,U,,02/11/2020,"Tacos Chiwas","Food : Restaurants","Food","Restaurants","Phx",$8.74,$0.00,-$3888.44
"Discover",,U,,02/11/2020,"Big 5 Sporting","Recreation : Entertainment","Recreation","Entertainment","New DISC",$10.85,$0.00,-$3899.29
"Discover",,U,,02/11/2020,"Shell","Transportation : Gas","Transportation","Gas","",$18.95,$0.00,-$3918.24
"Discover",,U,,02/11/2020,"Horse shoe cafe Benson","Food : Restaurants","Food","Restaurants","",$28.75,$0.00,-$3946.99
"Discover",,U,,02/12/2020,"Nytimes","Recreation : Entertainment","Recreation","Entertainment","",$4.00,$0.00,-$3950.99
"Discover",,U,,02/13/2020,"Barnetts Propane","RV : propane","RV","propane","Benson",$51.15,$0.00,-$4002.14
"Discover",,U,,02/13/2020,"safeway","Food : Groceries","Food","Groceries","",$185.53,$0.00,-$4187.67
"Discover",,U,,02/14/2020,"circle k","Transportation : Gas","Transportation","Gas","",$22.25,$0.00,-$4209.92
"Discover",,U,,02/14/2020,"Indochine","Food : Restaurants","Food","Restaurants","Sierra Vista Valentines with LIsa",$41.70,$0.00,-$4251.62
"Discover",,U,,02/14/2020,"Amazon","Personal : Miscellaneous","Personal","Miscellaneous","Turbotax",$42.49,$0.00,-$4294.11
"Discover",,U,,02/16/2020,"Marios Bakery","Food : Restaurants","Food","Restaurants","cookies",$6.00,$0.00,-$4300.11
"Discover",,U,,02/16/2020,"Marios Bakery","Food : Restaurants","Food","Restaurants","Worlds Slowest Pizza",$25.30,$0.00,-$4325.41
"Discover",,U,,02/17/2020,"itunes","Recreation : Entertainment","Recreation","Entertainment","",$0.99,$0.00,-$4326.40
"Discover",,U,,02/17/2020,"Labcorp","Personal : Doctor, Dentist","Personal","Doctor, Dentist","Blood test for guy",$30.00,$0.00,-$4356.40
"Discover",,U,,02/18/2020,"Jetblue","Financial Help : Alyssa","Financial Help","Alyssa","Flight to Neveda",$321.80,$0.00,-$4678.20
"Discover",,U,,02/19/2020,"Amazon","Personal : Gifts","Personal","Gifts","Gi GONG for Karina",$17.90,$0.00,-$4696.10
"Discover",,U,,02/20/2020,"Normandy Farms","RV : Campgrounds","RV","Campgrounds","Refund",$0.00,$200.00,-$4496.10
"Discover",,U,,02/20/2020,"Bisbee coffee","Food : Restaurants","Food","Restaurants","",$3.34,$0.00,-$4499.44
"Discover",,U,,02/20/2020,"Bisbee Soap","Personal : Miscellaneous","Personal","Miscellaneous","",$17.54,$0.00,-$4516.98
"Discover",,U,,02/20/2020,"Queen Mine Bisbee","Recreation : Entertainment","Recreation","Entertainment","With SANDY",$39.00,$0.00,-$4555.98
"Discover",,U,,02/20/2020,"Screaming Banshee Pizza","Food : Restaurants","Food","Restaurants","Bisbee with Sandy",$61.60,$0.00,-$4617.58
"Discover",,U,,02/21/2020,"Walmart","RV : Equipment/Supplies","RV","Equipment/Supplies","",$21.88,$0.00,-$4639.46
"Discover",,U,,02/21/2020,"Hair by Tara","Personal : Miscellaneous","Personal","Miscellaneous","Haircut",$24.00,$0.00,-$4663.46
"Discover",,U,,02/21/2020,"Gadsens Douglas","Food : Restaurants","Food","Restaurants","With SKP crew in Douglas",$39.04,$0.00,-$4702.50
"Discover",,U,,02/21/2020,"GSE GOOD SAM","RV : clubs","RV","clubs","Roadside assistence",$149.95,$0.00,-$4852.45
"Discover",,U,,02/21/2020,"Wal-mart","Food : Groceries","Food","Groceries","(Split 1/2) ",$150.00,$0.00,-$5083.47
"Discover",,U,,02/21/2020,"Wal-mart","Lisa Business : Equipment Rental","Lisa Business","Equipment Rental","(Split 2/2) ",$81.02,$0.00,-$5083.47
"Discover",,U,,02/22/2020,"circle k","Transportation : Gas","Transportation","Gas","",$20.83,$0.00,-$5104.30
"Discover",,U,,02/23/2020,"SKP SAGUARO","RV : Campgrounds","RV","Campgrounds","",$27.89,$0.00,-$5132.19
"Discover",,U,,02/24/2020,"McDonalds","Food : Restaurants","Food","Restaurants","coffee",$1.09,$0.00,-$5133.28
"Discover",,U,,02/24/2020,"The Screamery","Food : Restaurants","Food","Restaurants","icecream",$12.76,$0.00,-$5146.04
"Discover",,U,,02/24/2020,"salsa verde","Food : Restaurants","Food","Restaurants","",$31.25,$0.00,-$5177.29
"Discover",,U,,02/25/2020,"Sq goodcakes","Food : Restaurants","Food","Restaurants","cake",$16.94,$0.00,-$5194.23
"Discover",,U,,02/25/2020,"speedway","Transportation : Gas","Transportation","Gas","",$18.40,$0.00,-$5212.63
"Discover",,U,,02/25/2020,"Sq blacksheep","Personal : Gifts","Personal","Gifts","bisbee",$21.92,$0.00,-$5234.55
"Discover",,U,,02/26/2020,"Screaming Banshee Pizza","Food : Restaurants","Food","Restaurants","pizza with mary",$57.06,$0.00,-$5291.61
"Discover",,U,,02/27/2020,"redbox","Recreation : Entertainment","Recreation","Entertainment","",$1.96,$0.00,-$5293.57
"Discover",,U,,02/27/2020,"Untamed convection","Food : Restaurants","Food","Restaurants","ice cream",$10.51,$0.00,-$5304.08
"Discover",,U,,02/27/2020,"Chiracahua","Personal : Gifts","Personal","Gifts","",$13.98,$0.00,-$5318.06
"Discover",,U,,02/27/2020,"Cheveron","Transportation : Gas","Transportation","Gas","",$20.15,$0.00,-$5338.21
"Discover",,U,,02/28/2020,"safeway","Food : Groceries","Food","Groceries","benson",$14.98,$0.00,-$5353.19
"Discover",,U,,02/28/2020,"gas tuscon","Transportation : Gas","Transportation","Gas","",$17.28,$0.00,-$5370.47
"Discover",,U,,02/29/2020,"itunes","Recreation : Entertainment","Recreation","Entertainment","",$2.99,$0.00,-$5373.46
"Discover",,U,,02/29/2020,"alltrails","Recreation : Entertainment","Recreation","Entertainment","",$59.99,$0.00,-$5433.45
"Discover",,U,,02/29/2020,"AZ desert Museum","Recreation : Entertainment","Recreation","Entertainment","with MARY",$74.85,$0.00,-$5508.30
"Discover",,U,,03/01/2020,"circle k","RV : gasoline","RV","gasoline","",$100.00,$0.00,-$5608.30
"Discover",,U,,03/01/2020,"SKP SAGUARO","RV : Campgrounds","RV","Campgrounds","electric",$126.10,$0.00,-$5734.40
"Discover",,U,,03/02/2020,"safeway","Food : Groceries","Food","Groceries","",$3.87,$0.00,-$5738.27
"Discover",,U,,03/02/2020,"safeway","Food : Groceries","Food","Groceries","",$107.98,$0.00,-$5846.25
"Discover",,U,,03/05/2020,"Oldies","Food : Restaurants","Food","Restaurants","icecream",$14.12,$0.00,-$5860.37
"Discover",,U,,03/05/2020,"walgreens","Personal : nom-prescription medication","Personal","nom-prescription medication","",$14.13,$0.00,-$5874.50
"Discover",,U,,03/06/2020,"Transfer : Dcu Checking",,,,"",$0.00,$3950.99,-$1923.51
"Discover",,U,,03/07/2020,"Circl K","Transportation : Gas","Transportation","Gas","",$26.15,$0.00,-$1949.66
"Discover",,U,,03/07/2020,"sprouts","Food : Groceries","Food","Groceries","",$79.19,$0.00,-$2028.85
"Discover",,U,,03/07/2020,"trader Joes","Food : Groceries","Food","Groceries","",$167.27,$0.00,-$2196.12
"Discover",,U,,03/10/2020,"Nytimes","Recreation : Entertainment","Recreation","Entertainment","",$4.00,$0.00,-$2200.12
"Discover",,U,,03/10/2020,"sonic drive","Food : Restaurants","Food","Restaurants","",$6.04,$0.00,-$2206.16
"Discover",,U,,03/10/2020,"walgreens","RV : Equipment/Supplies","RV","Equipment/Supplies","",$14.93,$0.00,-$2221.09
"Discover",,U,,03/10/2020,"Walmart","Food : Groceries","Food","Groceries","",$41.01,$0.00,-$2262.10
"Discover",,U,,03/10/2020,"Walmart","RV : Equipment/Supplies","RV","Equipment/Supplies","(Split 1/2) ",$40.00,$0.00,-$2364.62
"Discover",,U,,03/10/2020,"Walmart","Food : Groceries","Food","Groceries","(Split 2/2) ",$62.52,$0.00,-$2364.62
"Discover",,U,,03/13/2020,"Frys Groceries","Food : Groceries","Food","Groceries","",$71.21,$0.00,-$2435.83
"Discover",,U,,03/15/2020,"itunes","Recreation : Entertainment","Recreation","Entertainment","",$0.99,$0.00,-$2436.82
"Discover",,U,,03/15/2020,"cvs","Personal : Prescriptions, Medicine","Personal","Prescriptions, Medicine","",$25.46,$0.00,-$2462.28
"Discover",,U,,03/16/2020,"Paul Wagner","Personal : Doctor, Dentist","Personal","Doctor, Dentist","Lisa Eye exam - NO PROBLEM GREAT!!!!",$100.00,$0.00,-$2562.28
"Discover",,U,,03/18/2020,"Chevron","Transportation : Gas","Transportation","Gas","",$26.18,$0.00,-$2588.46
"Discover",,U,,03/20/2020,"trader Joes","Food : Groceries","Food","Groceries","",$76.69,$0.00,-$2665.15
"Discover",,U,,03/20/2020,"sprouts","Food : Groceries","Food","Groceries","",$190.77,$0.00,-$2855.92
"Discover",,U,,03/23/2020,"Turbotax","RV : MISC","RV","MISC","",$26.55,$0.00,-$2882.47
"Discover",,U,,03/23/2020,"Turbotax","RV : MISC","RV","MISC","",$26.55,$0.00,-$2909.02
"Discover",,U,,03/26/2020,"Amazon","RV : Equipment/Supplies","RV","Equipment/Supplies","",$37.12,$0.00,-$2946.14
"Discover",,U,,03/26/2020,"Amazon","RV : Equipment/Supplies","RV","Equipment/Supplies","",$98.63,$0.00,-$3044.77
"Discover",,U,,03/26/2020,"Amazon","RV : Equipment/Supplies","RV","Equipment/Supplies","",$114.24,$0.00,-$3159.01
"Discover",,U,,03/26/2020,"Nordvpn","RV : Equipment/Supplies","RV","Equipment/Supplies","",$125.64,$0.00,-$3284.65
"Discover",,U,,03/28/2020,"Amazon","RV : Equipment/Supplies","RV","Equipment/Supplies","",$20.55,$0.00,-$3305.20
"Discover",,U,,03/29/2020,"itunes","Recreation : Entertainment","Recreation","Entertainment","",$2.99,$0.00,-$3308.19
"Discover",,U,,03/29/2020,"Save the children","Charity : Other","Charity","Other","Coronavirus",$102.20,$0.00,-$3410.39
"Discover",,U,,04/04/2020,"Amazon Prime","RV : Equipment/Supplies","RV","Equipment/Supplies","Wifi Router Extender and other stuff",$119.00,$0.00,-$3529.39
"Discover",,U,,04/05/2020,"Wal-mart","Food : Groceries","Food","Groceries","deliverd",$113.98,$0.00,-$3643.37
"Discover",,U,,04/07/2020,"Transfer : Dcu Checking",,,,"",$0.00,$2364.62,-$1278.75
"Discover",,U,,04/07/2020,"sprouts","Food : Groceries","Food","Groceries","",$14.37,$0.00,-$1293.12
"Discover",,U,,04/07/2020,"sprouts","Food : Groceries","Food","Groceries","",$165.00,$0.00,-$1458.12
"Discover",,U,,04/08/2020,"Nytimes","Recreation : Entertainment","Recreation","Entertainment","",$4.00,$0.00,-$1462.12
"Discover",,U,,04/08/2020,"Amazon","RV : Equipment/Supplies","RV","Equipment/Supplies","",$11.80,$0.00,-$1473.92
"Discover",,U,,04/08/2020,"Barnes and Noble","Personal : Gifts","Personal","Gifts","alyssa books",$54.73,$0.00,-$1528.65
"Discover",,U,,04/09/2020,"Amazon","RV : Equipment/Supplies","RV","Equipment/Supplies","",$21.91,$0.00,-$1550.56
"Discover",,U,,04/09/2020,"Amazon","RV : Equipment/Supplies","RV","Equipment/Supplies","",$30.50,$0.00,-$1581.06
"Discover",,U,,04/09/2020,"Amazon","RV : Equipment/Supplies","RV","Equipment/Supplies","",$53.68,$0.00,-$1634.74
"Discover",,U,,04/10/2020,"K-mart","Financial Help : Mom And Dad","Financial Help","Mom And Dad","Microwave",$168.85,$0.00,-$1803.59
"Discover",,U,,04/11/2020,"Partners in Health","Charity : Other","Charity","Other","",$103.90,$0.00,-$1907.49
"Discover",,U,,04/12/2020,"Amazon","Personal : nom-prescription medication","Personal","nom-prescription medication","",$21.26,$0.00,-$1928.75
"Discover",,U,,04/13/2020,"Shell","Transportation : Gas","Transportation","Gas","",$19.72,$0.00,-$1948.47
"Discover",,U,,04/14/2020,"sprouts","Food : Groceries","Food","Groceries","",$158.32,$0.00,-$2106.79
"Discover",,U,,04/15/2020,"Amazon","Personal : nom-prescription medication","Personal","nom-prescription medication","",$15.33,$0.00,-$2122.12
"Discover",,U,,04/15/2020,"Amazon","RV : Equipment/Supplies","RV","Equipment/Supplies","",$15.62,$0.00,-$2137.74
"Discover",,U,,04/15/2020,"Amazon","RV : Equipment/Supplies","RV","Equipment/Supplies","",$36.12,$0.00,-$2173.86
"Discover",,U,,04/16/2020,"sprouts","Food : Groceries","Food","Groceries","",$2.00,$0.00,-$2175.86
"Discover",,U,,04/16/2020,"Amazon","RV : Equipment/Supplies","RV","Equipment/Supplies","",$28.09,$0.00,-$2203.95
"Discover",,U,,04/18/2020,"itunes","Recreation : Entertainment","Recreation","Entertainment","",$0.99,$0.00,-$2204.94
"Discover",,U,,04/18/2020,"Amazon","RV : Equipment/Supplies","RV","Equipment/Supplies","",$19.72,$0.00,-$2224.66
"Discover",,U,,04/19/2020,"rvtripwiz","RV : Equipment/Supplies","RV","Equipment/Supplies","",$39.00,$0.00,-$2263.66
"Discover",,U,,04/20/2020,"Amazon","RV : Equipment/Supplies","RV","Equipment/Supplies","",$8.76,$0.00,-$2272.42
"Discover",,U,,04/20/2020,"Amazon","Recreation : Entertainment","Recreation","Entertainment","Gardening stuff",$9.85,$0.00,-$2282.27
"Discover",,U,,04/21/2020,"Save the children","Charity : Other","Charity","Other","",$102.20,$0.00,-$2384.47
"Discover",,U,,04/22/2020,"Amazon","RV : Equipment/Supplies","RV","Equipment/Supplies","",$16.39,$0.00,-$2400.86
"Discover",,U,,04/22/2020,"cvs","Personal : Prescriptions, Medicine","Personal","Prescriptions, Medicine","",$20.00,$0.00,-$2420.86
"Discover",,U,,04/24/2020,"cvs","Personal : Prescriptions, Medicine","Personal","Prescriptions, Medicine","",$19.72,$0.00,-$2440.58
"Discover",,U,,04/25/2020,"Amazon","RV : Equipment/Supplies","RV","Equipment/Supplies","",$19.63,$0.00,-$2460.21
"Discover",,U,,04/25/2020,"Instacart","Food : Groceries","Food","Groceries","",$280.00,$0.00,-$2740.21
"Discover",,U,,04/27/2020,"Instacart","Food : Groceries","Food","Groceries","",$8.67,$0.00,-$2748.88
"Discover",,U,,04/27/2020,"Amazon","RV : Equipment/Supplies","RV","Equipment/Supplies","",$19.72,$0.00,-$2768.60
"Discover",,U,,04/30/2020,"Amazon","RV : Equipment/Supplies","RV","Equipment/Supplies","",-$19.72,$0.00,-$2748.88
"Discover",,U,,05/01/2020,"itunes","Recreation : Entertainment","Recreation","Entertainment","",$2.99,$0.00,-$2751.87
"Discover",,U,,05/01/2020,"Dancing Eagle","RV : gasoline","RV","gasoline","CEN PAraje NM",$46.25,$0.00,-$2798.12
"Discover",,U,,05/01/2020,"","RV : gasoline","RV","gasoline","Holbrook AZ",$100.00,$0.00,-$2898.12
"Discover",,U,,05/03/2020,"Circe K","RV : gasoline","RV","gasoline","GoodLand KS",$50.42,$0.00,-$2948.54
"Discover",,U,,05/03/2020,"Exxon mobile","RV : gasoline","RV","gasoline","Trinidad CO",$78.70,$0.00,-$3027.24
"Discover",,U,,05/04/2020,"Raton Ma Campground","RV : Campgrounds","RV","Campgrounds","",$38.77,$0.00,-$3066.01
"Discover",,U,,05/04/2020,"Kearny RV Park","RV : Campgrounds","RV","Campgrounds","Nebraska",$46.47,$0.00,-$3112.48
"Discover",,U,,05/04/2020,"Wal-mart","Food : Groceries","Food","Groceries","(Split 1/2) ",$300.00,$0.00,-$3522.06
"Discover",,U,,05/04/2020,"Wal-mart","RV : Equipment/Supplies","RV","Equipment/Supplies","(Split 2/2) ",$109.58,$0.00,-$3522.06
"Discover",,U,,05/05/2020,"Pilot","RV : gasoline","RV","gasoline","Wood River NE",$48.28,$0.00,-$3570.34
"Discover",,U,,05/06/2020,"Nytimes","Recreation : Entertainment","Recreation","Entertainment","",$4.00,$0.00,-$3574.34
"Discover",,U,,05/06/2020,"netflix","Recreation : Entertainment","Recreation","Entertainment","",$12.99,$0.00,-$3587.33
"Discover",,U,,05/06/2020,"Pilot","RV : gasoline","RV","gasoline","Walcott IA",$75.00,$0.00,-$3662.33
"Discover",,U,,05/06/2020,"Sunoco","RV : gasoline","RV","gasoline","Rolling Prare IN (?)",$77.96,$0.00,-$3740.29
"Discover",,U,,05/07/2020,"Transfer : Dcu Checking",,,,"",$0.00,$1928.75,-$1811.54
"Discover",,U,,05/07/2020,"Shell","RV : gasoline","RV","gasoline","North East PA",$40.98,$0.00,-$1852.52
"Discover",,U,,05/07/2020,"Sunoco","RV : gasoline","RV","gasoline","Angola NY",$88.16,$0.00,-$1940.68
"Discover",,U,,05/08/2020,"gulf mart","RV : gasoline","RV","gasoline","Blandford MA",$100.00,$0.00,-$2040.68
"Discover",,U,,05/08/2020,"Walmart","Food : Groceries","Food","Groceries","Albany NY",$169.57,$0.00,-$2210.25
"Discover",,U,,05/09/2020,"advanced autoparts","Transportation : Repairs & Maintenance","Transportation","Repairs & Maintenance","",$0.00,$22.00,-$2188.25
"Discover",,U,,05/09/2020,"advanced autoparts","Transportation : Repairs & Maintenance","Transportation","Repairs & Maintenance","",$2.96,$0.00,-$2191.21
"Discover",,U,,05/09/2020,"advanced autoparts","Transportation : Repairs & Maintenance","Transportation","Repairs & Maintenance","Battery",$150.86,$0.00,-$2342.07
"Discover",,U,,05/11/2020,"advanced autoparts","Transportation : Repairs & Maintenance","Transportation","Repairs & Maintenance","",$3.18,$0.00,-$2345.25
"Discover",,U,,05/11/2020,"Exxon mobile","Transportation : Gas","Transportation","Gas","",$17.84,$0.00,-$2363.09
"Discover",,U,,05/14/2020,"just picked","RV : Equipment/Supplies","RV","Equipment/Supplies","",$43.49,$0.00,-$2406.58
"Discover",,U,,05/15/2020,"USA  star","RV : Laundry","RV","Laundry","",$5.50,$0.00,-$2412.08
"Discover",,U,,05/15/2020,"US A  Star","RV : Laundry","RV","Laundry","",$11.00,$0.00,-$2423.08
"Discover",,U,,05/15/2020,"Amazon","RV : Equipment/Supplies","RV","Equipment/Supplies","",$18.31,$0.00,-$2441.39
"Discover",,U,,05/15/2020,"aarp","RV : clubs","RV","clubs","",$30.00,$0.00,-$2471.39
"Discover",,U,,05/15/2020,"agway","Personal : Gifts","Personal","Gifts","",$38.22,$0.00,-$2509.61
"Discover",,U,,05/16/2020,"cvs","Personal : Prescriptions, Medicine","Personal","Prescriptions, Medicine","",$12.53,$0.00,-$2522.14
"Discover",,U,,05/16/2020,"Ace hardware","Financial Help : Mom And Dad","Financial Help","Mom And Dad","",$88.16,$0.00,-$2610.30
"Discover",,U,,05/17/2020,"agway","Personal : Gifts","Personal","Gifts","",$18.86,$0.00,-$2629.16
"Discover",,U,,05/18/2020,"RMV","Transportation : Car Insurance","Transportation","Car Insurance","Paid to see driving record",$8.00,$0.00,-$2637.16
"Discover",,U,,05/19/2020,"itunes","Recreation : Entertainment","Recreation","Entertainment","",$0.99,$0.00,-$2638.15
"Discover",,U,,05/19/2020,"Amazon","RV : Equipment/Supplies","RV","Equipment/Supplies","",$123.70,$0.00,-$2761.85
"Discover",,U,,05/21/2020,"Exxon mobile","Transportation : Gas","Transportation","Gas","Yarmouth",$15.90,$0.00,-$2777.75
"Discover",,U,,05/22/2020,"stop & shop","Food : Groceries","Food","Groceries","Peapod Orleans",$288.07,$0.00,-$3065.82
"Discover",,U,,05/27/2020,"US A  Star","RV : Laundry","RV","Laundry","",$11.00,$0.00,-$3076.82
"Discover",,U,,05/27/2020,"US A  Star","RV : Laundry","RV","Laundry","",$11.00,$0.00,-$3087.82
"Discover",,U,,05/27/2020,"chess.com","Recreation : Entertainment","Recreation","Entertainment","",$29.00,$0.00,-$3116.82
"Discover",,U,,05/29/2020,"itunes","Recreation : Entertainment","Recreation","Entertainment","",$2.99,$0.00,-$3119.81
"Discover",,U,,05/29/2020,"FBBay","Charity : Other","Charity","Other","For Laura Bday",$57.00,$0.00,-$3176.81
"Discover",,U,,05/31/2020,"Sunoco Newton","Transportation : Gas","Transportation","Gas","",$18.18,$0.00,-$3194.99
"Discover",,U,,06/01/2020,"stop & shop","Food : Groceries","Food","Groceries","",$0.00,$15.00,-$3179.99
"Discover",,U,,06/01/2020,"Sunoco Newton","Transportation : Gas","Transportation","Gas","",$17.13,$0.00,-$3197.12
"Discover",,U,,06/01/2020,"Brick fire pizza","Food : Restaurants","Food","Restaurants","",$36.38,$0.00,-$3233.50
"Discover",,U,,06/01/2020,"stop and shop","Food : Groceries","Food","Groceries","",$337.91,$0.00,-$3571.41
"Discover",,U,,06/03/2020,"Nytimes","Recreation : Entertainment","Recreation","Entertainment","",$4.00,$0.00,-$3575.41
"Discover",,U,,06/05/2020,"Ring Bors","Food : Groceries","Food","Groceries","",$44.07,$0.00,-$3619.48
"Discover",,U,,06/05/2020,"Progressive Insurance","RV : Insurance","RV","Insurance","",$1850.00,$0.00,-$5469.48
"Discover",,U,,06/06/2020,"Transfer : Dcu Checking",,,,"",$0.00,$2363.09,-$3106.39
"Discover",,U,,06/06/2020,"netflix","Recreation : Entertainment","Recreation","Entertainment","",$12.99,$0.00,-$3119.38
"Discover",,U,,06/06/2020,"netflix","Recreation : Entertainment","Recreation","Entertainment","",$12.99,$0.00,-$3132.37
"Discover",,U,,06/07/2020,"Nancies Candy","Personal : Gifts","Personal","Gifts","",$12.72,$0.00,-$3145.09
"Discover",,U,,06/07/2020,"Shell Dennis Ma","Transportation : Gas","Transportation","Gas","",$23.65,$0.00,-$3168.74
"Discover",,U,,06/07/2020,"Ring Bros Market","Food : Groceries","Food","Groceries","",$34.89,$0.00,-$3203.63
"Discover",,U,,06/07/2020,"cvs","Personal : Prescriptions, Medicine","Personal","Prescriptions, Medicine","(Split 1/2) ",$70.00,$0.00,-$3345.55
"Discover",,U,,06/07/2020,"cvs","RV : Equipment/Supplies","RV","Equipment/Supplies","(Split 2/2) ",$71.92,$0.00,-$3345.55
"Discover",,U,,06/08/2020,"USA  star","RV : Laundry","RV","Laundry","Dennis Port Ma",$11.00,$0.00,-$3356.55
"Discover",,U,,06/08/2020,"Amazon","Recreation : Entertainment","Recreation","Entertainment","Back[ack",$24.99,$0.00,-$3381.54
"Discover",,U,,06/08/2020,"Amazon","Personal : cloths","Personal","cloths","",$40.79,$0.00,-$3422.33
"Discover",,U,,06/10/2020,"Amazon","Recreation : Entertainment","Recreation","Entertainment","",$40.28,$0.00,-$3462.61
"Discover",,U,,06/10/2020,"Captain Frosty","Food : Restaurants","Food","Restaurants","",$90.29,$0.00,-$3552.90
"Discover",,U,,06/10/2020,"zenni","Personal : Doctor, Dentist","Personal","Doctor, Dentist","Bob Glasses",$116.46,$0.00,-$3669.36
"Discover",,U,,06/12/2020,"trader Joes","Food : Groceries","Food","Groceries","",$209.65,$0.00,-$3879.01
"Discover",,U,,06/13/2020,"Sweetwater camground","RV : Campgrounds","RV","Campgrounds","Firewood",$5.99,$0.00,-$3885.00
"Discover",,U,,06/13/2020,"Exxon mobile","Transportation : Gas","Transportation","Gas","Newton",$14.85,$0.00,-$3899.85
"Discover",,U,,06/13/2020,"Cafe Al Fresco","Food : Restaurants","Food","Restaurants","Picnic Lunch",$28.10,$0.00,-$3927.95
"Discover",,U,,06/15/2020,"Escapees RV Club","RV : clubs","RV","clubs","",$39.95,$0.00,-$3967.90
"Discover",,U,,06/16/2020,"star laundry","RV : Laundry","RV","Laundry","",$5.50,$0.00,-$3973.40
"Discover",,U,,06/16/2020,"star laundry","RV : Laundry","RV","Laundry","",$11.00,$0.00,-$3984.40
"Discover",,U,,06/17/2020,"itunes","Recreation : Entertainment","Recreation","Entertainment","",$0.99,$0.00,-$3985.39
"Discover",,U,,06/18/2020,"agway","Recreation : Entertainment","Recreation","Entertainment","plants",$23.65,$0.00,-$4009.04
"Discover",,U,,06/18/2020,"agway","Recreation : Entertainment","Recreation","Entertainment","",$33.99,$0.00,-$4043.03
"Discover",,U,,06/18/2020,"stop & shop","Food : Groceries","Food","Groceries","",$229.39,$0.00,-$4272.42
"Discover",,U,,06/20/2020,"Sweetwater camground","Personal : Gifts","Personal","Gifts","",$20.98,$0.00,-$4293.40
"Discover",,U,,06/20/2020,"Sweetwater camground","RV : Equipment/Supplies","RV","Equipment/Supplies","",$49.66,$0.00,-$4343.06
"Discover",,U,,06/22/2020,"Shell","RV : gasoline","RV","gasoline","",$17.74,$0.00,-$4360.80
"Discover",,U,,06/22/2020,"zenni","Personal : Doctor, Dentist","Personal","Doctor, Dentist","",$94.85,$0.00,-$4455.65
"Discover",,U,,06/22/2020,"stop & shop","Food : Groceries","Food","Groceries","",$160.37,$0.00,-$4616.02
"Discover",,U,,06/24/2020,"redbox","Recreation : Entertainment","Recreation","Entertainment","",$3.83,$0.00,-$4619.85
"Discover",,U,,06/24/2020,"Sweetwater camground","RV : Equipment/Supplies","RV","Equipment/Supplies","",$31.06,$0.00,-$4650.91
"Discover",,U,,06/25/2020,"Sweetwater camground","RV : Equipment/Supplies","RV","Equipment/Supplies","",$20.00,$0.00,-$4670.91
"Discover",,U,,06/25/2020,"Sweetwater camground","RV : Equipment/Supplies","RV","Equipment/Supplies","",$22.06,$0.00,-$4692.97
"Discover",,U,,06/25/2020,"Sun on restaurant","Food : Restaurants","Food","Restaurants","",$87.36,$0.00,-$4780.33
"Discover",,U,,06/28/2020,"Brewster Scoop","Food : Restaurants","Food","Restaurants","icecream",$18.10,$0.00,-$4798.43
"Discover",,U,,06/29/2020,"star laundry","RV : Laundry","RV","Laundry","",$5.50,$0.00,-$4803.93
"Discover",,U,,06/29/2020,"star laundry","RV : Laundry","RV","Laundry","",$11.00,$0.00,-$4814.93
"Discover",,U,,06/30/2020,"itunes","Recreation : Entertainment","Recreation","Entertainment","",$2.99,$0.00,-$4817.92
"Discover",,U,,07/01/2020,"redbox","Recreation : Entertainment","Recreation","Entertainment","",$1.91,$0.00,-$4819.83
"Discover",,U,,07/01/2020,"Nytimes","Recreation : Entertainment","Recreation","Entertainment","",$4.00,$0.00,-$4823.83
"Discover",,U,,07/02/2020,"stop & shop","Food : Groceries","Food","Groceries","",$145.38,$0.00,-$4969.21
"Discover",,U,,07/02/2020,"stop & shop","Food : Groceries","Food","Groceries","",$192.01,$0.00,-$5161.22
"Discover",,U,,07/03/2020,"Exxon mobile","Transportation : Gas","Transportation","Gas","",$18.69,$0.00,-$5179.91
"Discover",,U,,07/06/2020,"Transfer : Dcu Checking",,,,"",$0.00,$3612.30,-$1567.61
"Discover",,U,,07/07/2020,"Sweetwater camground","RV : Equipment/Supplies","RV","Equipment/Supplies","",$70.55,$0.00,-$1638.16
"Discover",,U,,07/09/2020,"cvs","Personal : Prescriptions, Medicine","Personal","Prescriptions, Medicine","",$12.20,$0.00,-$1650.36
"Discover",,U,,07/09/2020,"cvs","Personal : Prescriptions, Medicine","Personal","Prescriptions, Medicine","",$19.72,$0.00,-$1670.08
"Discover",,U,,07/09/2020,"stop & shop","Food : Groceries","Food","Groceries","",$82.92,$0.00,-$1753.00
"Discover",,U,,07/09/2020,"stop & shop","Food : Groceries","Food","Groceries","",$180.69,$0.00,-$1933.69
"Discover",,U,,07/10/2020,"Sweetwater camground","RV : Equipment/Supplies","RV","Equipment/Supplies","",$28.01,$0.00,-$1961.70
"Discover",,U,,07/13/2020,"Town of Dennis","Recreation : Entertainment","Recreation","Entertainment","Beach pass",$52.25,$0.00,-$2013.95
"Discover",,U,,07/14/2020,"rancatores","Food : Restaurants","Food","Restaurants","ice cream at Lanas",$42.52,$0.00,-$2056.47
"Discover",,U,,07/16/2020,"itunes","Recreation : Entertainment","Recreation","Entertainment","",$0.99,$0.00,-$2057.46
"Discover",,U,,07/16/2020,"AUgusta Subs Billerica","Food : Restaurants","Food","Restaurants","Visiting Christine Bob Sandwich",$7.48,$0.00,-$2064.94
"Discover",,U,,07/16/2020,"WESTFORD DERMERTOLOGY","Personal : Doctor, Dentist","Personal","Doctor, Dentist","",$18.00,$0.00,-$2082.94
"Discover",,U,,07/16/2020,"Exxon West Barnstable","Transportation : Gas","Transportation","Gas","",$19.52,$0.00,-$2102.46
"Discover",,U,,07/16/2020,"Modell's","Personal : cloths","Personal","cloths","Bob Sandals and Sneakers",$68.92,$0.00,-$2171.38
"Discover",,U,,07/17/2020,"CTS HYANNIS","Food : Groceries","Food","Groceries","",$53.03,$0.00,-$2224.41
"Discover",,U,,07/17/2020,"Joanns Stores","Financial Help : Alyssa","Financial Help","Alyssa","(Split 1/2) ",$45.00,$0.00,-$2293.46
"Discover",,U,,07/17/2020,"Joanns Stores","Recreation : Entertainment","Recreation","Entertainment","(Split 2/2) ",$24.05,$0.00,-$2293.46
"Discover",,U,,07/17/2020,"trader Joes","Food : Groceries","Food","Groceries","",$250.44,$0.00,-$2543.90
"Discover",,U,,07/19/2020,"Shell  South Dennis","Transportation : Gas","Transportation","Gas","",$20.85,$0.00,-$2564.75
"Discover",,U,,07/19/2020,"Cape Cod National Seashor","Recreation : Entertainment","Recreation","Entertainment","Yearly National Park Pass",$80.00,$0.00,-$2644.75
"Discover",,U,,07/20/2020,"redbox","Recreation : Entertainment","Recreation","Entertainment","",$1.91,$0.00,-$2646.66
"Discover",,U,,07/20/2020,"stop & shop","Food : Groceries","Food","Groceries","",$17.45,$0.00,-$2664.11
"Discover",,U,,07/21/2020,"redbox","Recreation : Entertainment","Recreation","Entertainment","",$1.91,$0.00,-$2666.02
"Discover",,U,,07/22/2020,"stop & shop","Food : Groceries","Food","Groceries","",$37.98,$0.00,-$2704.00
"Discover",,U,,07/23/2020,"Amazon","RV : Equipment/Supplies","RV","Equipment/Supplies","",$48.71,$0.00,-$2752.71
"Discover",,U,,07/25/2020,"Wellfleet Theatres","Recreation : Entertainment","Recreation","Entertainment","Drive in movie",$27.00,$0.00,-$2779.71
"Discover",,U,,07/25/2020,"Basco Grill Eastham","Food : Restaurants","Food","Restaurants","Mom and Dad",$38.50,$0.00,-$2818.21
"Discover",,U,,07/26/2020,"Cumberland Farms","Transportation : Gas","Transportation","Gas","",$21.19,$0.00,-$2839.40
"Discover",,U,,07/27/2020,"Amazon","RV : Equipment/Supplies","RV","Equipment/Supplies","",$26.48,$0.00,-$2865.88
"Discover",,U,,07/27/2020,"Amazon","RV : Equipment/Supplies","RV","Equipment/Supplies","",$36.76,$0.00,-$2902.64
"Discover",,U,,07/27/2020,"stop and shop","Food : Groceries","Food","Groceries","",$67.11,$0.00,-$2969.75
"Discover",,U,,07/27/2020,"stop & shop","Food : Groceries","Food","Groceries","",$250.05,$0.00,-$3219.80
"Discover",,U,,07/29/2020,"itunes","Recreation : Entertainment","Recreation","Entertainment","",$2.99,$0.00,-$3222.79
"Discover",,U,,07/29/2020,"Nytimes","Recreation : Entertainment","Recreation","Entertainment","",$4.00,$0.00,-$3226.79
"Discover",,U,,07/29/2020,"star laundry","RV : Laundry","RV","Laundry","",$11.00,$0.00,-$3237.79
"Discover",,U,,08/01/2020,"Brewster Hardware","RV : Equipment/Supplies","RV","Equipment/Supplies","? ask Lisa",$12.74,$0.00,-$3250.53
"Discover",,U,,08/01/2020,"Cumberland Farms","Transportation : Gas","Transportation","Gas","",$20.74,$0.00,-$3271.27
"Discover",,U,,08/01/2020,"BM Sichuan Gourment","Food : Restaurants","Food","Restaurants","",$67.97,$0.00,-$3339.24
"Discover",,U,,08/02/2020,"stop & shop","Food : Groceries","Food","Groceries","",$68.60,$0.00,-$3407.84
"Discover",,U,,08/02/2020,"Market bskt","Food : Groceries","Food","Groceries","",$249.80,$0.00,-$3657.64
"Discover",,U,,08/03/2020,"Ocean State Joblot","Recreation : Entertainment","Recreation","Entertainment","Drawing stuff",$15.45,$0.00,-$3673.09
"Discover",,U,,08/03/2020,"Amazon","RV : Equipment/Supplies","RV","Equipment/Supplies","",$82.04,$0.00,-$3755.13
"Discover",,U,,08/06/2020,"Transfer : Dcu Checking",,,,"",$0.00,$1961.70,-$1793.43
"Discover",,U,,08/06/2020,"dunkin donuts","Food : Restaurants","Food","Restaurants","",$5.54,$0.00,-$1798.97
"Discover",,U,,08/06/2020,"netflix","Recreation : Entertainment","Recreation","Entertainment","",$12.99,$0.00,-$1811.96
"Discover",,U,,08/06/2020,"Amazon","RV : Equipment/Supplies","RV","Equipment/Supplies","",$13.07,$0.00,-$1825.03
"Discover",,U,,08/06/2020,"speedway","Transportation : Gas","Transportation","Gas","",$18.11,$0.00,-$1843.14
"Discover",,U,,08/07/2020,"one stop oil","Transportation : Repairs & Maintenance","Transportation","Repairs & Maintenance","",$42.00,$0.00,-$1885.14
"Discover",,U,,08/09/2020,"Brewster book store","Recreation : Entertainment","Recreation","Entertainment","Hanold book",$19.13,$0.00,-$1904.27
"Discover",,U,,08/10/2020,"sir crickets fish & chip","Food : Restaurants","Food","Restaurants","",$34.08,$0.00,-$1938.35
"Discover",,U,,08/13/2020,"star laundry","RV : Laundry","RV","Laundry","",$5.50,$0.00,-$1943.85
"Discover",,U,,08/13/2020,"star laundry","RV : Laundry","RV","Laundry","",$11.00,$0.00,-$1954.85
"Discover",,U,,08/13/2020,"Amazon","Personal : nom-prescription medication","Personal","nom-prescription medication","",$16.38,$0.00,-$1971.23
"Discover",,U,,08/13/2020,"stop and shop","Food : Groceries","Food","Groceries","",$276.60,$0.00,-$2247.83
"Discover",,U,,08/15/2020,"redbox","Recreation : Entertainment","Recreation","Entertainment","",$2.13,$0.00,-$2249.96
"Discover",,U,,08/15/2020,"cvs","Personal : Prescriptions, Medicine","Personal","Prescriptions, Medicine","",$56.00,$0.00,-$2305.96
"Discover",,U,,08/16/2020,"itunes","Recreation : Entertainment","Recreation","Entertainment","",$0.99,$0.00,-$2306.95
"Discover",,U,,08/16/2020,"Exxon mobile","Transportation : Gas","Transportation","Gas","Harwich",$19.58,$0.00,-$2326.53
"Discover",,U,,08/18/2020,"cvs","Personal : Prescriptions, Medicine","Personal","Prescriptions, Medicine","",$6.33,$0.00,-$2332.86
"Discover",,U,,08/18/2020,"starbucks","Food : Restaurants","Food","Restaurants","",$8.45,$0.00,-$2341.31
"Discover",,U,,08/18/2020,"AUgusta Subs Billerica","Food : Restaurants","Food","Restaurants","",$13.99,$0.00,-$2355.30
"Discover",,U,,08/18/2020,"WESTFORD DERMERTOLOGY","Personal : Doctor, Dentist","Personal","Doctor, Dentist","",$18.00,$0.00,-$2373.30
"Discover",,U,,08/18/2020,"speedway","Transportation : Gas","Transportation","Gas","",$20.47,$0.00,-$2393.77
"Discover",,U,,08/18/2020,"Amazon","Recreation : Entertainment","Recreation","Entertainment","Bob Gripper",$53.02,$0.00,-$2446.79
"Discover",,U,,08/18/2020,"shades of green","RV : Equipment/Supplies","RV","Equipment/Supplies","eco friendly foo storage stuff and artists shacks",$56.28,$0.00,-$2503.07
"Discover",,U,,08/18/2020,"veggie crust","Food : Restaurants","Food","Restaurants","",$79.47,$0.00,-$2582.54
"Discover",,U,,08/19/2020,"cvs","Personal : Prescriptions, Medicine","Personal","Prescriptions, Medicine","",$33.25,$0.00,-$2615.79
"Discover",,U,,08/19/2020,"bangkok kitchen","Food : Restaurants","Food","Restaurants","anniversary Thai food with LISA",$46.85,$0.00,-$2662.64
"Discover",,U,,08/20/2020,"stop and shop","Food : Groceries","Food","Groceries","",$85.02,$0.00,-$2747.66
"Discover",,U,,08/21/2020,"walgreens","RV : Equipment/Supplies","RV","Equipment/Supplies","",$11.35,$0.00,-$2759.01
"Discover",,U,,08/24/2020,"shaw's Market","Food : Groceries","Food","Groceries","",$15.93,$0.00,-$2774.94
"Discover",,U,,08/25/2020,"redbox","Recreation : Entertainment","Recreation","Entertainment","",$1.91,$0.00,-$2776.85
"Discover",,U,,08/25/2020,"Nona Homemade","Food : Restaurants","Food","Restaurants","Scituate",$12.63,$0.00,-$2789.48
"Discover",,U,,08/26/2020,"Nytimes","Recreation : Entertainment","Recreation","Entertainment","",$4.00,$0.00,-$2793.48
"Discover",,U,,08/26/2020,"star laundry","RV : Laundry","RV","Laundry","",$5.50,$0.00,-$2798.98
"Discover",,U,,08/26/2020,"star laundry","RV : Laundry","RV","Laundry","",$11.00,$0.00,-$2809.98
"Discover",,U,,08/26/2020,"Exxon mobile","Transportation : Gas","Transportation","Gas","",$19.47,$0.00,-$2829.45
"Discover",,U,,08/26/2020,"stop & shop","Food : Groceries","Food","Groceries","",$74.94,$0.00,-$2904.39
"Discover",,U,,08/26/2020,"stop & shop","Food : Groceries","Food","Groceries","",$215.32,$0.00,-$3119.71
"Discover",,U,,08/28/2020,"itunes","Recreation : Entertainment","Recreation","Entertainment","",$2.99,$0.00,-$3122.70
"Discover",,U,,08/28/2020,"cvs","Personal : Prescriptions, Medicine","Personal","Prescriptions, Medicine","",$20.00,$0.00,-$3142.70
"Discover",,U,,08/28/2020,"RAO NH State Parks","RV : Campgrounds","RV","Campgrounds","",$206.50,$0.00,-$3349.20
"Discover",,U,,08/31/2020,"Home Depot","Financial Help : Mom And Dad","Financial Help","Mom And Dad","Ask Lisa",$198.61,$0.00,-$3547.81
"Discover",,U,,09/01/2020,"cvs","Personal : Prescriptions, Medicine","Personal","Prescriptions, Medicine","dupixin",$20.00,$0.00,-$3567.81
"Discover",,U,,09/01/2020,"Cumberland Farms","Transportation : Gas","Transportation","Gas","",$24.12,$0.00,-$3591.93
"Discover",,U,,09/01/2020,"Bertolucci's","Food : Restaurants","Food","Restaurants","",$66.82,$0.00,-$3658.75
"Discover",,U,,09/02/2020,"stop & shop","Food : Groceries","Food","Groceries","",$144.69,$0.00,-$3803.44
"Discover",,U,,09/03/2020,"actblue","Personal : Miscellaneous","Personal","Miscellaneous","political donation",$50.00,$0.00,-$3853.44
"Discover",,U,,09/03/2020,"actblue","Personal : Miscellaneous","Personal","Miscellaneous","Political donation",$55.00,$0.00,-$3908.44
"Discover",,U,,09/03/2020,"actbule","Personal : Miscellaneous","Personal","Miscellaneous","poltical doantion",$110.00,$0.00,-$4018.44
"Discover",,U,,09/04/2020,"redbox","Recreation : Entertainment","Recreation","Entertainment","",$3.83,$0.00,-$4022.27
"Discover",,U,,09/04/2020,"star laundry","RV : Laundry","RV","Laundry","",$11.00,$0.00,-$4033.27
"Discover",,U,,09/05/2020,"dunkin donuts","Food : Restaurants","Food","Restaurants","",$3.09,$0.00,-$4036.36
"Discover",,U,,09/06/2020,"Transfer : Dcu Checking",,,,"",$0.00,$1938.35,-$2098.01
"Discover",,U,,09/06/2020,"netflix","Recreation : Entertainment","Recreation","Entertainment","",$12.99,$0.00,-$2111.00
"Discover",,U,,09/07/2020,"Amazon","Recreation : Entertainment","Recreation","Entertainment","",$36.15,$0.00,-$2147.15
"Discover",,U,,09/07/2020,"stop & shop","Food : Groceries","Food","Groceries","",$94.27,$0.00,-$2241.42
"Discover",,U,,09/07/2020,"Exxon mobile","RV : gasoline","RV","gasoline","Bow NH",$100.00,$0.00,-$2341.42
"Discover",,U,,09/08/2020,"Nothc express irving","Transportation : Gas","Transportation","Gas","",$19.38,$0.00,-$2360.80
"Discover",,U,,09/08/2020,"Walmart","Financial Help : Alyssa","Financial Help","Alyssa","(Split 1/2) ",$55.00,$0.00,-$2532.15
"Discover",,U,,09/08/2020,"Walmart","RV : Equipment/Supplies","RV","Equipment/Supplies","(Split 2/2) ",$116.35,$0.00,-$2532.15
"Discover",,U,,09/09/2020,"NH state park","Recreation : Entertainment","Recreation","Entertainment","FLUME HIKE - GREAT!!",$49.00,$0.00,-$2581.15
"Discover",,U,,09/11/2020,"Amazon","Recreation : Entertainment","Recreation","Entertainment","",$14.33,$0.00,-$2595.48
"Discover",,U,,09/11/2020,"Wellfleet Theatres","Food : Restaurants","Food","Restaurants","",$25.52,$0.00,-$2621.00
"Discover",,U,,09/11/2020,"Wellfleet Theatres","Recreation : Entertainment","Recreation","Entertainment","drivin",$40.00,$0.00,-$2661.00
"Discover",,U,,09/12/2020,"tjmaxx","Personal : cloths","Personal","cloths","",$35.90,$0.00,-$2696.90
"Discover",,U,,09/12/2020,"Creme and Kone","Food : Restaurants","Food","Restaurants","",$88.89,$0.00,-$2785.79
"Discover",,U,,09/12/2020,"trader Joes","Financial Help : Alyssa","Financial Help","Alyssa","(Split 1/2) ",$40.00,$0.00,-$2971.82
"Discover",,U,,09/12/2020,"trader Joes","Food : Groceries","Food","Groceries","(Split 2/2) ",$146.03,$0.00,-$2971.82
"Discover",,U,,09/13/2020,"Marshall's","RV : Equipment/Supplies","RV","Equipment/Supplies","(Split 1/2) ",$20.00,$0.00,-$3023.65
"Discover",,U,,09/13/2020,"Marshall's","Personal : cloths","Personal","cloths","(Split 2/2) ",$31.83,$0.00,-$3023.65
"Discover",,U,,09/14/2020,"Sunoco","Transportation : Gas","Transportation","Gas","",$18.92,$0.00,-$3042.57
"Discover",,U,,09/14/2020,"peterson market dennis","Food : Restaurants","Food","Restaurants","",$54.98,$0.00,-$3097.55
"Discover",,U,,09/15/2020,"star laundry","RV : Laundry","RV","Laundry","",$11.00,$0.00,-$3108.55
"Discover",,U,,09/15/2020,"star laundry","RV : Laundry","RV","Laundry","",$11.00,$0.00,-$3119.55
"Discover",,U,,09/16/2020,"itunes","Recreation : Entertainment","Recreation","Entertainment","",$0.99,$0.00,-$3120.54
"Discover",,U,,09/16/2020,"peterson market dennis","Food : Restaurants","Food","Restaurants","",$62.69,$0.00,-$3183.23
"Discover",,U,,09/16/2020,"baskins Hardware","Financial Help : Mom And Dad","Financial Help","Mom And Dad","",$99.38,$0.00,-$3282.61
"Discover",,U,,09/17/2020,"nauset Auto","Transportation : Repairs & Maintenance","Transportation","Repairs & Maintenance","",$20.80,$0.00,-$3303.41
"Discover",,U,,09/18/2020,"Basil Thai Cuisine","Food : Restaurants","Food","Restaurants","Yarmouth",$30.00,$0.00,-$3333.41
"Discover",,U,,09/19/2020,"Cape Code Bag","Personal : cloths","Personal","cloths","Mask",$29.75,$0.00,-$3363.16
"Discover",,U,,09/20/2020,"actblue","Personal : Miscellaneous","Personal","Miscellaneous","",$25.00,$0.00,-$3388.16
"Discover",,U,,09/20/2020,"actblue","Personal : Miscellaneous","Personal","Miscellaneous","",$26.00,$0.00,-$3414.16
"Discover",,U,,09/20/2020,"actblue","Personal : Miscellaneous","Personal","Miscellaneous","",$27.00,$0.00,-$3441.16
"Discover",,U,,09/20/2020,"actblue","Personal : Miscellaneous","Personal","Miscellaneous","",$27.00,$0.00,-$3468.16
"Discover",,U,,09/20/2020,"actblue","Personal : Miscellaneous","Personal","Miscellaneous","",$53.00,$0.00,-$3521.16
"Discover",,U,,09/21/2020,"dunkin donuts","Food : Restaurants","Food","Restaurants","",$2.09,$0.00,-$3523.25
"Discover",,U,,09/21/2020,"speedway","Transportation : Gas","Transportation","Gas","",$17.77,$0.00,-$3541.02
"Discover",,U,,09/22/2020,"peterson market dennis","Food : Restaurants","Food","Restaurants","",$39.06,$0.00,-$3580.08
"Discover",,U,,09/23/2020,"redbox","Recreation : Entertainment","Recreation","Entertainment","",$1.91,$0.00,-$3581.99
"Discover",,U,,09/23/2020,"Nytimes","Recreation : Entertainment","Recreation","Entertainment","",$4.00,$0.00,-$3585.99
"Discover",,U,,09/23/2020,"Primacare","Personal : Doctor, Dentist","Personal","Doctor, Dentist","",$10.00,$0.00,-$3595.99
"Discover",,U,,09/23/2020,"Amazon","Recreation : Entertainment","Recreation","Entertainment","",$16.99,$0.00,-$3612.98
"Discover",,U,,09/23/2020,"Exxon mobile","Transportation : Gas","Transportation","Gas","",$20.45,$0.00,-$3633.43
"Discover",,U,,09/23/2020,"actblue","Personal : Miscellaneous","Personal","Miscellaneous","",$27.00,$0.00,-$3660.43
"Discover",,U,,09/23/2020,"columbos Cafe","Food : Restaurants","Food","Restaurants","Hyannis",$27.55,$0.00,-$3687.98
"Discover",,U,,09/23/2020,"stop & shop","Food : Groceries","Food","Groceries","",$56.00,$0.00,-$3743.98
"Discover",,U,,09/23/2020,"cvs","Personal : Prescriptions, Medicine","Personal","Prescriptions, Medicine","",$87.13,$0.00,-$3831.11
"Discover",,U,,09/24/2020,"actblue","Personal : Miscellaneous","Personal","Miscellaneous","",$25.00,$0.00,-$3856.11
"Discover",,U,,09/25/2020,"Sweetwater camground","RV : Equipment/Supplies","RV","Equipment/Supplies","",$45.78,$0.00,-$3901.89
"Discover",,U,,09/26/2020,"zoo New England","Recreation : Entertainment","Recreation","Entertainment","",$68.95,$0.00,-$3970.84
"Discover",,U,,09/27/2020,"Rons Ice Cream","Food : Restaurants","Food","Restaurants","",$19.75,$0.00,-$3990.59
"Discover",,U,,09/27/2020,"Wegmans","Financial Help : Alyssa","Financial Help","Alyssa","(Split 1/2) ",$80.00,$0.00,-$4291.79
"Discover",,U,,09/27/2020,"Wegmans","Food : Groceries","Food","Groceries","(Split 2/2) ",$221.20,$0.00,-$4291.79
"Discover",,U,,09/28/2020,"Exxon mobile","Transportation : Gas","Transportation","Gas","",$19.91,$0.00,-$4311.70
"Discover",,U,,09/28/2020,"actblue","Personal : Miscellaneous","Personal","Miscellaneous","",$25.00,$0.00,-$4336.70
"Discover",,U,,09/28/2020,"actblue","Personal : Miscellaneous","Personal","Miscellaneous","",$25.00,$0.00,-$4361.70
"Discover",,U,,09/28/2020,"actblue","Personal : Miscellaneous","Personal","Miscellaneous","",$26.00,$0.00,-$4387.70
"Discover",,U,,09/28/2020,"O'Hara Food","Food : Groceries","Food","Groceries","",$113.23,$0.00,-$4500.93
"Discover",,U,,09/29/2020,"itunes","Recreation : Entertainment","Recreation","Entertainment","",$2.99,$0.00,-$4503.92
"Discover",,U,,09/29/2020,"consumer reports","Recreation : Entertainment","Recreation","Entertainment","",$39.00,$0.00,-$4542.92
"Discover",,U,,09/29/2020,"Hyannis auto","Transportation : Repairs & Maintenance","Transportation","Repairs & Maintenance","New Key and Inspection",$186.36,$0.00,-$4729.28
"Discover",,U,,10/01/2020,"actblue","Personal : Miscellaneous","Personal","Miscellaneous","",$4.17,$0.00,-$4733.45
"Discover",,U,,10/01/2020,"actblue","Personal : Miscellaneous","Personal","Miscellaneous","",$5.16,$0.00,-$4738.61
"Discover",,U,,10/01/2020,"actblue","Personal : Miscellaneous","Personal","Miscellaneous","",$5.17,$0.00,-$4743.78
"Discover",,U,,10/01/2020,"actblue","Personal : Miscellaneous","Personal","Miscellaneous","",$5.17,$0.00,-$4748.95
"Discover",,U,,10/01/2020,"actblue","Personal : Miscellaneous","Personal","Miscellaneous","",$10.34,$0.00,-$4759.29
"Discover",,U,,10/01/2020,"actblue","Personal : Miscellaneous","Personal","Miscellaneous","",$15.48,$0.00,-$4774.77
"Discover",,U,,10/02/2020,"redbox","Recreation : Entertainment","Recreation","Entertainment","",$6.15,$0.00,-$4780.92
"Discover",,U,,10/02/2020,"Primacare","Personal : Doctor, Dentist","Personal","Doctor, Dentist","",$15.00,$0.00,-$4795.92
"Discover",,U,,10/02/2020,"cvs","Personal : Prescriptions, Medicine","Personal","Prescriptions, Medicine","",$19.72,$0.00,-$4815.64
"Discover",,U,,10/02/2020,"chipolte","Food : Restaurants","Food","Restaurants","",$29.32,$0.00,-$4844.96
"Discover",,U,,10/02/2020,"CTS HYANNIS","Personal : Gifts","Personal","Gifts","",$64.84,$0.00,-$4909.80
"Discover",,U,,10/02/2020,"Windy Acres Koa","RV : Campgrounds","RV","Campgrounds","",$68.31,$0.00,-$4978.11
"Discover",,U,,10/02/2020,"Exxon mobile","RV : gasoline","RV","gasoline","",$100.00,$0.00,-$5078.11
"Discover",,U,,10/03/2020,"dunkin donuts","Food : Restaurants","Food","Restaurants","",$2.98,$0.00,-$5081.09
"Discover",,U,,10/03/2020,"Cumberland Farms","Transportation : Gas","Transportation","Gas","",$15.00,$0.00,-$5096.09
"Discover",,U,,10/03/2020,"Exxon mobile","Transportation : Gas","Transportation","Gas","",$16.02,$0.00,-$5112.11
"Discover",,U,,10/03/2020,"Sunshine and Pas","Food : Restaurants","Food","Restaurants","Meredith NH - omelettes when picking up new car.",$32.52,$0.00,-$5144.63
"Discover",,U,,10/03/2020,"atkins Farm","Food : Restaurants","Food","Restaurants","",$34.58,$0.00,-$5179.21
"Discover",,U,,10/03/2020,"Windy Acres Koa","RV : Campgrounds","RV","Campgrounds","",$68.31,$0.00,-$5247.52
"Discover",,U,,10/04/2020,"Outlook Farm","Food : Restaurants","Food","Restaurants","",$18.65,$0.00,-$5266.17
"Discover",,U,,10/04/2020,"actblue","Personal : Miscellaneous","Personal","Miscellaneous","",$25.00,$0.00,-$5291.17
"Discover",,U,,10/04/2020,"actblue","Personal : Miscellaneous","Personal","Miscellaneous","",$25.00,$0.00,-$5316.17
"Discover",,U,,10/04/2020,"actblue","Personal : Miscellaneous","Personal","Miscellaneous","",$26.00,$0.00,-$5342.17
"Discover",,U,,10/04/2020,"Outlook Farm","Food : Restaurants","Food","Restaurants","",$28.15,$0.00,-$5370.32
"Discover",,U,,10/04/2020,"Amazon","RV : Equipment/Supplies","RV","Equipment/Supplies","",$48.85,$0.00,-$5419.17
"Discover",,U,,10/04/2020,"Exxon mobile","RV : gasoline","RV","gasoline","",$100.00,$0.00,-$5519.17
"Discover",,U,,10/07/2020,"Transfer : Dcu Checking",,,,"",$0.00,$2749.89,-$2769.28
"Discover",,U,,10/07/2020,"star laundry","RV : Laundry","RV","Laundry","",$5.50,$0.00,-$2774.78
"Discover",,U,,10/07/2020,"star laundry","RV : Laundry","RV","Laundry","",$11.00,$0.00,-$2785.78
"Discover",,U,,10/08/2020,"Amazon","RV : Equipment/Supplies","RV","Equipment/Supplies","",$9.55,$0.00,-$2795.33
"Discover",,U,,10/08/2020,"cape ann campground","RV : Campgrounds","RV","Campgrounds","",$100.00,$0.00,-$2895.33
"Discover",,U,,10/08/2020,"Market bskt","Food : Groceries","Food","Groceries","",$102.70,$0.00,-$2998.03
"Discover",,U,,10/08/2020,"airbnb","Recreation : Hotel","Recreation","Hotel","",$1425.29,$0.00,-$4423.32
"Discover",,U,,10/09/2020,"Shell","Transportation : Gas","Transportation","Gas","",$18.60,$0.00,-$4441.92
"Discover",,U,,10/10/2020,"Sweet Water Forest Campground","RV : Campgrounds","RV","Campgrounds","",$26.74,$0.00,-$4468.66
"Discover",,U,,10/12/2020,"Amazon","RV : Equipment/Supplies","RV","Equipment/Supplies","",$38.35,$0.00,-$4507.01
"Discover",,U,,10/13/2020,"peterson market dennis","Food : Restaurants","Food","Restaurants","",$28.77,$0.00,-$4535.78
"Discover",,U,,10/14/2020,"Karoo","Food : Restaurants","Food","Restaurants","Eastham",$84.62,$0.00,-$4620.40
"Discover",,U,,10/14/2020,"stop & shop","Food : Groceries","Food","Groceries","",$150.20,$0.00,-$4770.60
"Discover",,U,,10/15/2020,"Amazon","RV : Equipment/Supplies","RV","Equipment/Supplies","",$10.41,$0.00,-$4781.01
"Discover",,U,,10/15/2020,"star laundry","RV : Laundry","RV","Laundry","",$11.00,$0.00,-$4792.01
"Discover",,U,,10/15/2020,"crocker nurseries","Personal : Gifts","Personal","Gifts","",$13.59,$0.00,-$4805.60
"Discover",,U,,10/15/2020,"actblue","Personal : Miscellaneous","Personal","Miscellaneous","",$25.00,$0.00,-$4830.60
"Discover",,U,,10/15/2020,"actblue","Personal : Miscellaneous","Personal","Miscellaneous","",$25.00,$0.00,-$4855.60
"Discover",,U,,10/15/2020,"actblue","Personal : Miscellaneous","Personal","Miscellaneous","",$25.00,$0.00,-$4880.60
"Discover",,U,,10/15/2020,"actblue","Personal : Miscellaneous","Personal","Miscellaneous","",$25.00,$0.00,-$4905.60
"Discover",,U,,10/15/2020,"Amazon","RV : Equipment/Supplies","RV","Equipment/Supplies","",$72.98,$0.00,-$4978.58
"Discover",,U,,10/16/2020,"gulf braga","Transportation : Gas","Transportation","Gas","",$19.92,$0.00,-$4998.50
"Discover",,U,,10/16/2020,"cape ann campground","RV : Campgrounds","RV","Campgrounds","",$40.00,$0.00,-$5038.50
"Discover",,U,,10/17/2020,"itunes","Recreation : Entertainment","Recreation","Entertainment","",$0.99,$0.00,-$5039.49
"Discover",,U,,10/17/2020,"Holycow icecream","Food : Restaurants","Food","Restaurants","ice cream glouceser",$30.62,$0.00,-$5070.11
"Discover",,U,,10/18/2020,"speedway","RV : gasoline","RV","gasoline","Peabody",$88.54,$0.00,-$5158.65
"Discover",,U,,10/19/2020,"chick-fil-a","Food : Restaurants","Food","Restaurants","",$6.52,$0.00,-$5165.17
"Discover",,U,,10/19/2020,"RMV Services","RV : MISC","RV","MISC","registration",$50.00,$0.00,-$5215.17
"Discover",,U,,10/20/2020,"Cts Store orleans","Personal : Miscellaneous","Personal","Miscellaneous","",$14.51,$0.00,-$5229.68
"Discover",,U,,10/20/2020,"shaw's Market","Food : Groceries","Food","Groceries","",$21.16,$0.00,-$5250.84
"Discover",,U,,10/20/2020,"actblue","Personal : Miscellaneous","Personal","Miscellaneous","Joe Biden",$25.00,$0.00,-$5275.84
"Discover",,U,,10/20/2020,"actblue","Personal : Miscellaneous","Personal","Miscellaneous","Sara Gideon",$25.00,$0.00,-$5300.84
"Discover",,U,,10/20/2020,"actblue","Personal : Miscellaneous","Personal","Miscellaneous","Thereas Greenfield",$25.00,$0.00,-$5325.84
"Discover",,U,,10/20/2020,"stop & shop","Food : Groceries","Food","Groceries","",$113.70,$0.00,-$5439.54
"Discover",,U,,10/20/2020,"GH Bass","Personal : cloths","Personal","cloths","winter jackets etc",$148.50,$0.00,-$5588.04
"Discover",,U,,10/21/2020,"Nytimes","Recreation : Entertainment","Recreation","Entertainment","",$4.00,$0.00,-$5592.04
"Discover",,U,,10/21/2020,"MacCarther Farm","Food : Groceries","Food","Groceries","",$9.00,$0.00,-$5601.04
"Discover",,U,,10/21/2020,"Shell","Transportation : Gas","Transportation","Gas","",$18.26,$0.00,-$5619.30
"Discover",,U,,10/21/2020,"Delfino","Food : Restaurants","Food","Restaurants","Lisa Birthday with Mary and Karina",$167.34,$0.00,-$5786.64
"Discover",,U,,10/22/2020,"actblue","Personal : Miscellaneous","Personal","Miscellaneous","ossoff",$5.00,$0.00,-$5791.64
"Discover",,U,,10/22/2020,"actblue","Personal : Miscellaneous","Personal","Miscellaneous","Gdieon",$10.00,$0.00,-$5801.64
"Discover",,U,,10/22/2020,"cvs","Personal : Miscellaneous","Personal","Miscellaneous","",$11.99,$0.00,-$5813.63
"Discover",,U,,10/22/2020,"actblue","Personal : Miscellaneous","Personal","Miscellaneous","biden",$15.00,$0.00,-$5828.63
"Discover",,U,,10/22/2020,"actblue","Personal : Miscellaneous","Personal","Miscellaneous","bullock",$15.00,$0.00,-$5843.63
"Discover",,U,,10/22/2020,"actblue","Personal : Miscellaneous","Personal","Miscellaneous","warnock",$15.00,$0.00,-$5858.63
"Discover",,U,,10/22/2020,"cvs","Personal : Prescriptions, Medicine","Personal","Prescriptions, Medicine","",$20.00,$0.00,-$5878.63
"Discover",,U,,10/22/2020,"cape abilities","Personal : cloths","Personal","cloths","",$32.92,$0.00,-$5911.55
"Discover",,U,,10/22/2020,"APT","Food : Restaurants","Food","Restaurants","Lisa BD",$124.00,$0.00,-$6035.55
"Discover",,U,,10/24/2020,"actblue","Personal : Miscellaneous","Personal","Miscellaneous","Greenfield",$10.00,$0.00,-$6045.55
"Discover",,U,,10/24/2020,"actblue","Personal : Miscellaneous","Personal","Miscellaneous","harrison",$10.00,$0.00,-$6055.55
"Discover",,U,,10/24/2020,"actblue","Personal : Miscellaneous","Personal","Miscellaneous","Jones",$10.00,$0.00,-$6065.55
"Discover",,U,,10/25/2020,"gulf","Transportation : Gas","Transportation","Gas","weymouth",$19.00,$0.00,-$6084.55
"Discover",,U,,10/25/2020,"cvs","Personal : Prescriptions, Medicine","Personal","Prescriptions, Medicine","",$20.00,$0.00,-$6104.55
"Discover",,U,,10/25/2020,"cvs","Personal : Prescriptions, Medicine","Personal","Prescriptions, Medicine","",$20.00,$0.00,-$6124.55
"Discover",,U,,10/27/2020,"McDonalds","Food : Restaurants","Food","Restaurants","",$12.60,$0.00,-$6137.15
"Discover",,U,,10/27/2020,"speedway","Transportation : Gas","Transportation","Gas","Worcester",$18.56,$0.00,-$6155.71
"Discover",,U,,10/27/2020,"actblue","Personal : Miscellaneous","Personal","Miscellaneous","",$25.00,$0.00,-$6180.71
"Discover",,U,,10/27/2020,"Vinas Pizzeria","Food : Restaurants","Food","Restaurants","Takeout at Neil and Anns house",$37.19,$0.00,-$6217.90
"Discover",,U,,10/28/2020,"walgreens","RV : Equipment/Supplies","RV","Equipment/Supplies","",$19.10,$0.00,-$6237.00
"Discover",,U,,10/29/2020,"itunes","Recreation : Entertainment","Recreation","Entertainment","",$2.99,$0.00,-$6239.99
"Discover",,U,,10/29/2020,"actblue","Personal : Miscellaneous","Personal","Miscellaneous","",$5.00,$0.00,-$6244.99
"Discover",,U,,10/31/2020,"CTS HYANNIS","Personal : Gifts","Personal","Gifts","",$11.98,$0.00,-$6256.97
"Discover",,U,,10/31/2020,"Amazon MktPlace","RV : Equipment/Supplies","RV","Equipment/Supplies","Mouse traps etc.",$116.90,$0.00,-$6373.87
"Discover",,U,,10/31/2020,"trader Joes","Food : Groceries","Food","Groceries","Hyannis",$242.83,$0.00,-$6616.70
"Discover",,U,,11/01/2020,"actblue","Personal : Miscellaneous","Personal","Miscellaneous","",$4.17,$0.00,-$6620.87
"Discover",,U,,11/01/2020,"actblue","Personal : Miscellaneous","Personal","Miscellaneous","",$4.17,$0.00,-$6625.04
"Discover",,U,,11/01/2020,"actblue","Personal : Miscellaneous","Personal","Miscellaneous","",$5.17,$0.00,-$6630.21
"Discover",,U,,11/01/2020,"actblue","Personal : Miscellaneous","Personal","Miscellaneous","",$15.00,$0.00,-$6645.21
"Discover",,U,,11/01/2020,"actblue","Personal : Miscellaneous","Personal","Miscellaneous","",$15.00,$0.00,-$6660.21
"Discover",,U,,11/01/2020,"Shell","Transportation : Gas","Transportation","Gas","Dennis",$19.16,$0.00,-$6679.37
"Discover",,U,,11/03/2020,"chipolte","Food : Restaurants","Food","Restaurants","takeout at Neil and Anns",$29.21,$0.00,-$6708.58
"Discover",,U,,11/04/2020,"Chez siam","Food : Restaurants","Food","Restaurants","",$64.15,$0.00,-$6772.73
"Discover",,U,,11/05/2020,"Shell","Transportation : Gas","Transportation","Gas","",$19.11,$0.00,-$6791.84
"Discover",,U,,11/05/2020,"Walmart","RV : Equipment/Supplies","RV","Equipment/Supplies","",$107.83,$0.00,-$6899.67
"Discover",,U,,11/06/2020,"Transfer : Dcu Checking",,,,"",$0.00,$4333.14,-$2566.53
"Discover",,U,,11/06/2020,"Common man","Food : Restaurants","Food","Restaurants","Food again on trip to get car",$4.09,$0.00,-$2570.62
"Discover",,U,,11/06/2020,"Common man","Food : Restaurants","Food","Restaurants","NH rest stop",$10.36,$0.00,-$2580.98
"Discover",,U,,11/06/2020,"Exxon mobile","Transportation : Gas","Transportation","Gas","New Hampton NH",$16.02,$0.00,-$2597.00
"Discover",,U,,11/06/2020,"Exxon mobile","Transportation : Gas","Transportation","Gas","New Hampthon NH - gassed up both cars",$20.81,$0.00,-$2617.81
"Discover",,U,,11/06/2020,"Ancha rest","Food : Restaurants","Food","Restaurants","Lisa and Alyssa",$34.91,$0.00,-$2652.72
"Discover",,U,,11/06/2020,"Primark","Personal : cloths","Personal","cloths","Braintree",$71.56,$0.00,-$2724.28
"Discover",,U,,11/07/2020,"redbox","Recreation : Entertainment","Recreation","Entertainment","Rent and buy",$5.09,$0.00,-$2729.37
"Discover",,U,,11/07/2020,"CTS HYANNIS","Personal : Gifts","Personal","Gifts","",$43.20,$0.00,-$2772.57
"Discover",,U,,11/08/2020,"speedway","Transportation : Gas","Transportation","Gas","",$16.49,$0.00,-$2789.06
"Discover",,U,,11/08/2020,"Market bskt","Food : Groceries","Food","Groceries","",$36.15,$0.00,-$2825.21
"Discover",,U,,11/09/2020,"7-11 eastham","Transportation : Gas","Transportation","Gas","",$30.49,$0.00,-$2855.70
"Discover",,U,,11/09/2020,"big lots","RV : Equipment/Supplies","RV","Equipment/Supplies","",$42.50,$0.00,-$2898.20
"Discover",,U,,11/11/2020,"Primacare","Personal : Doctor, Dentist","Personal","Doctor, Dentist","",$26.00,$0.00,-$2924.20
"Discover",,U,,11/11/2020,"Safety Insurance","Transportation : Car Insurance","Transportation","Car Insurance","",$483.95,$0.00,-$3408.15
"Discover",,U,,11/12/2020,"Star","Food : Groceries","Food","Groceries","Harwich Ma",$52.16,$0.00,-$3460.31
"Discover",,U,,11/13/2020,"cvs","Personal : Prescriptions, Medicine","Personal","Prescriptions, Medicine","",$1.69,$0.00,-$3462.00
"Discover",,U,,11/13/2020,"speedway","Transportation : Gas","Transportation","Gas","",$28.19,$0.00,-$3490.19
"Discover",,U,,11/13/2020,"Baskin's Hardware","RV : Equipment/Supplies","RV","Equipment/Supplies","",$39.50,$0.00,-$3529.69
"Discover",,U,,11/15/2020,"stop & shop","Food : Groceries","Food","Groceries","",$2.00,$0.00,-$3531.69
"Discover",,U,,11/15/2020,"netflix","Recreation : Entertainment","Recreation","Entertainment","",$13.99,$0.00,-$3545.68
"Discover",,U,,11/15/2020,"Walmart","Food : Groceries","Food","Groceries","",$192.37,$0.00,-$3738.05
"Discover",,U,,11/16/2020,"pizza shark","Food : Restaurants","Food","Restaurants","",$23.18,$0.00,-$3761.23
"Discover",,U,,11/17/2020,"Amazon","RV : Equipment/Supplies","RV","Equipment/Supplies","",$12.53,$0.00,-$3773.76
"Discover",,U,,11/17/2020,"Amazon","RV : Equipment/Supplies","RV","Equipment/Supplies","",$41.62,$0.00,-$3815.38
"Discover",,U,,11/18/2020,"Nytimes","Recreation : Entertainment","Recreation","Entertainment","",$4.00,$0.00,-$3819.38
"Discover",,U,,11/18/2020,"stop & shop","Food : Groceries","Food","Groceries","",$87.00,$0.00,-$3906.38
"Discover",,U,,11/19/2020,"Gas","Transportation : Gas","Transportation","Gas","",$27.16,$0.00,-$3933.54
"Discover",,U,,11/20/2020,"itunes","Recreation : Entertainment","Recreation","Entertainment","",$0.99,$0.00,-$3934.53
"Discover",,U,,11/20/2020,"Amazon","Personal : Gifts","Personal","Gifts","",$14.68,$0.00,-$3949.21
"Discover",,U,,11/22/2020,"etsy brooklyn","Personal : Gifts","Personal","Gifts","",$61.20,$0.00,-$4010.41
"Discover",,U,,11/23/2020,"stop & shop","Food : Groceries","Food","Groceries","Peapod pickup",$144.92,$0.00,-$4155.33
"Discover",,U,,11/24/2020,"Newbury Comics","Personal : Gifts","Personal","Gifts","",$18.05,$0.00,-$4173.38
"Discover",,U,,11/24/2020,"tjmaxx","Personal : cloths","Personal","cloths","",$35.54,$0.00,-$4208.92
"Discover",,U,,11/24/2020,"Barnes and Noble","Personal : Gifts","Personal","Gifts","",$62.65,$0.00,-$4271.57
"Discover",,U,,11/24/2020,"Marshall's","Personal : Gifts","Personal","Gifts","(Split 1/2) ",$90.00,$0.00,-$4456.59
"Discover",,U,,11/24/2020,"Marshall's","Personal : cloths","Personal","cloths","(Split 2/2) ",$95.02,$0.00,-$4456.59
"Discover",,U,,11/27/2020,"USPS","RV : Equipment/Supplies","RV","Equipment/Supplies","stamps",$11.00,$0.00,-$4467.59
"Discover",,U,,11/27/2020,"stop & shop","Food : Groceries","Food","Groceries","",$50.14,$0.00,-$4517.73
"Discover",,U,,11/29/2020,"itunes","Recreation : Entertainment","Recreation","Entertainment","",$2.99,$0.00,-$4520.72
"Discover",,U,,11/29/2020,"cvs","Personal : Prescriptions, Medicine","Personal","Prescriptions, Medicine","",$29.71,$0.00,-$4550.43
"Discover",,U,,11/30/2020,"Gas","Transportation : Gas","Transportation","Gas","",$15.89,$0.00,-$4566.32
"Discover",,U,,11/30/2020,"savers marlboro","Personal : cloths","Personal","cloths","",$24.46,$0.00,-$4590.78
"Discover",,U,,11/30/2020,"Marshall's","Personal : Gifts","Personal","Gifts","",$31.85,$0.00,-$4622.63
"Discover",,U,,11/30/2020,"hannaford","Food : Groceries","Food","Groceries","",$32.44,$0.00,-$4655.07
"Discover",,U,,12/01/2020,"SP shark robot","Personal : Gifts","Personal","Gifts","",$14.57,$0.00,-$4669.64
"Discover",,U,,12/01/2020,"Teeturtle","Personal : Gifts","Personal","Gifts","",$15.95,$0.00,-$4685.59
"Discover",,U,,12/01/2020,"cvs","Personal : Prescriptions, Medicine","Personal","Prescriptions, Medicine","",$20.00,$0.00,-$4705.59
"Discover",,U,,12/01/2020,"Bellzi","Personal : Gifts","Personal","Gifts","",$45.00,$0.00,-$4750.59
"Discover",,U,,12/01/2020,"Harry Potter shop","Personal : Gifts","Personal","Gifts","",$61.06,$0.00,-$4811.65
"Discover",,U,,12/01/2020,"Ravello Italian","Food : Restaurants","Food","Restaurants","ALyssa Birthday takeout",$111.65,$0.00,-$4923.30
"Discover",,U,,12/02/2020,"speedway","Transportation : Gas","Transportation","Gas","",$19.71,$0.00,-$4943.01
"Discover",,U,,12/02/2020,"Amazon","Personal : Gifts","Personal","Gifts",,$21.03,$0.00,-$4964.04
"Discover",,U,,12/03/2020,"capecode filling","Transportation : Gas","Transportation","Gas","",$13.30,$0.00,-$4977.34
"Discover",,U,,12/03/2020,"Allergy and Asma","Personal : Doctor, Dentist","Personal","Doctor, Dentist","",$18.00,$0.00,-$4995.34
"Discover",,U,,12/03/2020,"Amazon","Personal : Gifts","Personal","Gifts","",$23.35,$0.00,-$5018.69
"Discover",,U,,12/03/2020,"wordpress","Recreation : Entertainment","Recreation","Entertainment","",$69.00,$0.00,-$5087.69
"Discover",,U,,12/04/2020,"Amazon","Personal : Gifts","Personal","Gifts","",$15.93,$0.00,-$5103.62
"Discover",,U,,12/04/2020,"Amazon","Personal : Gifts","Personal","Gifts","",$40.36,$0.00,-$5143.98
"Discover",,U,,12/05/2020,"airbnb","Recreation : Hotel","Recreation","Hotel","",$1472.80,$0.00,-$6616.78
"Discover",,U,,12/06/2020,"Market bskt","Food : Groceries","Food","Groceries","",$243.70,$0.00,-$6860.48
"Discover",,U,,12/07/2020,"Transfer : Dcu Checking",,,,"",$0.00,$3408.15,-$3452.33
"Discover",,U,,12/08/2020,"WESTFORD DERMERTOLOGY","Personal : Doctor, Dentist","Personal","Doctor, Dentist","",$18.00,$0.00,-$3470.33
"Discover",,U,,12/08/2020,"pressed cafe","Food : Restaurants","Food","Restaurants","",$29.95,$0.00,-$3500.28
"Discover",,U,,12/08/2020,"Shell","Transportation : Gas","Transportation","Gas","",$30.39,$0.00,-$3530.67
"Discover",,U,,12/08/2020,"Amazon","Personal : Gifts","Personal","Gifts","",$31.90,$0.00,-$3562.57
"Discover",,U,,12/08/2020,"trader Joes","Food : Groceries","Food","Groceries","",$163.50,$0.00,-$3726.07
"Discover",,U,,12/09/2020,"actblue","Personal : Miscellaneous","Personal","Miscellaneous","",$10.00,$0.00,-$3736.07
"Discover",,U,,12/09/2020,"actblue","Personal : Miscellaneous","Personal","Miscellaneous","",$10.00,$0.00,-$3746.07
"Discover",,U,,12/09/2020,"Amazon","Personal : Gifts","Personal","Gifts","",$53.11,$0.00,-$3799.18
"Discover",,U,,12/09/2020,"Amazon","Personal : Gifts","Personal","Gifts","",$74.49,$0.00,-$3873.67
"Discover",,U,,12/09/2020,"Amazon","Personal : Gifts","Personal","Gifts","",$264.98,$0.00,-$4138.65
"Discover",,U,,12/10/2020,"dollar tree","Personal : Gifts","Personal","Gifts","",$4.25,$0.00,-$4142.90
"Discover",,U,,12/10/2020,"speedway","Transportation : Gas","Transportation","Gas","",$25.32,$0.00,-$4168.22
"Discover",,U,,12/10/2020,"Ocean State Joblot","Personal : Gifts","Personal","Gifts","",$74.80,$0.00,-$4243.02
"Discover",,U,,12/10/2020,"stop & shop","Food : Groceries","Food","Groceries","",$105.48,$0.00,-$4348.50
"Discover",,U,,12/11/2020,"USPS","RV : Equipment/Supplies","RV","Equipment/Supplies","",$13.65,$0.00,-$4362.15
"Discover",,U,,12/11/2020,"LLBE AN DIRECT","Personal : cloths","Personal","cloths",,$79.00,$0.00,-$4441.15
"Discover",,U,,12/14/2020,"the market pinehills","Food : Groceries","Food","Groceries","",$12.73,$0.00,-$4453.88
"Discover",,U,,12/14/2020,"pinehillls postoffice","Personal : Gifts","Personal","Gifts","shipping?",$14.95,$0.00,-$4468.83
"Discover",,U,,12/14/2020,"Amazon","Recreation : Hers","Recreation","Hers","gifts lisa",$222.06,$0.00,-$4690.89
"Discover",,U,,12/15/2020,"netflix","Recreation : Entertainment","Recreation","Entertainment","",$13.99,$0.00,-$4704.88
"Discover",,U,,12/15/2020,"actblue","Personal : Miscellaneous","Personal","Miscellaneous","",$25.00,$0.00,-$4729.88
"Discover",,U,,12/15/2020,"Amazon","Personal : Gifts","Personal","Gifts","",$41.29,$0.00,-$4771.17
"Discover",,U,,12/16/2020,"Marshall's","Personal : Gifts","Personal","Gifts","",$0.00,$35.04,-$4736.13
"Discover",,U,,12/16/2020,"itunes","Recreation : Entertainment","Recreation","Entertainment","",$0.99,$0.00,-$4737.12
"Discover",,U,,12/16/2020,"Nytimes","Recreation : Entertainment","Recreation","Entertainment","",$4.00,$0.00,-$4741.12
"Discover",,U,,12/16/2020,"actblue","Personal : Miscellaneous","Personal","Miscellaneous","",$10.00,$0.00,-$4751.12
"Discover",,U,,12/16/2020,"actblue","Personal : Miscellaneous","Personal","Miscellaneous","",$10.00,$0.00,-$4761.12
"Discover",,U,,12/16/2020,"Exxon mobile","Transportation : Gas","Transportation","Gas","",$28.22,$0.00,-$4789.34
"Discover",,U,,12/16/2020,"peterson market dennis","Food : Groceries","Food","Groceries","",$39.87,$0.00,-$4829.21
"Discover",,U,,12/16/2020,"cvs","Personal : Prescriptions, Medicine","Personal","Prescriptions, Medicine","",$39.94,$0.00,-$4869.15
"Discover",,U,,12/16/2020,"Best Buy","Personal : Gifts","Personal","Gifts","",$79.68,$0.00,-$4948.83
"Discover",,U,,12/18/2020,"Amazon","Personal : Gifts","Personal","Gifts","",$15.13,$0.00,-$4963.96
"Discover",,U,,12/18/2020,"Amazon","Personal : Gifts","Personal","Gifts","",$20.49,$0.00,-$4984.45
"Discover",,U,,12/19/2020,"sq cell","Personal : Miscellaneous","Personal","Miscellaneous","Get Lisa PC lookd at",$34.50,$0.00,-$5018.95
"Discover",,U,,12/21/2020,"Amazon","Personal : Gifts","Personal","Gifts","",$16.18,$0.00,-$5035.13
"Discover",,U,,12/21/2020,"Amazon","Personal : Gifts","Personal","Gifts","",$17.31,$0.00,-$5052.44
"Discover",,U,,12/21/2020,"cvs","Personal : Gifts","Personal","Gifts","",$59.47,$0.00,-$5111.91
"Discover",,U,,12/22/2020,"CTS HYANNIS","Personal : Gifts","Personal","Gifts","",$16.09,$0.00,-$5128.00
"Discover",,U,,12/22/2020,"cvs","Personal : Prescriptions, Medicine","Personal","Prescriptions, Medicine","",$20.53,$0.00,-$5148.53
"Discover",,U,,12/22/2020,"cvs","Personal : Gifts","Personal","Gifts","",$104.16,$0.00,-$5252.69
"Discover",,U,,12/22/2020,"stop & shop","Food : Groceries","Food","Groceries","",$254.46,$0.00,-$5507.15
"Discover",,U,,12/23/2020,"actblue","Personal : Miscellaneous","Personal","Miscellaneous","",$10.00,$0.00,-$5517.15
"Discover",,U,,12/23/2020,"actblue","Personal : Miscellaneous","Personal","Miscellaneous","",$10.00,$0.00,-$5527.15
"Discover",,U,,12/24/2020,"Sunoco","Transportation : Gas","Transportation","Gas","",$30.59,$0.00,-$5557.74
"Discover",,U,,12/24/2020,"american canser","Charity : Other","Charity","Other","",$75.00,$0.00,-$5632.74
"Discover",,U,,12/27/2020,"great call","Financial Help : Mom And Dad","Financial Help","Mom And Dad","",$36.49,$0.00,-$5669.23
"Discover",,U,,12/27/2020,"great call","Financial Help : Mom And Dad","Financial Help","Mom And Dad","",$40.93,$0.00,-$5710.16
"Discover",,U,,12/29/2020,"itunes","Recreation : Entertainment","Recreation","Entertainment","",$2.99,$0.00,-$5713.15
"Discover",,U,,12/29/2020,"cvs","Personal : Prescriptions, Medicine","Personal","Prescriptions, Medicine","",$20.00,$0.00,-$5733.15
"Discover",,U,,12/30/2020,"cvs","Personal : Prescriptions, Medicine","Personal","Prescriptions, Medicine","",$8.86,$0.00,-$5742.01
"Discover",,U,,12/30/2020,"actblue","Personal : Miscellaneous","Personal","Miscellaneous",,$10.00,$0.00,-$5752.01
"Discover",,U,,12/30/2020,"actblue","Personal : Miscellaneous","Personal","Miscellaneous","",$10.00,$0.00,-$5762.01
"Discover",,U,,12/30/2020,"cvs","Personal : Prescriptions, Medicine","Personal","Prescriptions, Medicine","",$25.43,$0.00,-$5787.44
"Discover",,U,,12/30/2020,"Sunoco","Transportation : Gas","Transportation","Gas","",$30.96,$0.00,-$5818.40
"Discover",,U,,12/30/2020,"TUk Tuk Thai","Food : Restaurants","Food","Restaurants","",$46.08,$0.00,-$5864.48
"Discover",,U,,12/30/2020,"zenni","Personal : Doctor, Dentist","Personal","Doctor, Dentist","",$130.80,$0.00,-$5995.28
"Discover",,U,,01/04/2021,"Amazon","Recreation : Entertainment","Recreation","Entertainment","",$33.98,$0.00,-$6029.26
"Discover",,U,,01/05/2021,"speedway","Transportation : Gas","Transportation","Gas","",$29.05,$0.00,-$6058.31
"Discover",,U,,01/07/2021,"Transfer : Dcu Checking",,,,"",$0.00,$4362.15,-$1696.16
"Discover",,U,,01/07/2021,"chipolte","Food : Restaurants","Food","Restaurants","",$27.00,$0.00,-$1723.16
"Discover",,U,,01/07/2021,"linguines","Food : Restaurants","Food","Restaurants","",$27.71,$0.00,-$1750.87
"Discover",,U,,01/07/2021,"Thairiffic","Food : Restaurants","Food","Restaurants","",$37.24,$0.00,-$1788.11
"Discover",,U,,01/08/2021,"Village cafe","Food : Restaurants","Food","Restaurants","",$19.15,$0.00,-$1807.26
"Discover",,U,,01/08/2021,"sunoco plymouth","Transportation : Gas","Transportation","Gas","",$30.77,$0.00,-$1838.03
"Discover",,U,,01/09/2021,"cvs","Personal : Prescriptions, Medicine","Personal","Prescriptions, Medicine","",$34.34,$0.00,-$1872.37
"Discover",,U,,01/09/2021,"stop & shop","Food : Groceries","Food","Groceries","",$62.46,$0.00,-$1934.83
"Discover",,U,,01/09/2021,"cvs","RV : Equipment/Supplies","RV","Equipment/Supplies","",$68.06,$0.00,-$2002.89
"Discover",,U,,01/10/2021,"Tufts ebill","Personal : Doctor, Dentist","Personal","Doctor, Dentist","",$18.00,$0.00,-$2020.89
"Discover",,U,,01/10/2021,"Woods seafood","Food : Restaurants","Food","Restaurants","walk with karina and mary",$75.29,$0.00,-$2096.18
"Discover",,U,,01/12/2021,"exxon wareham","Transportation : Gas","Transportation","Gas","",$25.13,$0.00,-$2121.31
"Discover",,U,,01/13/2021,"Nytimes","Recreation : Entertainment","Recreation","Entertainment","",$4.00,$0.00,-$2125.31
"Discover",,U,,01/13/2021,"slice","Food : Restaurants","Food","Restaurants","I think this is village cafe in Berline - verify",$32.89,$0.00,-$2158.20
"Discover",,U,,01/13/2021,"stop & shop","Food : Groceries","Food","Groceries","",$143.60,$0.00,-$2301.80
"Discover",,U,,01/15/2021,"netflix","Recreation : Entertainment","Recreation","Entertainment","",$13.99,$0.00,-$2315.79
"Discover",,U,,01/15/2021,"caringbridge","Charity : Other","Charity","Other","",$25.00,$0.00,-$2340.79
"Discover",,U,,01/16/2021,"itunes","Recreation : Entertainment","Recreation","Entertainment","",$0.99,$0.00,-$2341.78
"Discover",,U,,01/22/2021,"CAPE COD HOSPITIAL","Personal : Prescriptions, Medicine","Personal","Prescriptions, Medicine","",$18.00,$0.00,-$2359.78
"Discover",,U,,01/22/2021,"Trombetta","Personal : Gifts","Personal","Gifts","",$52.35,$0.00,-$2412.13
"Discover",,U,,01/22/2021,"Kindles","Food : Restaurants","Food","Restaurants","",$55.87,$0.00,-$2468.00
"Discover",,U,,01/23/2021,"exxom berlin","Transportation : Gas","Transportation","Gas","",$29.48,$0.00,-$2497.48
"Discover",,U,,01/23/2021,"Roche Brothers","Food : Groceries","Food","Groceries","",$126.50,$0.00,-$2623.98
"Discover",,U,,01/26/2021,"Amazon","Recreation : Entertainment","Recreation","Entertainment","",$8.87,$0.00,-$2632.85
"Discover",,U,,01/26/2021,"Cumberland Farms","Transportation : Gas","Transportation","Gas","",$26.90,$0.00,-$2659.75
"Discover",,U,,01/27/2021,"fax","Personal : Doctor, Dentist","Personal","Doctor, Dentist","fax medical stuff",$1.06,$0.00,-$2660.81
"Discover",,U,,01/27/2021,"Amazon","Personal : Gifts","Personal","Gifts","",$41.43,$0.00,-$2702.24
"Discover",,U,,01/27/2021,"Street kitchen","Food : Restaurants","Food","Restaurants","",$44.48,$0.00,-$2746.72
"Discover",,U,,01/28/2021,"great call","Financial Help : Mom And Dad","Financial Help","Mom And Dad","",$26.87,$0.00,-$2773.59
"Discover",,U,,01/28/2021,"Amazon","RV : Equipment/Supplies","RV","Equipment/Supplies","",$42.84,$0.00,-$2816.43
"Discover",,U,,01/28/2021,"dunkin donuts","Personal : Gifts","Personal","Gifts","",$50.00,$0.00,-$2866.43
"Discover",,U,,01/29/2021,"itunes","Recreation : Entertainment","Recreation","Entertainment","",$2.99,$0.00,-$2869.42
"Discover",,U,,02/01/2021,"gofundme","Charity : Other","Charity","Other","DR ARNOLD PATIENT COVID VICTON",$16.88,$0.00,-$2886.30
"Discover",,U,,02/01/2021,"cvs","Personal : Prescriptions, Medicine","Personal","Prescriptions, Medicine","",$20.00,$0.00,-$2906.30
"Discover",,U,,02/02/2021,"chipolte","Food : Restaurants","Food","Restaurants","",$21.35,$0.00,-$2927.65
"Discover",,U,,02/02/2021,"grubhub","Food : Restaurants","Food","Restaurants","",$52.45,$0.00,-$2980.10
"Discover",,U,,02/02/2021,"in at longwood","Recreation : Hotel","Recreation","Hotel","FOR dr visit in Boston",$207.77,$0.00,-$3187.87
"Discover",,U,,02/03/2021,"discount gas marlboro","Transportation : Gas","Transportation","Gas","",$23.69,$0.00,-$3211.56
"Discover",,U,,02/03/2021,"Kindles Pizza","Food : Restaurants","Food","Restaurants",,$37.58,$0.00,-$3249.14
"Discover",,U,,02/03/2021,"stop & shop","Food : Groceries","Food","Groceries","",$185.01,$0.00,-$3434.15
"Discover",,U,,02/03/2021,"northborouhg dental associates","Personal : Doctor, Dentist","Personal","Doctor, Dentist","",$477.00,$0.00,-$3911.15
"Discover",,U,,02/04/2021,"stop & shop","Food : Groceries","Food","Groceries","",$0.00,$4.19,-$3906.96
"Discover",,U,,02/04/2021,"savers Framingham","Personal : cloths","Personal","cloths","",$22.97,$0.00,-$3929.93
"Discover",,U,,02/04/2021,"Marlboro dental","Personal : Doctor, Dentist","Personal","Doctor, Dentist","",$225.00,$0.00,-$4154.93
"Discover",,U,,02/04/2021,"target","Personal : cloths","Personal","cloths","",$322.65,$0.00,-$4477.58
"Discover",,U,,02/05/2021,"CAPE COD HOSPITIAL","Personal : Doctor, Dentist","Personal","Doctor, Dentist","",$10.00,$0.00,-$4487.58
"Discover",,U,,02/05/2021,"Roche Brothers","Food : Groceries","Food","Groceries","",$134.57,$0.00,-$4622.15
"Discover",,U,,02/06/2021,"Transfer : Dcu Checking",,,,"",$0.00,$2096.18,-$2525.97
"Discover",,U,,02/06/2021,"target","Personal : cloths","Personal","cloths","",$0.00,$60.00,-$2465.97
"Discover",,U,,02/08/2021,"cashback","Income : Available this month","Income","Available this month","",$0.00,$2341.62,-$124.35
"Discover",,U,,02/08/2021,"Thai tamarind westboro","Food : Restaurants","Food","Restaurants",,$77.54,$0.00,-$201.89
"Discover",,U,,02/08/2021,"lls","Charity : Other","Charity","Other","",$100.00,$0.00,-$301.89
"Discover",,U,,02/09/2021,"shell Berlin","Transportation : Gas","Transportation","Gas","",$31.16,$0.00,-$333.05
"Discover",,U,,02/10/2021,"Nytimes","Recreation : Entertainment","Recreation","Entertainment","",$4.00,$0.00,-$337.05
"Discover",,U,,02/10/2021,"chick-fil-a","Food : Restaurants","Food","Restaurants","",$23.35,$0.00,-$360.40
"Discover",,U,,02/11/2021,"Tst Fishermen","Food : Restaurants","Food","Restaurants","",$19.18,$0.00,-$379.58
"Discover",,U,,02/12/2021,"shell Berlin","Transportation : Gas","Transportation","Gas","",$28.83,$0.00,-$408.41
"Discover",,U,,02/12/2021,"cafe chew","Food : Restaurants","Food","Restaurants","",$37.88,$0.00,-$446.29
"Discover",,U,,02/12/2021,"CTS HYANNIS","Personal : Gifts","Personal","Gifts","",$45.34,$0.00,-$491.63
"Discover",,U,,02/13/2021,"stop & shop","Food : Groceries","Food","Groceries","",$117.53,$0.00,-$609.16
"Discover",,U,,02/14/2021,"Sunoco","Transportation : Gas","Transportation","Gas","",$31.61,$0.00,-$640.77
"Discover",,U,,02/15/2021,"star market","Food : Groceries","Food","Groceries","",$8.56,$0.00,-$649.33
"Discover",,U,,02/15/2021,"netflix","Recreation : Entertainment","Recreation","Entertainment","",$13.99,$0.00,-$663.32
"Discover",,U,,02/15/2021,"cvs","Personal : Prescriptions, Medicine","Personal","Prescriptions, Medicine","",$14.05,$0.00,-$677.37
"Discover",,U,,02/15/2021,"caringbridge","Charity : Other","Charity","Other","",$25.00,$0.00,-$702.37
"Discover",,U,,02/15/2021,"cornerstone health","Personal : Prescriptions, Medicine","Personal","Prescriptions, Medicine","",$40.00,$0.00,-$742.37
"Discover",,U,,02/17/2021,"bidmc","Lisa Business : Parking","Lisa Business","Parking","",$7.00,$0.00,-$749.37
"Discover",,U,,02/17/2021,"chipolte","Food : Restaurants","Food","Restaurants","",$15.09,$0.00,-$764.46
"Discover",,U,,02/17/2021,"bidmc","Personal : Doctor, Dentist","Personal","Doctor, Dentist","",$18.00,$0.00,-$782.46
"Discover",,U,,02/17/2021,"Sweetwater camground","RV : Campgrounds","RV","Campgrounds","",$228.00,$0.00,-$1010.46
"Discover",,U,,02/18/2021,"WESTFORD DERMERTOLOGY","Personal : Doctor, Dentist","Personal","Doctor, Dentist","",$18.00,$0.00,-$1028.46
"Discover",,U,,02/19/2021,"star market","Food : Groceries","Food","Groceries","",$8.04,$0.00,-$1036.50
"Discover",,U,,02/19/2021,"gulf mart","RV : gasoline","RV","gasoline","",$16.70,$0.00,-$1053.20
"Discover",,U,,02/19/2021,"hmpf hermatology","Personal : Doctor, Dentist","Personal","Doctor, Dentist","",$18.00,$0.00,-$1071.20
"Discover",,U,,02/19/2021,"chess.com","Recreation : Entertainment","Recreation","Entertainment","",$29.00,$0.00,-$1100.20
"Discover",,U,,02/19/2021,"target","Personal : cloths","Personal","cloths","",$30.00,$0.00,-$1130.20
"Discover",,U,,02/19/2021,"star market","Food : Groceries","Food","Groceries","",$43.30,$0.00,-$1173.50
"Discover",,U,,02/19/2021,"LLBean-Direct","Personal : cloths","Personal","cloths","",$59.99,$0.00,-$1233.49
"Discover",,U,,02/19/2021,"Apple Store","RV : Equipment/Supplies","RV","Equipment/Supplies","Lisa computer",$1486.44,$0.00,-$2719.93
"Discover",,U,,02/20/2021,"redbox","Recreation : Entertainment","Recreation","Entertainment","",$1.91,$0.00,-$2721.84
"Discover",,U,,02/20/2021,"cvs","Personal : Prescriptions, Medicine","Personal","Prescriptions, Medicine","",$18.79,$0.00,-$2740.63
"Discover",,U,,02/20/2021,"Tower hill botanic","Recreation : Entertainment","Recreation","Entertainment","",$125.00,$0.00,-$2865.63
"Discover",,U,,02/21/2021,"Hitch N Post","Personal : Gifts","Personal","Gifts","Ann and Neil RV stay - Partial payback for using their house",$6.19,$0.00,-$2871.82
"Discover",,U,,02/21/2021,"star market","Food : Groceries","Food","Groceries","",$12.41,$0.00,-$2884.23
"Discover",,U,,02/21/2021,"hannaford","Food : Groceries","Food","Groceries","",$14.24,$0.00,-$2898.47
"Discover",,U,,02/21/2021,"Amazon","RV : Equipment/Supplies","RV","Equipment/Supplies","",$20.18,$0.00,-$2918.65
"Discover",,U,,02/21/2021,"Shell","Transportation : Gas","Transportation","Gas","",$33.19,$0.00,-$2951.84
"Discover",,U,,02/21/2021,"Hitch N Post","Personal : Gifts","Personal","Gifts","Ann and neil RV stay",$612.81,$0.00,-$3564.65
"Discover",,U,,02/22/2021,"bidmc","Personal : Doctor, Dentist","Personal","Doctor, Dentist","",$18.00,$0.00,-$3582.65
"Discover",,U,,02/22/2021,"Bouvier Pharmacy","Personal : Prescriptions, Medicine","Personal","Prescriptions, Medicine","",$29.24,$0.00,-$3611.89
"Discover",,U,,02/23/2021,"Amazon","RV : Equipment/Supplies","RV","Equipment/Supplies","",$6.36,$0.00,-$3618.25
"Discover",,U,,02/23/2021,"NAPA","Transportation : Repairs & Maintenance","Transportation","Repairs & Maintenance","Headlight",$14.86,$0.00,-$3633.11
"Discover",,U,,02/23/2021,"A1 auto","Transportation : Repairs & Maintenance","Transportation","Repairs & Maintenance","",$64.66,$0.00,-$3697.77
"Discover",,U,,02/25/2021,"Amazon","RV : Equipment/Supplies","RV","Equipment/Supplies","",$42.27,$0.00,-$3740.04
"Discover",,U,,02/25/2021,"stop & shop","Food : Groceries","Food","Groceries","",$80.85,$0.00,-$3820.89
"Discover",,U,,02/25/2021,"Marlboro dental","Personal : Doctor, Dentist","Personal","Doctor, Dentist","",$649.00,$0.00,-$4469.89
"Discover",,U,,02/28/2021,"BP franklin","Transportation : Gas","Transportation","Gas","",$29.60,$0.00,-$4499.49
"Discover",,U,,02/28/2021,"MAC CITY N GRafton","Food : Restaurants","Food","Restaurants","mac and cheese with cliff alyssa and nicole",$107.01,$0.00,-$4606.50
"Discover",,U,,03/01/2021,"itunes","Recreation : Entertainment","Recreation","Entertainment","",$2.99,$0.00,-$4609.49
"Discover",,U,,03/01/2021,"USPS","RV : Equipment/Supplies","RV","Equipment/Supplies","",$7.95,$0.00,-$4617.44
"Discover",,U,,03/01/2021,"hmpf hermatology","Personal : Doctor, Dentist","Personal","Doctor, Dentist","",$18.00,$0.00,-$4635.44
"Discover",,U,,03/01/2021,"great call","Financial Help : Mom And Dad","Financial Help","Mom And Dad","",$36.87,$0.00,-$4672.31
"Discover",,U,,03/02/2021,"tatte bakery","Food : Restaurants","Food","Restaurants","",$13.45,$0.00,-$4685.76
"Discover",,U,,03/02/2021,"CAPE COD HOSPITIAL","Personal : Doctor, Dentist","Personal","Doctor, Dentist","",$36.00,$0.00,-$4721.76
"Discover",,U,,03/03/2021,"exxon bourne","Transportation : Gas","Transportation","Gas","",$30.50,$0.00,-$4752.26
"Discover",,U,,03/05/2021,"bidmc","Personal : Doctor, Dentist","Personal","Doctor, Dentist","",$10.00,$0.00,-$4762.26
"Discover",,U,,03/05/2021,"linguines","Food : Restaurants","Food","Restaurants","",$25.57,$0.00,-$4787.83
"Discover",,U,,03/05/2021,"hannaford","Food : Groceries","Food","Groceries","",$200.73,$0.00,-$4988.56
"Discover",,U,,03/06/2021,"Transfer : Dcu Checking",,,,"",$0.00,$379.58,-$4608.98
"Discover",,U,,03/06/2021,"speedway","Transportation : Gas","Transportation","Gas","",$34.43,$0.00,-$4643.41
"Discover",,U,,03/06/2021,"chang an","Food : Restaurants","Food","Restaurants","",$37.08,$0.00,-$4680.49
"Discover",,U,,03/09/2021,"savers marlboro","Personal : cloths","Personal","cloths","",$9.99,$0.00,-$4690.48
"Discover",,U,,03/09/2021,"hmpf hermatology","Personal : Doctor, Dentist","Personal","Doctor, Dentist","",$18.00,$0.00,-$4708.48
"Discover",,U,,03/09/2021,"hannaford","Food : Groceries","Food","Groceries","",$45.84,$0.00,-$4754.32
"Discover",,U,,03/09/2021,"Ocean State Joblot","Personal : cloths","Personal","cloths","(Split 1/3) ",$24.72,$0.00,-$4809.04
"Discover",,U,,03/09/2021,"Ocean State Joblot","Food : Groceries","Food","Groceries","(Split 2/3) ",$20.00,$0.00,-$4809.04
"Discover",,U,,03/09/2021,"Ocean State Joblot","RV : Equipment/Supplies","RV","Equipment/Supplies","(Split 3/3) ",$10.00,$0.00,-$4809.04
"Discover",,U,,03/10/2021,"Nytimes","Recreation : Entertainment","Recreation","Entertainment","",$4.00,$0.00,-$4813.04
"Discover",,U,,03/10/2021,"dollar tree","Personal : Gifts","Personal","Gifts","",$6.25,$0.00,-$4819.29
"Discover",,U,,03/10/2021,"hannaford","Food : Groceries","Food","Groceries","",$38.73,$0.00,-$4858.02
"Discover",,U,,03/11/2021,"lastpass","RV : Equipment/Supplies","RV","Equipment/Supplies","Last pass membership",$38.25,$0.00,-$4896.27
"Discover",,U,,03/12/2021,"redbox","Recreation : Entertainment","Recreation","Entertainment","",$1.91,$0.00,-$4898.18
"Discover",,U,,03/14/2021,"Clean & Green Car Wash","Transportation : Repairs & Maintenance","Transportation","Repairs & Maintenance","car cleaning",$40.00,$0.00,-$4938.18
"Discover",,U,,03/15/2021,"cvs","Personal : Prescriptions, Medicine","Personal","Prescriptions, Medicine","",$10.00,$0.00,-$4948.18
"Discover",,U,,03/15/2021,"Primacare","Personal : Doctor, Dentist","Personal","Doctor, Dentist","",$10.00,$0.00,-$4958.18
"Discover",,U,,03/15/2021,"speedway","Transportation : Gas","Transportation","Gas","",$12.23,$0.00,-$4970.41
"Discover",,U,,03/15/2021,"netflix","Recreation : Entertainment","Recreation","Entertainment","",$13.99,$0.00,-$4984.40
"Discover",,U,,03/15/2021,"hmpf hermatology","Personal : Doctor, Dentist","Personal","Doctor, Dentist",,$18.00,$0.00,-$5002.40
"Discover",,U,,03/15/2021,"bidmc","Personal : Prescriptions, Medicine","Personal","Prescriptions, Medicine","",$21.01,$0.00,-$5023.41
"Discover",,U,,03/15/2021,"Shell","Transportation : Gas","Transportation","Gas","",$21.75,$0.00,-$5045.16
"Discover",,U,,03/15/2021,"caringbridge","Charity : Other","Charity","Other","",$25.00,$0.00,-$5070.16
"Discover",,U,,03/15/2021,"Shell","Transportation : Gas","Transportation","Gas","",$36.92,$0.00,-$5107.08
"Discover",,U,,03/16/2021,"target","Food : Groceries","Food","Groceries","",$20.20,$0.00,-$5127.28
"Discover",,U,,03/16/2021,"Cts shrewsbury","Personal : Gifts","Personal","Gifts","",$25.64,$0.00,-$5152.92
"Discover",,U,,03/16/2021,"Amazon","RV : Equipment/Supplies","RV","Equipment/Supplies",,$144.12,$0.00,-$5297.04
"Discover",,U,,03/18/2021,"linguines","Food : Restaurants","Food","Restaurants","",$7.44,$0.00,-$5304.48
"Discover",,U,,03/18/2021,"Amazon","Recreation : Entertainment","Recreation","Entertainment","GUitar picks",$7.99,$0.00,-$5312.47
"Discover",,U,,03/18/2021,"BIGELOW NURSERIES  INC","Personal : Gifts","Personal","Gifts","",$11.50,$0.00,-$5323.97
"Discover",,U,,03/18/2021,"Amazon","Recreation : Entertainment","Recreation","Entertainment","GUITAR",$212.49,$0.00,-$5536.46
"Discover",,U,,03/18/2021,"macs at work","RV : Equipment/Supplies","RV","Equipment/Supplies","Mac restore data",$367.49,$0.00,-$5903.95
"Discover",,U,,03/19/2021,"Amazon","Recreation : Entertainment","Recreation","Entertainment","",$8.49,$0.00,-$5912.44
"Discover",,U,,03/19/2021,"stop and shop","Food : Groceries","Food","Groceries","",$155.37,$0.00,-$6067.81
"Discover",,U,,03/20/2021,"prime video","Recreation : Entertainment","Recreation","Entertainment","",$3.99,$0.00,-$6071.80
"Discover",,U,,03/20/2021,"Turbotax","RV : MISC","RV","MISC","",$26.56,$0.00,-$6098.36
"Discover",,U,,03/21/2021,"Micheals","Recreation : Entertainment","Recreation","Entertainment","",$8.49,$0.00,-$6106.85
"Discover",,U,,03/21/2021,"Micheals","Recreation : Entertainment","Recreation","Entertainment","art supplies",$21.24,$0.00,-$6128.09
"Discover",,U,,03/21/2021,"pressed cafe","Food : Restaurants","Food","Restaurants","",$41.73,$0.00,-$6169.82
"Discover",,U,,03/22/2021,"HFMP","Personal : Doctor, Dentist","Personal","Doctor, Dentist","",$18.00,$0.00,-$6187.82
"Discover",,U,,03/22/2021,"Sunoco","Transportation : Gas","Transportation","Gas","",$38.21,$0.00,-$6226.03
"Discover",,U,,03/22/2021,"thai spice","Food : Restaurants","Food","Restaurants","",$52.16,$0.00,-$6278.19
"Discover",,U,,03/24/2021,"cvs","Personal : Prescriptions, Medicine","Personal","Prescriptions, Medicine","",$10.00,$0.00,-$6288.19
"Discover",,U,,03/24/2021,"cvs","Personal : Prescriptions, Medicine","Personal","Prescriptions, Medicine","",$27.56,$0.00,-$6315.75
"Discover",,U,,03/24/2021,"speedway","Transportation : Gas","Transportation","Gas","",$28.77,$0.00,-$6344.52
"Discover",,U,,03/26/2021,"Price Chopper","Food : Groceries","Food","Groceries","",$69.28,$0.00,-$6413.80
"Discover",,U,,03/27/2021,"Marbn rose","Food : Restaurants","Food","Restaurants","concord",$15.52,$0.00,-$6429.32
"Discover",,U,,03/27/2021,"pricsilla candy","Personal : Gifts","Personal","Gifts","",$18.69,$0.00,-$6448.01
"Discover",,U,,03/29/2021,"great call","Financial Help : Mom And Dad","Financial Help","Mom And Dad","",$36.87,$0.00,-$6484.88
"Discover",,U,,03/30/2021,"itunes","Recreation : Entertainment","Recreation","Entertainment","",$2.99,$0.00,-$6487.87
"Discover",,U,,03/30/2021,"cjs northside grill","Food : Restaurants","Food","Restaurants","",$11.85,$0.00,-$6499.72
"Discover",,U,,03/30/2021,"HFMP","Personal : Doctor, Dentist","Personal","Doctor, Dentist","",$18.00,$0.00,-$6517.72
"Discover",,U,,03/30/2021,"trader Joes","Food : Groceries","Food","Groceries","",$152.67,$0.00,-$6670.39
"Discover",,U,,03/31/2021,"main stree pastri","Food : Restaurants","Food","Restaurants","",$8.50,$0.00,-$6678.89
"Discover",,U,,03/31/2021,"macs at work","RV : Equipment/Supplies","RV","Equipment/Supplies","",$25.00,$0.00,-$6703.89
"Discover",,U,,03/31/2021,"Shell","Transportation : Gas","Transportation","Gas","3",$36.15,$0.00,-$6740.04
"Discover",,U,,03/31/2021,"skillshare","Recreation : Entertainment","Recreation","Entertainment","",$59.40,$0.00,-$6799.44
"Discover",,U,,03/31/2021,"indian market","Food : Groceries","Food","Groceries","",$71.26,$0.00,-$6870.70
"Discover",,U,,04/01/2021,"life is good","Personal : Gifts","Personal","Gifts","",$28.00,$0.00,-$6898.70
"Discover",,U,,04/01/2021,"linguines","Food : Restaurants","Food","Restaurants","",$28.78,$0.00,-$6927.48
"Discover",,U,,04/01/2021,"Apple Store","RV : Equipment/Supplies","RV","Equipment/Supplies","Adapter for usb",$69.01,$0.00,-$6996.49
"Discover",,U,,04/02/2021,"tatte bakery","Food : Restaurants","Food","Restaurants","",$14.62,$0.00,-$7011.11
"Discover",,U,,04/02/2021,"tatte bakery","Food : Restaurants","Food","Restaurants","",$17.69,$0.00,-$7028.80
"Discover",,U,,04/02/2021,"HFMP","Personal : Doctor, Dentist","Personal","Doctor, Dentist","",$18.00,$0.00,-$7046.80
"Discover",,U,,04/02/2021,"star market","Food : Groceries","Food","Groceries","",$32.08,$0.00,-$7078.88
"Discover",,U,,04/03/2021,"target","Food : Groceries","Food","Groceries","",$1.18,$0.00,-$7080.06
"Discover",,U,,04/03/2021,"prime video","Recreation : Entertainment","Recreation","Entertainment","",$5.99,$0.00,-$7086.05
"Discover",,U,,04/03/2021,"Sweetwater camground","RV : Campgrounds","RV","Campgrounds",,$23.90,$0.00,-$7109.95
"Discover",,U,,04/04/2021,"pizza shark","Food : Restaurants","Food","Restaurants","",$6.42,$0.00,-$7116.37
"Discover",,U,,04/04/2021,"dennis public market","Food : Groceries","Food","Groceries","",$22.52,$0.00,-$7138.89
"Discover",,U,,04/04/2021,"Amazon","Recreation : Entertainment","Recreation","Entertainment","",$32.52,$0.00,-$7171.41
"Discover",,U,,04/04/2021,"speedway","Transportation : Gas","Transportation","Gas","buzzards bay",$33.15,$0.00,-$7204.56
"Discover",,U,,04/04/2021,"pizza shark","Food : Restaurants","Food","Restaurants","",$37.21,$0.00,-$7241.77
"Discover",,U,,04/05/2021,"hmpf hermatology","Personal : Doctor, Dentist","Personal","Doctor, Dentist","",$18.00,$0.00,-$7259.77
"Discover",,U,,04/05/2021,"Amazon","Recreation : Entertainment","Recreation","Entertainment","",$106.22,$0.00,-$7365.99
"Discover",,U,,04/05/2021,"Amazon","RV : Equipment/Supplies","RV","Equipment/Supplies","PRIME",$119.00,$0.00,-$7484.99
"Discover",,U,,04/06/2021,"Sweet Water Forest Campground","RV : Equipment/Supplies","RV","Equipment/Supplies","",$3.18,$0.00,-$7488.17
"Discover",,U,,04/06/2021,"taste of siam","Food : Restaurants","Food","Restaurants","",$30.82,$0.00,-$7518.99
"Discover",,U,,04/06/2021,"exxon barnstable","Transportation : Gas","Transportation","Gas","",$31.56,$0.00,-$7550.55
"Discover",,U,,04/07/2021,"Transfer : Dcu Checking",,,,"",$0.00,$4896.27,-$2654.28
"Discover",,U,,04/07/2021,"Nytimes","Recreation : Entertainment","Recreation","Entertainment","",$4.00,$0.00,-$2658.28
"Discover",,U,,04/07/2021,"linguines","Food : Restaurants","Food","Restaurants","",$83.51,$0.00,-$2741.79
"Discover",,U,,04/07/2021,"Wal-mart","Food : Groceries","Food","Groceries","(Split 1/2) ",$77.00,$0.00,-$2918.79
"Discover",,U,,04/07/2021,"Wal-mart","RV : Equipment/Supplies","RV","Equipment/Supplies","(Split 2/2) ",$100.00,$0.00,-$2918.79
"Discover",,U,,04/08/2021,"formosa","Food : Groceries","Food","Groceries","",$8.97,$0.00,-$2927.76
"Discover",,U,,04/08/2021,"hanaford","Food : Groceries","Food","Groceries","",$19.08,$0.00,-$2946.84
"Discover",,U,,04/08/2021,"BB  NE WILD FLOWER SOC","Recreation : Entertainment","Recreation","Entertainment","",$25.00,$0.00,-$2971.84
"Discover",,U,,04/08/2021,"formosa","Food : Groceries","Food","Groceries","",$52.06,$0.00,-$3023.90
"Discover",,U,,04/08/2021,"Walmart","Food : Groceries","Food","Groceries","",$52.91,$0.00,-$3076.81
"Discover",,U,,04/08/2021,"bidmc","Personal : Doctor, Dentist","Personal","Doctor, Dentist","",$100.00,$0.00,-$3176.81
"Discover",,U,,04/09/2021,"Shell","Transportation : Gas","Transportation","Gas","",$25.49,$0.00,-$3202.30
"Discover",,U,,04/12/2021,"cvs","Personal : Prescriptions, Medicine","Personal","Prescriptions, Medicine","",$21.76,$0.00,-$3224.06
"Discover",,U,,04/12/2021,"Cts shrewsbury","Personal : Gifts","Personal","Gifts","(Split 1/3) ",$50.00,$0.00,-$3376.65
"Discover",,U,,04/12/2021,"Cts shrewsbury","Food : Groceries","Food","Groceries","(Split 2/3) ",$52.59,$0.00,-$3376.65
"Discover",,U,,04/12/2021,"Cts shrewsbury","RV : Equipment/Supplies","RV","Equipment/Supplies","(Split 3/3) ",$50.00,$0.00,-$3376.65
"Discover",,U,,04/12/2021,"Home Depot","RV : Equipment/Supplies","RV","Equipment/Supplies","DEHUMIDIFIER",$289.84,$0.00,-$3666.49
"Discover",,U,,04/12/2021,"Ocean State Joblot","Financial Help : Mom And Dad","Financial Help","Mom And Dad","",$468.74,$0.00,-$4135.23
"Discover",,U,,04/13/2021,"chipolte","Food : Restaurants","Food","Restaurants","",$21.00,$0.00,-$4156.23
"Discover",,U,,04/13/2021,"Sweetwater camground","RV : Equipment/Supplies","RV","Equipment/Supplies","",$30.95,$0.00,-$4187.18
"Discover",,U,,04/13/2021,"speedway","Transportation : Gas","Transportation","Gas","",$33.76,$0.00,-$4220.94
"Discover",,U,,04/13/2021,"Chex zee","Food : Restaurants","Food","Restaurants","",$43.66,$0.00,-$4264.60
"Discover",,U,,04/15/2021,"netflix","Recreation : Entertainment","Recreation","Entertainment","",$13.99,$0.00,-$4278.59
"Discover",,U,,04/15/2021,"caringbridge","Charity : Other","Charity","Other","",$25.00,$0.00,-$4303.59
"Discover",,U,,04/16/2021,"bidmc","Personal : Doctor, Dentist","Personal","Doctor, Dentist","",$10.00,$0.00,-$4313.59
"Discover",,U,,04/16/2021,"speedway","Transportation : Gas","Transportation","Gas","",$31.34,$0.00,-$4344.93
"Discover",,U,,04/16/2021,"PHO PASTEUR QUNNCY","Food : Restaurants","Food","Restaurants","",$33.70,$0.00,-$4378.63
"Discover",,U,,04/17/2021,"NESTING LLC","Personal : Gifts","Personal","Gifts","",$5.85,$0.00,-$4384.48
"Discover",,U,,04/17/2021,"kindle unlimited","Recreation : Entertainment","Recreation","Entertainment","",$9.99,$0.00,-$4394.47
"Discover",,U,,04/17/2021,"BEDFORD FARMS","Food : Restaurants","Food","Restaurants","",$11.00,$0.00,-$4405.47
"Discover",,U,,04/17/2021,"trader Joes","Food : Groceries","Food","Groceries","",$87.18,$0.00,-$4492.65
"Discover",,U,,04/18/2021,"Amazon Music","Recreation : Entertainment","Recreation","Entertainment","",$7.99,$0.00,-$4500.64
"Discover",,U,,04/18/2021,"Main street market","Food : Restaurants","Food","Restaurants","Concord",$20.20,$0.00,-$4520.84
"Discover",,U,,04/19/2021,"Aprils Garden","Personal : Gifts","Personal","Gifts","",$0.00,$5.42,-$4515.42
"Discover",,U,,04/19/2021,"USPS","RV : Equipment/Supplies","RV","Equipment/Supplies","",$11.10,$0.00,-$4526.52
"Discover",,U,,04/19/2021,"Native plant trust","Personal : Gifts","Personal","Gifts","",$25.48,$0.00,-$4552.00
"Discover",,U,,04/19/2021,"rv tripwizard","RV : Equipment/Supplies","RV","Equipment/Supplies","",$39.00,$0.00,-$4591.00
"Discover",,U,,04/19/2021,"Aprils Garden","Personal : Gifts","Personal","Gifts","Plant for Anne Durango CO",$70.15,$0.00,-$4661.15
"Discover",,U,,04/19/2021,"shaws","Food : Groceries","Food","Groceries","",$175.57,$0.00,-$4836.72
"Discover",,U,,04/20/2021,"tatte bakery","Food : Restaurants","Food","Restaurants","",$15.20,$0.00,-$4851.92
"Discover",,U,,04/20/2021,"hmpf hermatology","Personal : Doctor, Dentist","Personal","Doctor, Dentist",,$18.00,$0.00,-$4869.92
"Discover",,U,,04/22/2021,"El Mariachi","Food : Restaurants","Food","Restaurants","wareham",$26.47,$0.00,-$4896.39
"Discover",,U,,04/22/2021,"Shell","Transportation : Gas","Transportation","Gas","",$33.22,$0.00,-$4929.61
"Discover",,U,,04/23/2021,"hmpf hermatology","Personal : Doctor, Dentist","Personal","Doctor, Dentist",,$18.00,$0.00,-$4947.61
"Discover",,U,,04/23/2021,"Shell","Transportation : Gas","Transportation","Gas","",$20.06,$0.00,-$4967.67
"Discover",,U,,04/23/2021,"Sunoco","Transportation : Gas","Transportation","Gas","",$32.25,$0.00,-$4999.92
"Discover",,U,,04/23/2021,"shaw's Market","Food : Groceries","Food","Groceries","",$41.05,$0.00,-$5040.97
"Discover",,U,,04/24/2021,"Trombetta","Food : Restaurants","Food","Restaurants","",$16.59,$0.00,-$5057.56
"Discover",,U,,04/24/2021,"intuit","Financial Help : Alyssa","Financial Help","Alyssa","",$26.56,$0.00,-$5084.12
"Discover",,U,,04/25/2021,"dollar tree","RV : Equipment/Supplies","RV","Equipment/Supplies","",$7.19,$0.00,-$5091.31
"Discover",,U,,04/25/2021,"Rockys Hardward","RV : Equipment/Supplies","RV","Equipment/Supplies","",$13.00,$0.00,-$5104.31
"Discover",,U,,04/25/2021,"Officemax","RV : Equipment/Supplies","RV","Equipment/Supplies","",$56.76,$0.00,-$5161.07
"Discover",,U,,04/26/2021,"hmpf hermatology","Personal : Doctor, Dentist","Personal","Doctor, Dentist","",$18.00,$0.00,-$5179.07
"Discover",,U,,04/26/2021,"star market","Food : Groceries","Food","Groceries","",$47.98,$0.00,-$5227.05
"Discover",,U,,04/27/2021,"tatte bakery","Food : Restaurants","Food","Restaurants","",$7.75,$0.00,-$5234.80
"Discover",,U,,04/27/2021,"tatte bakery","Food : Restaurants","Food","Restaurants","",$11.11,$0.00,-$5245.91
"Discover",,U,,04/27/2021,"edmon jacobson","Personal : Doctor, Dentist","Personal","Doctor, Dentist","",$18.00,$0.00,-$5263.91
"Discover",,U,,04/27/2021,"speedway","Transportation : Gas","Transportation","Gas","",$30.31,$0.00,-$5294.22
"Discover",,U,,04/28/2021,"great call","Financial Help : Mom And Dad","Financial Help","Mom And Dad","",$36.99,$0.00,-$5331.21
"Discover",,U,,04/28/2021,"mirachi nation","Food : Restaurants","Food","Restaurants","",$70.67,$0.00,-$5401.88
"Discover",,U,,04/28/2021,"gillis landscapre","RV : Campgrounds","RV","Campgrounds","LANDSCAPING FOR ANN AND NEIL",$198.50,$0.00,-$5600.38
"Discover",,U,,04/29/2021,"itunes","Recreation : Entertainment","Recreation","Entertainment","",$2.99,$0.00,-$5603.37
"Discover",,U,,04/29/2021,"bidmc","Personal : Doctor, Dentist","Personal","Doctor, Dentist","",$30.00,$0.00,-$5633.37
"Discover",,U,,04/29/2021,"shields","Personal : Doctor, Dentist","Personal","Doctor, Dentist","",$30.00,$0.00,-$5663.37
"Discover",,U,,04/29/2021,"hmpf hermatology","Personal : Doctor, Dentist","Personal","Doctor, Dentist","",$54.00,$0.00,-$5717.37
"Discover",,U,,04/30/2021,"linguines","Food : Restaurants","Food","Restaurants","",$49.27,$0.00,-$5766.64
"Discover",,U,,05/01/2021,"speedway","Transportation : Gas","Transportation","Gas","buzzards bay",$21.98,$0.00,-$5788.62
"Discover",,U,,05/01/2021,"dennis public market","Food : Groceries","Food","Groceries","",$27.66,$0.00,-$5816.28
"Discover",,U,,05/01/2021,"Justinguitar","Recreation : Entertainment","Recreation","Entertainment","Sheet music",$49.99,$0.00,-$5866.27
"Discover",,U,,05/02/2021,"dennis public market","Food : Groceries","Food","Groceries","",$40.39,$0.00,-$5906.66
"Discover",,U,,05/02/2021,"hannaford","Food : Groceries","Food","Groceries","",$83.47,$0.00,-$5990.13
"Discover",,U,,05/03/2021,"star market","Food : Groceries","Food","Groceries","",$7.43,$0.00,-$5997.56
"Discover",,U,,05/03/2021,"bidmc","Personal : Doctor, Dentist","Personal","Doctor, Dentist","",$18.00,$0.00,-$6015.56
"Discover",,U,,05/03/2021,"speedway","Transportation : Gas","Transportation","Gas","hyannis",$35.56,$0.00,-$6051.12
"Discover",,U,,05/03/2021,"linguines","Food : Restaurants","Food","Restaurants","",$39.34,$0.00,-$6090.46
"Discover",,U,,05/03/2021,"whole foods","Food : Groceries","Food","Groceries","",$48.95,$0.00,-$6139.41
"Discover",,U,,05/04/2021,"chick-fil-a","Food : Restaurants","Food","Restaurants","",$6.62,$0.00,-$6146.03
"Discover",,U,,05/05/2021,"Nytimes","Recreation : Entertainment","Recreation","Entertainment","",$4.00,$0.00,-$6150.03
"Discover",,U,,05/05/2021,"cvs","Personal : Prescriptions, Medicine","Personal","Prescriptions, Medicine","",$10.00,$0.00,-$6160.03
"Discover",,U,,05/05/2021,"Sweetwater camground","RV : Equipment/Supplies","RV","Equipment/Supplies","",$11.94,$0.00,-$6171.97
"Discover",,U,,05/05/2021,"CTS West Dennis","Personal : Gifts","Personal","Gifts","",$32.98,$0.00,-$6204.95
"Discover",,U,,05/06/2021,"Transfer : Dcu Checking",,,,"",$0.00,$3202.30,-$3002.65
"Discover",,U,,05/08/2021,"bidmc garage","Lisa Business : Parking","Lisa Business","Parking","",$12.00,$0.00,-$3014.65
"Discover",,U,,05/08/2021,"Yellick farm","Personal : Gifts","Personal","Gifts","",$25.50,$0.00,-$3040.15
"Discover",,U,,05/08/2021,"Pho Viets","Food : Restaurants","Food","Restaurants","",$34.40,$0.00,-$3074.55
"Discover",,U,,05/08/2021,"gulf mart","RV : gasoline","RV","gasoline","Natick",$36.80,$0.00,-$3111.35
"Discover",,U,,05/09/2021,"moon river botanic","Personal : Gifts","Personal","Gifts","",$19.12,$0.00,-$3130.47
"Discover",,U,,05/09/2021,"Officemax","RV : Equipment/Supplies","RV","Equipment/Supplies","",$22.30,$0.00,-$3152.77
"Discover",,U,,05/09/2021,"hanaford","Food : Groceries","Food","Groceries","",$51.15,$0.00,-$3203.92
"Discover",,U,,05/10/2021,"Cobiies","Food : Restaurants","Food","Restaurants","",$41.62,$0.00,-$3245.54
"Discover",,U,,05/11/2021,"Gas","Transportation : Gas","Transportation","Gas","Bourne",$35.69,$0.00,-$3281.23
"Discover",,U,,05/11/2021,"Market bskt","Food : Groceries","Food","Groceries","",$275.34,$0.00,-$3556.57
"Discover",,U,,05/12/2021,"tatte bakery","Food : Restaurants","Food","Restaurants","",$8.56,$0.00,-$3565.13
"Discover",,U,,05/12/2021,"tatte bakery","Food : Restaurants","Food","Restaurants","",$12.20,$0.00,-$3577.33
"Discover",,U,,05/12/2021,"rutchads thai","Food : Restaurants","Food","Restaurants","",$44.74,$0.00,-$3622.07
"Discover",,U,,05/12/2021,"A1 auto","Transportation : Repairs & Maintenance","Transportation","Repairs & Maintenance","",$88.91,$0.00,-$3710.98
"Discover",,U,,05/12/2021,"hanaford","Food : Groceries","Food","Groceries","marlboro",$90.00,$0.00,-$3800.98
"Discover",,U,,05/13/2021,"Panera Bread","Food : Restaurants","Food","Restaurants","",$19.32,$0.00,-$3820.30
"Discover",,U,,05/13/2021,"Sunoco","Transportation : Gas","Transportation","Gas","Boston",$39.90,$0.00,-$3860.20
"Discover",,U,,05/13/2021,"Ptzcuaro","Food : Restaurants","Food","Restaurants","newton",$62.06,$0.00,-$3922.26
"Discover",,U,,05/14/2021,"star market","Food : Groceries","Food","Groceries","",$16.86,$0.00,-$3939.12
"Discover",,U,,05/14/2021,"stop & shop","Food : Groceries","Food","Groceries","Roslindale",$21.00,$0.00,-$3960.12
"Discover",,U,,05/14/2021,"slice round two pizza","Food : Restaurants","Food","Restaurants","NY? Rosindale",$24.98,$0.00,-$3985.10
"Discover",,U,,05/14/2021,"star market","Food : Groceries","Food","Groceries","boston",$51.40,$0.00,-$4036.50
"Discover",,U,,05/15/2021,"netflix","Recreation : Entertainment","Recreation","Entertainment","",$13.99,$0.00,-$4050.49
"Discover",,U,,05/15/2021,"caringbridge","Charity : Other","Charity","Other","",$25.00,$0.00,-$4075.49
"Discover",,U,,05/15/2021,"Shanti","Food : Restaurants","Food","Restaurants","roslindale",$52.87,$0.00,-$4128.36
"Discover",,U,,05/15/2021,"Apple Store","RV : Equipment/Supplies","RV","Equipment/Supplies","Bob Iphone",$1162.45,$0.00,-$5290.81
"Discover",,U,,05/16/2021,"Amazon","RV : Equipment/Supplies","RV","Equipment/Supplies","",$19.11,$0.00,-$5309.92
"Discover",,U,,05/16/2021,"uno chicago grill","Food : Restaurants","Food","Restaurants","",$41.44,$0.00,-$5351.36
"Discover",,U,,05/16/2021,"the greeen coffee shop","Food : Restaurants","Food","Restaurants","roslindale",$41.83,$0.00,-$5393.19
"Discover",,U,,05/16/2021,"Rons Ice Cream","Food : Restaurants","Food","Restaurants","",$42.49,$0.00,-$5435.68
"Discover",,U,,05/17/2021,"Round two","Food : Restaurants","Food","Restaurants","",$20.66,$0.00,-$5456.34
"Discover",,U,,05/18/2021,"star market","Food : Groceries","Food","Groceries","",$19.84,$0.00,-$5476.18
"Discover",,U,,05/19/2021,"Hot table","Food : Restaurants","Food","Restaurants","",$28.75,$0.00,-$5504.93
"Discover",,U,,05/20/2021,"Cape code creamery","Food : Restaurants","Food","Restaurants","ice cream",$18.13,$0.00,-$5523.06
"Discover",,U,,05/21/2021,"Brewster farms","Food : Groceries","Food","Groceries","",$9.47,$0.00,-$5532.53
"Discover",,U,,05/21/2021,"Amazon","RV : Equipment/Supplies","RV","Equipment/Supplies","",$19.11,$0.00,-$5551.64
"Discover",,U,,05/21/2021,"Shell","Transportation : Gas","Transportation","Gas","Brewster",$36.33,$0.00,-$5587.97
"Discover",,U,,05/21/2021,"Cobies","Food : Restaurants","Food","Restaurants","",$41.41,$0.00,-$5629.38
"Discover",,U,,05/21/2021,"Trombetta","Personal : Gifts","Personal","Gifts","",$42.80,$0.00,-$5672.18
"Discover",,U,,05/21/2021,"Amazon","RV : Equipment/Supplies","RV","Equipment/Supplies","",$57.36,$0.00,-$5729.54
"Discover",,U,,05/22/2021,"savers marlboro","Personal : cloths","Personal","cloths",,$5.30,$0.00,-$5734.84
"Discover",,U,,05/22/2021,"dunkin donuts","Personal : Gifts","Personal","Gifts","",$6.62,$0.00,-$5741.46
"Discover",,U,,05/22/2021,"Tialina's","Personal : Gifts","Personal","Gifts","",$9.00,$0.00,-$5750.46
"Discover",,U,,05/23/2021,"CTS Store West Dennis","Personal : Gifts","Personal","Gifts","",$37.98,$0.00,-$5788.44
"Discover",,U,,05/24/2021,"bidmc","Personal : Doctor, Dentist","Personal","Doctor, Dentist","",$18.00,$0.00,-$5806.44
"Discover",,U,,05/24/2021,"soup shack","Food : Restaurants","Food","Restaurants","",$35.15,$0.00,-$5841.59
"Discover",,U,,05/24/2021,"Gas","Transportation : Gas","Transportation","Gas","Bourne",$37.34,$0.00,-$5878.93
"Discover",,U,,05/24/2021,"Max and Leos","Food : Restaurants","Food","Restaurants","",$65.59,$0.00,-$5944.52
"Discover",,U,,05/25/2021,"big lots","RV : Equipment/Supplies","RV","Equipment/Supplies","",$7.03,$0.00,-$5951.55
"Discover",,U,,05/25/2021,"chess.com","Recreation : Entertainment","Recreation","Entertainment","",$29.00,$0.00,-$5980.55
"Discover",,U,,05/25/2021,"chess.com","Recreation : Entertainment","Recreation","Entertainment","",$76.08,$0.00,-$6056.63
"Discover",,U,,05/26/2021,"chick-fil-a","Food : Restaurants","Food","Restaurants","",$9.90,$0.00,-$6066.53
"Discover",,U,,05/26/2021,"The Bbreakfast club","Food : Restaurants","Food","Restaurants","Allston",$11.24,$0.00,-$6077.77
"Discover",,U,,05/26/2021,"The Diner","Food : Restaurants","Food","Restaurants","Watertown",$20.16,$0.00,-$6097.93
"Discover",,U,,05/26/2021,"CTS HYANNIS","Personal : Gifts","Personal","Gifts","",$31.86,$0.00,-$6129.79
"Discover",,U,,05/26/2021,"Home Depot","RV : Equipment/Supplies","RV","Equipment/Supplies","",$39.53,$0.00,-$6169.32
"Discover",,U,,05/27/2021,"Red apple","Food : Groceries","Food","Groceries","",$13.79,$0.00,-$6183.11
"Discover",,U,,05/27/2021,"casarecce","Food : Restaurants","Food","Restaurants","",$34.35,$0.00,-$6217.46
"Discover",,U,,05/27/2021,"great call","Financial Help : Mom And Dad","Financial Help","Mom And Dad","",$36.99,$0.00,-$6254.45
"Discover",,U,,05/27/2021,"Gas","Transportation : Gas","Transportation","Gas","Yarmouth port",$38.00,$0.00,-$6292.45
"Discover",,U,,05/27/2021,"Captain Frosty","Food : Restaurants","Food","Restaurants","",$61.63,$0.00,-$6354.08
"Discover",,U,,05/28/2021,"chick-fil-a","Food : Restaurants","Food","Restaurants","",$9.90,$0.00,-$6363.98
"Discover",,U,,05/28/2021,"bidmc","Personal : Doctor, Dentist","Personal","Doctor, Dentist","",$12.00,$0.00,-$6375.98
"Discover",,U,,05/28/2021,"NYA Joe","Food : Restaurants","Food","Restaurants","",$18.59,$0.00,-$6394.57
"Discover",,U,,05/28/2021,"linguines","Food : Restaurants","Food","Restaurants","",$26.64,$0.00,-$6421.21
"Discover",,U,,05/29/2021,"star market","Food : Groceries","Food","Groceries","",$4.99,$0.00,-$6426.20
"Discover",,U,,05/29/2021,"bidmc","Personal : Doctor, Dentist","Personal","Doctor, Dentist","",$12.00,$0.00,-$6438.20
"Discover",,U,,05/29/2021,"babbel","Recreation : Entertainment","Recreation","Entertainment","",$79.69,$0.00,-$6517.89
"Discover",,U,,05/29/2021,"star market","Food : Groceries","Food","Groceries","",$81.63,$0.00,-$6599.52
"Discover",,U,,05/30/2021,"laundry","RV : Laundry","RV","Laundry","",$1.00,$0.00,-$6600.52
"Discover",,U,,05/30/2021,"itunes","Recreation : Entertainment","Recreation","Entertainment","",$2.99,$0.00,-$6603.51
"Discover",,U,,05/30/2021,"laundry","RV : Laundry","RV","Laundry","",$10.00,$0.00,-$6613.51
"Discover",,U,,05/30/2021,"Primary Care Cape Cod","Personal : Doctor, Dentist","Personal","Doctor, Dentist","",$10.00,$0.00,-$6623.51
"Discover",,U,,05/30/2021,"The Diner","Food : Restaurants","Food","Restaurants","",$20.16,$0.00,-$6643.67
"Discover",,U,,05/30/2021,"Justinguitar","Recreation : Entertainment","Recreation","Entertainment","",$68.98,$0.00,-$6712.65
"Discover",,U,,05/31/2021,"Shell","Transportation : Gas","Transportation","Gas","dennis",$37.43,$0.00,-$6750.08
"Discover",,U,,05/31/2021,"Chapins","Food : Restaurants","Food","Restaurants","",$97.37,$0.00,-$6847.45
"Discover",,U,,06/01/2021,"bidmc","Personal : Doctor, Dentist","Personal","Doctor, Dentist","",$18.00,$0.00,-$6865.45
"Discover",,U,,06/01/2021,"Kindles Pizza","Food : Restaurants","Food","Restaurants","",$43.26,$0.00,-$6908.71
"Discover",,U,,06/02/2021,"Nytimes","Recreation : Entertainment","Recreation","Entertainment","",$4.00,$0.00,-$6912.71
"Discover",,U,,06/02/2021,"Davidian Broethers","Food : Restaurants","Food","Restaurants","",$9.98,$0.00,-$6922.69
"Discover",,U,,06/02/2021,"stop & shop","Food : Groceries","Food","Groceries","",$141.52,$0.00,-$7064.21
"Discover",,U,,06/02/2021,"Progressive Insurance","RV : Insurance","RV","Insurance","",$1993.00,$0.00,-$9057.21
"Discover",,U,,06/04/2021,"bidmc","Personal : Doctor, Dentist","Personal","Doctor, Dentist","",$18.00,$0.00,-$9075.21
"Discover",,U,,06/04/2021,"Chez siam","Food : Restaurants","Food","Restaurants","",$27.12,$0.00,-$9102.33
"Discover",,U,,06/04/2021,"gulf mart","Transportation : Gas","Transportation","Gas","",$41.74,$0.00,-$9144.07
"Discover",,U,,06/05/2021,"Transfer : Dcu Checking",,,,"",$0.00,$3666.24,-$5477.83
"Discover",,U,,06/05/2021,"Yellick farm","Personal : Gifts","Personal","Gifts","",$96.69,$0.00,-$5574.52
"Discover",,U,,06/06/2021,"cvs","Personal : Prescriptions, Medicine","Personal","Prescriptions, Medicine","",$10.00,$0.00,-$5584.52
"Discover",,U,,06/07/2021,"bidmc","Personal : Doctor, Dentist","Personal","Doctor, Dentist","",$18.00,$0.00,-$5602.52
"Discover",,U,,06/07/2021,"shutter fly","Personal : Gifts","Personal","Gifts",,$36.45,$0.00,-$5638.97
"Discover",,U,,06/08/2021,"peterson market dennis","Food : Groceries","Food","Groceries","",$16.55,$0.00,-$5655.52
"Discover",,U,,06/09/2021,"chick-fil-a","Food : Restaurants","Food","Restaurants","",$12.45,$0.00,-$5667.97
"Discover",,U,,06/09/2021,"CTS HYANNIS","RV : Equipment/Supplies","RV","Equipment/Supplies","",$13.25,$0.00,-$5681.22
"Discover",,U,,06/09/2021,"trader Joes","Food : Groceries","Food","Groceries","Hynnis",$15.67,$0.00,-$5696.89
"Discover",,U,,06/09/2021,"Shell","Transportation : Gas","Transportation","Gas","dennis",$36.23,$0.00,-$5733.12
"Discover",,U,,06/09/2021,"trader Joes","Food : Groceries","Food","Groceries","",$84.57,$0.00,-$5817.69
"Discover",,U,,06/10/2021,"Sweet Water Forest Campground","RV : Equipment/Supplies","RV","Equipment/Supplies",,$9.81,$0.00,-$5827.50
"Discover",,U,,06/11/2021,"dana farber","Personal : Doctor, Dentist","Personal","Doctor, Dentist","",$36.00,$0.00,-$5863.50
"Discover",,U,,06/13/2021,"Cap anns Marina resort","Personal : Gifts","Personal","Gifts","Gift for Doug",$50.00,$0.00,-$5913.50
"Discover",,U,,06/14/2021,"pizza shark","Food : Restaurants","Food","Restaurants","",$24.40,$0.00,-$5937.90
"Discover",,U,,06/14/2021,"girt rocket","Personal : Gifts","Personal","Gifts","Guido and Eilleen gift",$54.50,$0.00,-$5992.40
"Discover",,U,,06/14/2021,"sweewater","RV : propane","RV","propane","",$59.06,$0.00,-$6051.46
"Discover",,U,,06/14/2021,"stop & shop","Food : Groceries","Food","Groceries","",$147.38,$0.00,-$6198.84
"Discover",,U,,06/15/2021,"USA  star","RV : Laundry","RV","Laundry","",$6.50,$0.00,-$6205.34
"Discover",,U,,06/15/2021,"USA  star","RV : Laundry","RV","Laundry","",$12.50,$0.00,-$6217.84
"Discover",,U,,06/15/2021,"netflix","Recreation : Entertainment","Recreation","Entertainment","",$13.99,$0.00,-$6231.83
"Discover",,U,,06/15/2021,"Amazon","RV : Equipment/Supplies","RV","Equipment/Supplies","",$14.56,$0.00,-$6246.39
"Discover",,U,,06/15/2021,"caringbridge","Charity : Other","Charity","Other","",$25.00,$0.00,-$6271.39
"Discover",,U,,06/15/2021,"Ring Bors","Food : Groceries","Food","Groceries","",$25.00,$0.00,-$6296.39
"Discover",,U,,06/15/2021,"Escapees RV Club","RV : clubs","RV","clubs","",$49.95,$0.00,-$6346.34
"Discover",,U,,06/15/2021,"bidmc","Personal : Doctor, Dentist","Personal","Doctor, Dentist","",$72.00,$0.00,-$6418.34
"Discover",,U,,06/16/2021,"cafe chew","Food : Restaurants","Food","Restaurants","",$28.78,$0.00,-$6447.12
"Discover",,U,,06/16/2021,"Heritage museaum and gardens","Recreation : Entertainment","Recreation","Entertainment","We liked this - gardens great and nice car museaum",$42.16,$0.00,-$6489.28
"Discover",,U,,06/16/2021,"Best Buy Hannis","Personal : Gifts","Personal","Gifts","Dad Head phones??",$46.72,$0.00,-$6536.00
"Discover",,U,,06/16/2021,"Westies Shoes","Personal : cloths","Personal","cloths","",$69.88,$0.00,-$6605.88
"Discover",,U,,06/17/2021,"Captain Frosty","Food : Restaurants","Food","Restaurants","",$22.99,$0.00,-$6628.87
"Discover",,U,,06/18/2021,"McDonalds","Food : Restaurants","Food","Restaurants","",$9.92,$0.00,-$6638.79
"Discover",,U,,06/18/2021,"cvs","Personal : Prescriptions, Medicine","Personal","Prescriptions, Medicine","",$10.00,$0.00,-$6648.79
"Discover",,U,,06/18/2021,"exxon barnstable","Transportation : Gas","Transportation","Gas","",$39.56,$0.00,-$6688.35
"Discover",,U,,06/19/2021,"redbox","Recreation : Entertainment","Recreation","Entertainment","",$1.91,$0.00,-$6690.26
"Discover",,U,,06/19/2021,"stop & shop","Food : Groceries","Food","Groceries","",$55.50,$0.00,-$6745.76
"Discover",,U,,06/20/2021,"Wegmans","Food : Groceries","Food","Groceries","",$53.72,$0.00,-$6799.48
"Discover",,U,,06/21/2021,"Uhlmans ice cream","Food : Restaurants","Food","Restaurants","",$20.75,$0.00,-$6820.23
"Discover",,U,,06/21/2021,"Roche Brothers","Food : Groceries","Food","Groceries","",$30.33,$0.00,-$6850.56
"Discover",,U,,06/21/2021,"Ranchocorona","Food : Restaurants","Food","Restaurants","",$90.58,$0.00,-$6941.14
"Discover",,U,,06/22/2021,"star market","Food : Groceries","Food","Groceries","",$3.54,$0.00,-$6944.68
"Discover",,U,,06/22/2021,"exxon brookline","Transportation : Gas","Transportation","Gas","",$35.93,$0.00,-$6980.61
"Discover",,U,,06/24/2021,"Amazon","RV : Equipment/Supplies","RV","Equipment/Supplies","",$15.63,$0.00,-$6996.24
"Discover",,U,,06/24/2021,"dennis public market","Food : Groceries","Food","Groceries","",$37.97,$0.00,-$7034.21
"Discover",,U,,06/24/2021,"Royall II restaurant Yarmouth","Food : Restaurants","Food","Restaurants","",$38.60,$0.00,-$7072.81
"Discover",,U,,06/24/2021,"Chapins","Food : Restaurants","Food","Restaurants","",$87.63,$0.00,-$7160.44
"Discover",,U,,06/25/2021,"Kates seafood","Food : Restaurants","Food","Restaurants","",$63.89,$0.00,-$7224.33
"Discover",,U,,06/25/2021,"Amazon","RV : Equipment/Supplies","RV","Equipment/Supplies","",$95.57,$0.00,-$7319.90
"Discover",,U,,06/26/2021,"cvs","Personal : Prescriptions, Medicine","Personal","Prescriptions, Medicine","",$7.00,$0.00,-$7326.90
"Discover",,U,,06/26/2021,"cvs","Personal : Prescriptions, Medicine","Personal","Prescriptions, Medicine","",$9.00,$0.00,-$7335.90
"Discover",,U,,06/26/2021,"trader Joes","Food : Groceries","Food","Groceries","",$148.98,$0.00,-$7484.88
"Discover",,U,,06/27/2021,"Five Guys","Food : Restaurants","Food","Restaurants","",$13.64,$0.00,-$7498.52
"Discover",,U,,06/27/2021,"south garage boston","Lisa Business : Parking","Lisa Business","Parking","",$15.00,$0.00,-$7513.52
"Discover",,U,,06/27/2021,"speedway","Transportation : Gas","Transportation","Gas","",$27.39,$0.00,-$7540.91
"Discover",,U,,06/27/2021,"Crown Point Camping","RV : Campgrounds","RV","Campgrounds","",$49.00,$0.00,-$7589.91
"Discover",,U,,06/28/2021,"star laundry","RV : Laundry","RV","Laundry","",$5.50,$0.00,-$7595.41
"Discover",,U,,06/28/2021,"Livin Easy","Personal : Gifts","Personal","Gifts","",$10.00,$0.00,-$7605.41
"Discover",,U,,06/28/2021,"Primary Care Cape Cod","Personal : Doctor, Dentist","Personal","Doctor, Dentist","",$10.00,$0.00,-$7615.41
"Discover",,U,,06/28/2021,"Cape Cod Sweat and Tea","Personal : cloths","Personal","cloths","",$12.00,$0.00,-$7627.41
"Discover",,U,,06/28/2021,"Ocean St Cafe","Food : Restaurants","Food","Restaurants","",$30.50,$0.00,-$7657.91
"Discover",,U,,06/29/2021,"Best Buy","Personal : Gifts","Personal","Gifts","",$0.00,$10.61,-$7647.30
"Discover",,U,,06/29/2021,"itunes","Recreation : Entertainment","Recreation","Entertainment","",$2.99,$0.00,-$7650.29
"Discover",,U,,06/29/2021,"cvs","Personal : Prescriptions, Medicine","Personal","Prescriptions, Medicine","",$10.00,$0.00,-$7660.29
"Discover",,U,,06/29/2021,"cvs","Personal : Prescriptions, Medicine","Personal","Prescriptions, Medicine","",$20.00,$0.00,-$7680.29
"Discover",,U,,06/29/2021,"Sesuit Gas","Transportation : Gas","Transportation","Gas","",$26.10,$0.00,-$7706.39
"Discover",,U,,06/29/2021,"Marshall's","Personal : cloths","Personal","cloths","",$29.08,$0.00,-$7735.47
"Discover",,U,,06/29/2021,"Sesuit Gas","Transportation : Gas","Transportation","Gas","",$36.00,$0.00,-$7771.47
"Discover",,U,,06/29/2021,"great call","Financial Help : Mom And Dad","Financial Help","Mom And Dad","",$36.99,$0.00,-$7808.46
"Discover",,U,,06/30/2021,"Nytimes","Recreation : Entertainment","Recreation","Entertainment","",$4.00,$0.00,-$7812.46
"Discover",,U,,06/30/2021,"7-11","Transportation : Gas","Transportation","Gas",,$14.85,$0.00,-$7827.31
"Discover",,U,,07/01/2021,"Crown Point Camping","RV : Campgrounds","RV","Campgrounds","",$244.00,$0.00,-$8071.31
"Discover",,U,,07/02/2021,"Woodstock Farmers Market","Food : Groceries","Food","Groceries","",$9.00,$0.00,-$8080.31
"Discover",,U,,07/02/2021,"Woodstock Farmers Market","Food : Groceries","Food","Groceries","",$86.00,$0.00,-$8166.31
"Discover",,U,,07/03/2021,"Sweetwater Sound","Recreation : Entertainment","Recreation","Entertainment","Guitar Picks",$4.77,$0.00,-$8171.08
"Discover",,U,,07/03/2021,"Crown Point Camping","RV : Campgrounds","RV","Campgrounds","",$20.41,$0.00,-$8191.49
"Discover",,U,,07/03/2021,"Crown Point Camping","RV : Campgrounds","RV","Campgrounds","",$64.97,$0.00,-$8256.46
"Discover",,U,,07/05/2021,"Stop & Shop Fuel","Transportation : Gas","Transportation","Gas",,$121.55,$0.00,-$8378.01
"Discover",,U,,07/06/2021,"Transfer : Dcu Checking",,,,"",$0.00,$5863.50,-$2514.51
"Discover",,U,,07/06/2021,"GSH South Hookset","Food : Restaurants","Food","Restaurants","",$19.08,$0.00,-$2533.59
"Discover",,U,,07/06/2021,"Citgo","RV : gasoline","RV","gasoline","",$100.00,$0.00,-$2633.59
"Discover",,U,,07/07/2021,"Market bskt","Food : Groceries","Food","Groceries","",$93.80,$0.00,-$2727.39
"Discover",,U,,07/07/2021,"Harry's Bar and Grille","Food : Restaurants","Food","Restaurants","Lunch with Anne and Neil",$100.00,$0.00,-$2827.39
"Discover",,U,,07/08/2021,"Pie in the Sky","Food : Restaurants","Food","Restaurants","woods hole MA?",$17.54,$0.00,-$2844.93
"Discover",,U,,07/08/2021,"hmpf hermatology","Personal : Doctor, Dentist","Personal","Doctor, Dentist","",$18.00,$0.00,-$2862.93
"Discover",,U,,07/09/2021,"star laundry","RV : Laundry","RV","Laundry","",$11.00,$0.00,-$2873.93
"Discover",,U,,07/09/2021,"star laundry","RV : Laundry","RV","Laundry","",$11.00,$0.00,-$2884.93
"Discover",,U,,07/09/2021,"Buckies Dennisport","RV : Equipment/Supplies","RV","Equipment/Supplies","",$19.88,$0.00,-$2904.81
"Discover",,U,,07/09/2021,"monroe motors","Transportation : Repairs & Maintenance","Transportation","Repairs & Maintenance","",$141.00,$0.00,-$3045.81
"Discover",,U,,07/10/2021,"cvs","Personal : Prescriptions, Medicine","Personal","Prescriptions, Medicine","",$20.00,$0.00,-$3065.81
"Discover",,U,,07/11/2021,"Shell","Transportation : Gas","Transportation","Gas","",$39.19,$0.00,-$3105.00
"Discover",,U,,07/11/2021,"The Place","Food : Restaurants","Food","Restaurants","Lunch at Art Show with Alyssa Karina Mary",$71.16,$0.00,-$3176.16
"Discover",,U,,07/12/2021,"peterson market dennis","Food : Groceries","Food","Groceries","",$38.16,$0.00,-$3214.32
"Discover",,U,,07/12/2021,"Thre Breakfast Room","Food : Restaurants","Food","Restaurants","Break fast Mitchell Becky Chris",$75.60,$0.00,-$3289.92
"Discover",,U,,07/13/2021,"Walmart","RV : Equipment/Supplies","RV","Equipment/Supplies","",$18.33,$0.00,-$3308.25
"Discover",,U,,07/13/2021,"Irving gas","Transportation : Gas","Transportation","Gas","",$40.90,$0.00,-$3349.15
"Discover",,U,,07/13/2021,"Pepper Terrace","Food : Restaurants","Food","Restaurants","Lisa and Charlotte",$45.27,$0.00,-$3394.42
"Discover",,U,,07/13/2021,"hmpf hermatology","Personal : Doctor, Dentist","Personal","Doctor, Dentist","",$54.00,$0.00,-$3448.42
"Discover",,U,,07/13/2021,"Market bskt","Food : Groceries","Food","Groceries","",$68.95,$0.00,-$3517.37
"Discover",,U,,07/14/2021,"Magnolia cafe","Food : Restaurants","Food","Restaurants","",$2.14,$0.00,-$3519.51
"Discover",,U,,07/14/2021,"Magnolia cafe","Food : Restaurants","Food","Restaurants","",$6.37,$0.00,-$3525.88
"Discover",,U,,07/14/2021,"bidmc","Personal : Doctor, Dentist","Personal","Doctor, Dentist","",$30.00,$0.00,-$3555.88
"Discover",,U,,07/15/2021,"netflix","Recreation : Entertainment","Recreation","Entertainment","",$13.99,$0.00,-$3569.87
"Discover",,U,,07/15/2021,"caringbridge","Charity : Other","Charity","Other","",$25.00,$0.00,-$3594.87
"Discover",,U,,07/15/2021,"Twin Acres Ice cream","Food : Restaurants","Food","Restaurants","",$26.94,$0.00,-$3621.81
"Discover",,U,,07/17/2021,"speedway","Transportation : Gas","Transportation","Gas","",$35.42,$0.00,-$3657.23
"Discover",,U,,07/17/2021,"Heritage museaum and gardens","Recreation : Entertainment","Recreation","Entertainment","Joan and Nick",$40.00,$0.00,-$3697.23
"Discover",,U,,07/17/2021,"trader Joes","Food : Groceries","Food","Groceries","",$217.53,$0.00,-$3914.76
"Discover",,U,,07/19/2021,"VVRMC Del Rio Tx","Personal : Doctor, Dentist","Personal","Doctor, Dentist","",$229.25,$0.00,-$4144.01
"Discover",,U,,07/20/2021,"Lhakpa Sonam","Recreation : Entertainment","Recreation","Entertainment","",$20.00,$0.00,-$4164.01
"Discover",,U,,07/20/2021,"Amazon","RV : Equipment/Supplies","RV","Equipment/Supplies","",$29.74,$0.00,-$4193.75
"Discover",,U,,07/20/2021,"Cobies","Food : Restaurants","Food","Restaurants","",$30.66,$0.00,-$4224.41
"Discover",,U,,07/21/2021,"cvs","RV : Equipment/Supplies","RV","Equipment/Supplies","Batteries",$7.43,$0.00,-$4231.84
"Discover",,U,,07/21/2021,"cvs","Personal : Prescriptions, Medicine","Personal","Prescriptions, Medicine","",$10.00,$0.00,-$4241.84
"Discover",,U,,07/22/2021,"star laundry","RV : Laundry","RV","Laundry","",$5.50,$0.00,-$4247.34
"Discover",,U,,07/22/2021,"star laundry","RV : Laundry","RV","Laundry","",$11.00,$0.00,-$4258.34
"Discover",,U,,07/22/2021,"Brewstar Hardware Store","RV : Equipment/Supplies","RV","Equipment/Supplies","",$16.34,$0.00,-$4274.68
"Discover",,U,,07/22/2021,"stop & shop","Food : Groceries","Food","Groceries","",$171.28,$0.00,-$4445.96
"Discover",,U,,07/26/2021,"redbox","Recreation : Entertainment","Recreation","Entertainment","",$4.08,$0.00,-$4450.04
"Discover",,U,,07/26/2021,"colombos","Food : Restaurants","Food","Restaurants","",$13.85,$0.00,-$4463.89
"Discover",,U,,07/26/2021,"allium hyannis","Personal : Gifts","Personal","Gifts","",$21.25,$0.00,-$4485.14
"Discover",,U,,07/26/2021,"speedway","Transportation : Gas","Transportation","Gas","",$38.94,$0.00,-$4524.08
"Discover",,U,,07/26/2021,"shaw's Market","Food : Groceries","Food","Groceries","",$47.14,$0.00,-$4571.22
"Discover",,U,,07/27/2021,"stop & shop","Food : Groceries","Food","Groceries","",$5.43,$0.00,-$4576.65
"Discover",,U,,07/27/2021,"Sweetwater Sound","Recreation : Entertainment","Recreation","Entertainment","",$5.83,$0.00,-$4582.48
"Discover",,U,,07/28/2021,"Nytimes","Recreation : Entertainment","Recreation","Entertainment","",$4.00,$0.00,-$4586.48
"Discover",,U,,07/28/2021,"cvs","Personal : Prescriptions, Medicine","Personal","Prescriptions, Medicine","",$6.30,$0.00,-$4592.78
"Discover",,U,,07/28/2021,"sweetwater","RV : Equipment/Supplies","RV","Equipment/Supplies","",$7.96,$0.00,-$4600.74
"Discover",,U,,07/28/2021,"great call","Financial Help : Mom And Dad","Financial Help","Mom And Dad","",$36.87,$0.00,-$4637.61
"Discover",,U,,07/28/2021,"Amazon","RV : Equipment/Supplies","RV","Equipment/Supplies","",$84.99,$0.00,-$4722.60
"Discover",,U,,07/28/2021,"bidmc","Personal : Doctor, Dentist","Personal","Doctor, Dentist","",$128.00,$0.00,-$4850.60
"Discover",,U,,07/29/2021,"itunes","Recreation : Entertainment","Recreation","Entertainment","",$2.99,$0.00,-$4853.59
"Discover",,U,,07/29/2021,"Captain Frosty","Food : Restaurants","Food","Restaurants","",$23.22,$0.00,-$4876.81
"Discover",,U,,07/29/2021,"Amazon","RV : Equipment/Supplies","RV","Equipment/Supplies","",$58.96,$0.00,-$4935.77
"Discover",,U,,07/29/2021,"Safety Insurance","Transportation : Car Insurance","Transportation","Car Insurance","",$1410.95,$0.00,-$6346.72
"Discover",,U,,07/30/2021,"CTS HYANNIS","RV : Equipment/Supplies","RV","Equipment/Supplies","",$3.18,$0.00,-$6349.90
"Discover",,U,,07/30/2021,"Cumberland Farms","Transportation : Gas","Transportation","Gas","",$38.18,$0.00,-$6388.08
"Discover",,U,,07/30/2021,"the breakfast room","Food : Restaurants","Food","Restaurants","",$41.94,$0.00,-$6430.02
"Discover",,U,,07/30/2021,"cvs","RV : Equipment/Supplies","RV","Equipment/Supplies","",$71.49,$0.00,-$6501.51
"Discover",,U,,07/31/2021,"Wellfleet Theatres","Food : Restaurants","Food","Restaurants","",$21.68,$0.00,-$6523.19
"Discover",,U,,07/31/2021,"SCOOP N SCOOPS","Food : Restaurants","Food","Restaurants","",$28.46,$0.00,-$6551.65
"Discover",,U,,07/31/2021,"Wellfleet Theatres","Food : Restaurants","Food","Restaurants","",$31.29,$0.00,-$6582.94
"Discover",,U,,07/31/2021,"Wellfleet Theatres","Recreation : Entertainment","Recreation","Entertainment","",$47.00,$0.00,-$6629.94
"Discover",,U,,07/31/2021,"MACS EATHAM","Food : Restaurants","Food","Restaurants","",$87.74,$0.00,-$6717.68
"Discover",,U,,07/31/2021,"airbnb","RV : Hotel","RV","Hotel","",$2173.74,$0.00,-$8891.42
"Discover",,U,,08/01/2021,"underground bakery","Food : Restaurants","Food","Restaurants","",$40.38,$0.00,-$8931.80
"Discover",,U,,08/02/2021,"cape cod t-shirt","Personal : cloths","Personal","cloths","",$30.00,$0.00,-$8961.80
"Discover",,U,,08/02/2021,"Shell","Transportation : Gas","Transportation","Gas","",$38.46,$0.00,-$9000.26
"Discover",,U,,08/02/2021,"anejo mexican","Food : Restaurants","Food","Restaurants","big Beach Tree in Hyannis with Alyssa",$81.41,$0.00,-$9081.67
"Discover",,U,,08/03/2021,"dollor tree","RV : Equipment/Supplies","RV","Equipment/Supplies","",$5.06,$0.00,-$9086.73
"Discover",,U,,08/03/2021,"star laundry","RV : Laundry","RV","Laundry","",$6.50,$0.00,-$9093.23
"Discover",,U,,08/03/2021,"star laundry","RV : Laundry","RV","Laundry","",$11.00,$0.00,-$9104.23
"Discover",,U,,08/03/2021,"cvs","Personal : Prescriptions, Medicine","Personal","Prescriptions, Medicine","",$20.00,$0.00,-$9124.23
"Discover",,U,,08/03/2021,"alzheihmers association","Charity : Other","Charity","Other","sherri ride",$100.00,$0.00,-$9224.23
"Discover",,U,,08/03/2021,"csisco kithchen and bar","Food : Restaurants","Food","Restaurants","with G&G!",$191.00,$0.00,-$9415.23
"Discover",,U,,08/04/2021,"trader Joes","Food : Groceries","Food","Groceries","",$7.38,$0.00,-$9422.61
"Discover",,U,,08/04/2021,"trader Joes","Food : Groceries","Food","Groceries","",$91.16,$0.00,-$9513.77
"Discover",,U,,08/06/2021,"Transfer : Dcu Checking",,,,"",$0.00,$3289.92,-$6223.85
"Discover",,U,,08/06/2021,"exxon hingham",,,,"",$39.03,$0.00,-$6262.88
"Discover",,U,,08/07/2021,"shipwreck","Food : Restaurants","Food","Restaurants","",$23.17,$0.00,-$6286.05
"Discover",,U,,08/08/2021,"Barrs in Chatham","Food : Restaurants","Food","Restaurants","",$22.66,$0.00,-$6308.71
"Discover",,U,,08/09/2021,"stop & shop","Food : Groceries","Food","Groceries","",$129.74,$0.00,-$6438.45
"Discover",,U,,08/13/2021,"USPS","RV : Equipment/Supplies","RV","Equipment/Supplies","",$15.00,$0.00,-$6453.45
"Discover",,U,,08/13/2021,"CTS West Dennis","Personal : Gifts","Personal","Gifts","",$17.00,$0.00,-$6470.45
"Discover",,U,,08/13/2021,"El Pathrom Authentic Mexican Brewster","Food : Restaurants","Food","Restaurants","",$175.84,$0.00,-$6646.29
"Discover",,U,,08/15/2021,"netflix","Recreation : Entertainment","Recreation","Entertainment","",$13.99,$0.00,-$6660.28
"Discover",,U,,08/15/2021,"peterson market dennis","Food : Groceries","Food","Groceries","",$20.49,$0.00,-$6680.77
"Discover",,U,,08/15/2021,"peterson market dennis","Food : Groceries","Food","Groceries","",$20.70,$0.00,-$6701.47
"Discover",,U,,08/15/2021,"caringbridge","Charity : Other","Charity","Other","",$25.00,$0.00,-$6726.47
"Discover",,U,,08/15/2021,"peterson market dennis","Food : Groceries","Food","Groceries","",$41.86,$0.00,-$6768.33
"Discover",,U,,08/18/2021,"cvs","Personal : Prescriptions, Medicine","Personal","Prescriptions, Medicine","",$6.00,$0.00,-$6774.33
"Discover",,U,,08/18/2021,"katies' ice cream","Food : Restaurants","Food","Restaurants","",$6.11,$0.00,-$6780.44
"Discover",,U,,08/18/2021,"anejo Miexican bistro","Food : Restaurants","Food","Restaurants","",$75.00,$0.00,-$6855.44
"Discover",,U,,08/18/2021,"monroe motors","Transportation : Repairs & Maintenance","Transportation","Repairs & Maintenance","",$591.88,$0.00,-$7447.32
"Discover",,U,,08/19/2021,"USA  star","RV : Laundry","RV","Laundry","",$5.50,$0.00,-$7452.82
"Discover",,U,,08/19/2021,"walgreens","RV : Equipment/Supplies","RV","Equipment/Supplies","",$6.36,$0.00,-$7459.18
"Discover",,U,,08/19/2021,"USA  star","RV : Laundry","RV","Laundry","",$11.00,$0.00,-$7470.18
"Discover",,U,,08/19/2021,"eat cake for breakfast","Food : Restaurants","Food","Restaurants","",$26.40,$0.00,-$7496.58
"Discover",,U,,08/19/2021,"Nancies Candy","Personal : Gifts","Personal","Gifts","",$27.55,$0.00,-$7524.13
"Discover",,U,,08/19/2021,"Kates seafood","Food : Restaurants","Food","Restaurants","",$28.95,$0.00,-$7553.08
"Discover",,U,,08/19/2021,"chatham pier fish","Food : Restaurants","Food","Restaurants","",$52.01,$0.00,-$7605.09
"Discover",,U,,08/20/2021,"pizza shark","Food : Restaurants","Food","Restaurants","",$20.00,$0.00,-$7625.09
"Discover",,U,,08/20/2021,"bits and pieces","Recreation : Entertainment","Recreation","Entertainment","",$76.73,$0.00,-$7701.82
"Discover",,U,,08/20/2021,"trader Joes","Food : Groceries","Food","Groceries","",$103.80,$0.00,-$7805.62
"Discover",,U,,08/21/2021,"cvs","Personal : Prescriptions, Medicine","Personal","Prescriptions, Medicine","",$10.00,$0.00,-$7815.62
"Discover",,U,,08/21/2021,"Shell","RV : gasoline","RV","gasoline","",$125.00,$0.00,-$7940.62
"Discover",,U,,08/23/2021,"Boothbay lobster","Food : Restaurants","Food","Restaurants","",$95.94,$0.00,-$8036.56
"Discover",,U,,08/25/2021,"Nytimes","Recreation : Entertainment","Recreation","Entertainment","",$4.00,$0.00,-$8040.56
"Discover",,U,,08/26/2021,"hmpf hermatology","Personal : Doctor, Dentist","Personal","Doctor, Dentist","",$18.00,$0.00,-$8058.56
"Discover",,U,,08/26/2021,"rideforfood","Charity : Other","Charity","Other","",$103.20,$0.00,-$8161.76
"Discover",,U,,08/27/2021,"SHermans boothbay","Food : Restaurants","Food","Restaurants","",$19.46,$0.00,-$8181.22
"Discover",,C,,08/28/2021,"tugboat inn","Food : Restaurants","Food","Restaurants","",$177.96,$0.00,-$8359.18
"Discover",,U,,08/29/2021,"itunes","Recreation : Entertainment","Recreation","Entertainment","",$2.99,$0.00,-$8362.17
"Discover",,U,,08/29/2021,"Blanchard's Creamary","Food : Restaurants","Food","Restaurants","",$25.42,$0.00,-$8387.59
"Discover",,U,,08/30/2021,"great call","Financial Help : Mom And Dad","Financial Help","Mom And Dad","",$36.87,$0.00,-$8424.46
"Discover",,U,,08/30/2021,"Harry and david","Personal : Gifts","Personal","Gifts","FOR Barbara",$48.98,$0.00,-$8473.44
"Discover",,U,,08/30/2021,"silvertown towing","Transportation : Repairs & Maintenance","Transportation","Repairs & Maintenance","",$78.00,$0.00,-$8551.44
"Discover",,U,,08/30/2021,"silver town cloud towing","Transportation : Repairs & Maintenance","Transportation","Repairs & Maintenance","",$98.80,$0.00,-$8650.24
"Discover",,U,,08/31/2021,"Sweetwater camground","RV : Campgrounds","RV","Campgrounds","",$5.98,$0.00,-$8656.22
"Discover",,U,,09/01/2021,"gas hyannis","Transportation : Gas","Transportation","Gas","",$37.55,$0.00,-$8693.77
"Discover",,U,,09/01/2021,"trader Joes","Food : Groceries","Food","Groceries","",$198.63,$0.00,-$8892.40
"Discover",,U,,09/01/2021,"Brewster service center","Transportation : Repairs & Maintenance","Transportation","Repairs & Maintenance","",$552.23,$0.00,-$9444.63
"Discover",,U,,09/02/2021,"cvs","Personal : Prescriptions, Medicine","Personal","Prescriptions, Medicine","",$6.30,$0.00,-$9450.93
"Discover",,U,,09/02/2021,"cvs","Personal : Prescriptions, Medicine","Personal","Prescriptions, Medicine","",$11.19,$0.00,-$9462.12
"Discover",,U,,09/05/2021,"cvs","Personal : Prescriptions, Medicine","Personal","Prescriptions, Medicine","",$10.00,$0.00,-$9472.12
"Discover",,U,,09/05/2021,"Brewster book store","Recreation : Entertainment","Recreation","Entertainment","",$25.99,$0.00,-$9498.11
"Discover",,U,,09/05/2021,"cvs","Personal : Prescriptions, Medicine","Personal","Prescriptions, Medicine","",$48.31,$0.00,-$9546.42
"Discover",,U,,09/06/2021,"Transfer : Dcu Checking",,,,"",$0.00,$6614.29,-$2932.13
"Discover",,U,,09/06/2021,"Gas dennis","Transportation : Gas","Transportation","Gas","",$19.20,$0.00,-$2951.33
"Discover",,U,,09/08/2021,"star laundry","RV : Laundry","RV","Laundry","",$14.25,$0.00,-$2965.58
"Discover",,U,,09/08/2021,"Brewster service center","Transportation : Repairs & Maintenance","Transportation","Repairs & Maintenance","",$1045.77,$0.00,-$4011.35
"Discover",,U,,09/09/2021,"gas plymouth","Transportation : Gas","Transportation","Gas","",$24.32,$0.00,-$4035.67
"Discover",,U,,09/09/2021,"Baskin's Hardware","RV : Equipment/Supplies","RV","Equipment/Supplies","",$32.04,$0.00,-$4067.71
"Discover",,U,,09/10/2021,"stop & shop","Food : Groceries","Food","Groceries","",$180.50,$0.00,-$4248.21
"Discover",,U,,09/11/2021,"redbox","Recreation : Entertainment","Recreation","Entertainment","",$1.97,$0.00,-$4250.18
"Discover",,U,,09/11/2021,"sweetwater","RV : Equipment/Supplies","RV","Equipment/Supplies",,$8.98,$0.00,-$4259.16
"Discover",,U,,09/11/2021,"Ring Bros Market","Food : Groceries","Food","Groceries","",$27.23,$0.00,-$4286.39
"Discover",,U,,09/11/2021,"Sweetwater camground","RV : Campgrounds","RV","Campgrounds",,$598.00,$0.00,-$4884.39
"Discover",,U,,09/12/2021,"cvs","Personal : Prescriptions, Medicine","Personal","Prescriptions, Medicine","",$20.00,$0.00,-$4904.39
"Discover",,U,,09/12/2021,"stop & shop","Food : Groceries","Food","Groceries","",$69.44,$0.00,-$4973.83
"Discover",,U,,09/13/2021,"Amazon","RV : Equipment/Supplies","RV","Equipment/Supplies","",$13.80,$0.00,-$4987.63
"Discover",,U,,09/13/2021,"Amazon","RV : Equipment/Supplies","RV","Equipment/Supplies","",$57.68,$0.00,-$5045.31
"Discover",,U,,09/15/2021,"netflix","Recreation : Entertainment","Recreation","Entertainment","",$13.99,$0.00,-$5059.30
"Discover",,U,,09/15/2021,"hot  chocalte Sparrow","Food : Restaurants","Food","Restaurants","",$18.37,$0.00,-$5077.67
"Discover",,U,,09/15/2021,"caringbridge","Charity : Other","Charity","Other","",$25.00,$0.00,-$5102.67
"Discover",,U,,09/16/2021,"Market bskt","Food : Groceries","Food","Groceries","",$33.24,$0.00,-$5135.91
"Discover",,U,,09/16/2021,"speedway","Transportation : Gas","Transportation","Gas","",$35.31,$0.00,-$5171.22
"Discover",,U,,09/18/2021,"linguines","Food : Restaurants","Food","Restaurants","",$58.69,$0.00,-$5229.91
"Discover",,U,,09/19/2021,"exxon harwich","Transportation : Gas","Transportation","Gas","",$41.55,$0.00,-$5271.46
"Discover",,U,,09/20/2021,"cape code hospital","Personal : Doctor, Dentist","Personal","Doctor, Dentist","",$16.20,$0.00,-$5287.66
"Discover",,U,,09/21/2021,"gigi house of pizza","Food : Restaurants","Food","Restaurants","",$29.08,$0.00,-$5316.74
"Discover",,U,,09/21/2021,"star market","Food : Groceries","Food","Groceries","",$72.00,$0.00,-$5388.74
"Discover",,U,,09/22/2021,"star laundry","RV : Laundry","RV","Laundry","",$6.75,$0.00,-$5395.49
"Discover",,U,,09/22/2021,"star laundry","RV : Laundry","RV","Laundry","",$14.50,$0.00,-$5409.99
"Discover",,U,,09/22/2021,"vaisakhi indian kitchen","Food : Restaurants","Food","Restaurants","brighton",$87.36,$0.00,-$5497.35
"Discover",,U,,09/23/2021,"redbox","Recreation : Entertainment","Recreation","Entertainment","",$2.13,$0.00,-$5499.48
"Discover",,U,,09/23/2021,"Nytimes","Recreation : Entertainment","Recreation","Entertainment","",$4.00,$0.00,-$5503.48
"Discover",,U,,09/23/2021,"Market bskt","Food : Groceries","Food","Groceries","",$71.19,$0.00,-$5574.67
"Discover",,U,,09/23/2021,"cisco kitchen","Food : Restaurants","Food","Restaurants","new bedford",$100.00,$0.00,-$5674.67
"Discover",,U,,09/25/2021,"stop & shop","Food : Groceries","Food","Groceries","",$111.81,$0.00,-$5786.48
"Discover",,U,,09/27/2021,"cvs","Personal : Prescriptions, Medicine","Personal","Prescriptions, Medicine","",$10.00,$0.00,-$5796.48
"Discover",,U,,09/28/2021,"lively","Financial Help : Mom And Dad","Financial Help","Mom And Dad","",$36.87,$0.00,-$5833.35
"Discover",,U,,09/29/2021,"redbox","Recreation : Entertainment","Recreation","Entertainment","",$1.97,$0.00,-$5835.32
"Discover",,U,,09/29/2021,"itunes","Recreation : Entertainment","Recreation","Entertainment","",$2.99,$0.00,-$5838.31
"Discover",,U,,09/29/2021,"Gas","Transportation : Gas","Transportation","Gas","middleboro",$38.74,$0.00,-$5877.05
"Discover",,U,,09/29/2021,"Walmart","RV : Equipment/Supplies","RV","Equipment/Supplies","",$58.13,$0.00,-$5935.18
"Discover",,U,,09/29/2021,"Market bskt","Food : Groceries","Food","Groceries","",$118.83,$0.00,-$6054.01
"Discover",,U,,10/01/2021,"easykey","RV : Equipment/Supplies","RV","Equipment/Supplies","new keys",$18.85,$0.00,-$6072.86
"Discover",,U,,10/01/2021,"Gas","Transportation : Gas","Transportation","Gas","south dennis",$26.33,$0.00,-$6099.19
"Discover",,U,,10/02/2021,"RMV","Transportation : Registration","Transportation","Registration","",$60.00,$0.00,-$6159.19
"Discover",,U,,10/03/2021,"star laundry","RV : Laundry","RV","Laundry","",$8.75,$0.00,-$6167.94
"Discover",,U,,10/03/2021,"Primary Care Cape Cod","Personal : Doctor, Dentist","Personal","Doctor, Dentist","",$10.00,$0.00,-$6177.94
"Discover",,U,,10/03/2021,"star laundry","RV : Laundry","RV","Laundry","",$14.50,$0.00,-$6192.44
"Discover",,U,,10/03/2021,"Gas","Transportation : Gas","Transportation","Gas","Mattapan",$47.52,$0.00,-$6239.96
"Discover",,U,,10/03/2021,"SOphia's grotto","Food : Restaurants","Food","Restaurants","marys birthday",$313.19,$0.00,-$6553.15
"Discover",,U,,10/04/2021,"Ferrettis market","Food : Groceries","Food","Groceries","",$13.37,$0.00,-$6566.52
"Discover",,U,,10/04/2021,"Amazon","RV : Equipment/Supplies","RV","Equipment/Supplies","",$39.60,$0.00,-$6606.12
"Discover",,U,,10/04/2021,"Ring Bors","Food : Restaurants","Food","Restaurants","",$60.83,$0.00,-$6666.95
"Discover",,U,,10/06/2021,"Transfer : Dcu Checking",,,,"",$0.00,$4953.83,-$1713.12
"Discover",,U,,10/06/2021,"Davidian Broethers","Food : Restaurants","Food","Restaurants","",$3.99,$0.00,-$1717.11
"Discover",,U,,10/06/2021,"subway","Food : Restaurants","Food","Restaurants","",$5.78,$0.00,-$1722.89
"Discover",,U,,10/06/2021,"chick-fil-a","Food : Restaurants","Food","Restaurants","",$14.27,$0.00,-$1737.16
"Discover",,U,,10/06/2021,"Amazon","RV : Equipment/Supplies","RV","Equipment/Supplies","",$18.05,$0.00,-$1755.21
"Discover",,U,,10/06/2021,"Gas","Transportation : Gas","Transportation","Gas","sagamore",$41.11,$0.00,-$1796.32
"Discover",,U,,10/07/2021,"cape abilities","Personal : Gifts","Personal","Gifts","",$41.42,$0.00,-$1837.74
"Discover",,U,,10/07/2021,"APT","Food : Restaurants","Food","Restaurants","",$43.00,$0.00,-$1880.74
"Discover",,U,,10/07/2021,"Cape cod trunk","RV : Maintenance","RV","Maintenance","",$322.46,$0.00,-$2203.20
"Discover",,U,,10/08/2021,"Opthanlmic consults","Personal : Doctor, Dentist","Personal","Doctor, Dentist","",$22.00,$0.00,-$2225.20
"Discover",,U,,10/08/2021,"On the mark","Recreation : Entertainment","Recreation","Entertainment","archery",$150.00,$0.00,-$2375.20
"Discover",,U,,10/09/2021,"cmsvend","Food : Restaurants","Food","Restaurants","",$2.60,$0.00,-$2377.80
"Discover",,U,,10/09/2021,"","Personal : Gifts","Personal","Gifts","",$21.25,$0.00,-$2399.05
"Discover",,U,,10/09/2021,"Chilacotes","Food : Restaurants","Food","Restaurants","",$49.95,$0.00,-$2449.00
"Discover",,U,,10/10/2021,"Gas","Transportation : Gas","Transportation","Gas","harwich",$43.19,$0.00,-$2492.19
"Discover",,U,,10/10/2021,"Captain Frosty","Food : Restaurants","Food","Restaurants","",$97.20,$0.00,-$2589.39
"Discover",,U,,10/11/2021,"cvs","Personal : Prescriptions, Medicine","Personal","Prescriptions, Medicine","",$13.00,$0.00,-$2602.39
"Discover",,U,,10/11/2021,"stop & shop","Food : Groceries","Food","Groceries","",$22.24,$0.00,-$2624.63
"Discover",,U,,10/12/2021,"Daily Paper","Food : Restaurants","Food","Restaurants","",$14.18,$0.00,-$2638.81
"Discover",,U,,10/12/2021,"The Sandwich Man","Food : Restaurants","Food","Restaurants","Harrisburg PA - ON way to visit Guido",$17.91,$0.00,-$2656.72
"Discover",,U,,10/12/2021,"Amazon","RV : Equipment/Supplies","RV","Equipment/Supplies","",$25.95,$0.00,-$2682.67
"Discover",,U,,10/12/2021,"Gas","Transportation : Gas","Transportation","Gas","buzzards bay MA",$26.97,$0.00,-$2709.64
"Discover",,U,,10/12/2021,"Gas","Transportation : Gas","Transportation","Gas","Boonton NJ on way to visit guido",$29.29,$0.00,-$2738.93
"Discover",,U,,10/13/2021,"Natural Bride State Park","Recreation : Entertainment","Recreation","Entertainment","6477 S Lee Hwy, Natural Bridge, VA 24578",$18.00,$0.00,-$2756.93
"Discover",,U,,10/13/2021,"Gas","Transportation : Gas","Transportation","Gas","Stephens City VA (guido visit)",$32.04,$0.00,-$2788.97
"Discover",,U,,10/13/2021,"Gas","Transportation : Gas","Transportation","Gas","Greenville TN (guido visit)",$38.20,$0.00,-$2827.17
"Discover",,U,,10/13/2021,"Athena Inn Chattanooga TN","RV : Hotel","RV","Hotel","Chattanooga TN",$63.19,$0.00,-$2890.36
"Discover",,U,,10/13/2021,"Holiday inn","RV : Hotel","RV","Hotel","Stephens City VA (GUido)",$107.70,$0.00,-$2998.06
"Discover",,U,,10/14/2021,"Cracker Barrel","Food : Restaurants","Food","Restaurants","Trussvile AL",$21.71,$0.00,-$3019.77
"Discover",,U,,10/14/2021,"Gas","Transportation : Gas","Transportation","Gas","Trussville AL",$34.83,$0.00,-$3054.60
"Discover",,U,,10/14/2021,"Gas","Transportation : Gas","Transportation","Gas","Picayone MS",$34.85,$0.00,-$3089.45
"Discover",,U,,10/14/2021,"Walmart","RV : Equipment/Supplies","RV","Equipment/Supplies","Picayune MS (TIre pump)",$58.68,$0.00,-$3148.13
"Discover",,U,,10/14/2021,"Kaisen","Food : Restaurants","Food","Restaurants","Knoxville TN",$60.27,$0.00,-$3208.40
"Discover",,U,,10/14/2021,"BRQ Seafood and BBQ","Food : Restaurants","Food","Restaurants","Baton rouge LA",$92.96,$0.00,-$3301.36
"Discover",,U,,10/14/2021,"Hibbet Sport","Personal : cloths","Personal","cloths","Running Shoes Picayune MS",$96.30,$0.00,-$3397.66
"Discover",,U,,10/14/2021,"Super 8","RV : Hotel","RV","Hotel","Baton Rouge LA",$115.00,$0.00,-$3512.66
"Discover",,U,,10/15/2021,"netflix","Recreation : Entertainment","Recreation","Entertainment","",$13.99,$0.00,-$3526.65
"Discover",,U,,10/15/2021,"Mass general Brigham","Personal : Doctor, Dentist","Personal","Doctor, Dentist","",$18.00,$0.00,-$3544.65
"Discover",,U,,10/15/2021,"Waffle House","Food : Restaurants","Food","Restaurants","Baton Rouge LA",$18.00,$0.00,-$3562.65
"Discover",,U,,10/15/2021,"caringbridge","Charity : Other","Charity","Other","",$25.00,$0.00,-$3587.65
"Discover",,U,,10/15/2021,"Gas","Transportation : Gas","Transportation","Gas","IOWA LA",$27.38,$0.00,-$3615.03
"Discover",,U,,10/15/2021,"Krogers","Food : Groceries","Food","Groceries","Houston",$36.13,$0.00,-$3651.16
"Discover",,U,,10/15/2021,"Royal Thai Cookery","Food : Restaurants","Food","Restaurants","Houston",$43.27,$0.00,-$3694.43
"Discover",,U,,10/15/2021,"Tire Kingdon","Transportation : Repairs & Maintenance","Transportation","Repairs & Maintenance","New back Tires Baton Roune LA",$472.03,$0.00,-$4166.46
"Discover",,U,,10/16/2021,"UT  MDACC","Food : Restaurants","Food","Restaurants","Coffee at MD anderson",$2.65,$0.00,-$4169.11
"Discover",,U,,10/16/2021,"Hu''s cooking","Food : Restaurants","Food","Restaurants","Houston",$50.02,$0.00,-$4219.13
"Discover",,U,,10/17/2021,"Liberty Taco","Food : Restaurants","Food","Restaurants","Houston",$22.25,$0.00,-$4241.38
"Discover",,U,,10/17/2021,"Royal Thai Cookery","Food : Restaurants","Food","Restaurants","Houston",$36.20,$0.00,-$4277.58
"Discover",,U,,10/18/2021,"Krogers","Food : Groceries","Food","Groceries","",$2.87,$0.00,-$4280.45
"Discover",,U,,10/18/2021,"USPS","RV : Equipment/Supplies","RV","Equipment/Supplies","Houston",$11.60,$0.00,-$4292.05
"Discover",,U,,10/18/2021,"HMNS store","Personal : Gifts","Personal","Gifts","Houston (Museum store)",$16.18,$0.00,-$4308.23
"Discover",,U,,10/18/2021,"Houston Museum of natural History","Recreation : Entertainment","Recreation","Entertainment","",$32.00,$0.00,-$4340.23
"Discover",,U,,10/18/2021,"Aladdin Meditrerrain","Food : Restaurants","Food","Restaurants","Houston (Reall y  - Cafe style with Eilleen)",$57.48,$0.00,-$4397.71
"Discover",,U,,10/19/2021,"Liberty Taco","Food : Restaurants","Food","Restaurants","Houston",$33.09,$0.00,-$4430.80
"Discover",,U,,10/19/2021,"Asahi Sushi","Food : Restaurants","Food","Restaurants","Houston",$42.92,$0.00,-$4473.72
"Discover",,U,,10/20/2021,"Nytimes","Recreation : Entertainment","Recreation","Entertainment","",$4.00,$0.00,-$4477.72
"Discover",,U,,10/20/2021,"Krogers","Food : Groceries","Food","Groceries","Houston",$7.14,$0.00,-$4484.86
"Discover",,U,,10/20/2021,"Krogers","Food : Groceries","Food","Groceries","houston",$7.56,$0.00,-$4492.42
"Discover",,U,,10/20/2021,"Tower hill botanic","Recreation : Entertainment","Recreation","Entertainment","",$13.80,$0.00,-$4506.22
"Discover",,U,,10/20/2021,"Mod Pizza","Food : Restaurants","Food","Restaurants","Fairfield Texas",$22.85,$0.00,-$4529.07
"Discover",,U,,10/20/2021,"Gas","Transportation : Gas","Transportation","Gas","BUc-ees Waller Texas",$27.31,$0.00,-$4556.38
"Discover",,U,,10/20/2021,"potbelly","Food : Restaurants","Food","Restaurants","Houston",$28.85,$0.00,-$4585.23
"Discover",,U,,10/20/2021,"Gas","Transportation : Gas","Transportation","Gas","Chappel Hill Texas",$31.42,$0.00,-$4616.65
"Discover",,U,,10/20/2021,"Royal Thai Cookery","Food : Restaurants","Food","Restaurants","Houston",$39.56,$0.00,-$4656.21
"Discover",,U,,10/20/2021,"Amazon","RV : Equipment/Supplies","RV","Equipment/Supplies","",$72.22,$0.00,-$4728.43
"Discover",,U,,10/22/2021,"Krogers","Food : Groceries","Food","Groceries","",$12.80,$0.00,-$4741.23
"Discover",,U,,10/22/2021,"Tower hill botanic","Recreation : Entertainment","Recreation","Entertainment","?? Ask Lisa",$13.80,$0.00,-$4755.03
"Discover",,U,,10/22/2021,"Guadalajara Mexican","Food : Restaurants","Food","Restaurants","Lisa BDAY with Marta Houston",$96.92,$0.00,-$4851.95
"Discover",,U,,10/23/2021,"HouMD PMS Houston TX","Recreation : Entertainment","Recreation","Entertainment","??",$8.00,$0.00,-$4859.95
"Discover",,U,,10/23/2021,"Tower hill botanic","Recreation : Entertainment","Recreation","Entertainment","",$13.80,$0.00,-$4873.75
"Discover",,U,,10/24/2021,"Krogers","Food : Groceries","Food","Groceries","",$3.19,$0.00,-$4876.94
"Discover",,U,,10/24/2021,"cvs","Personal : Prescriptions, Medicine","Personal","Prescriptions, Medicine","",$20.97,$0.00,-$4897.91
"Discover",,U,,10/24/2021,"Flowers & Cream","Food : Restaurants","Food","Restaurants","Houston",$22.08,$0.00,-$4919.99
"Discover",,U,,10/24/2021,"Krogers","Food : Groceries","Food","Groceries","",$35.03,$0.00,-$4955.02
"Discover",,U,,10/24/2021,"MFAH Guest SErvices","Recreation : Entertainment","Recreation","Entertainment","Museum of fine arts Houston",$38.00,$0.00,-$4993.02
"Discover",,U,,10/24/2021,"Mo Better Brews","Food : Restaurants","Food","Restaurants","Vegan Place in Houston",$50.66,$0.00,-$5043.68
"Discover",,U,,10/25/2021,"Hobby Lobby","Recreation : Entertainment","Recreation","Entertainment","Rope for guy drawig stuff for me Houston",$42.80,$0.00,-$5086.48
"Discover",,U,,10/26/2021,"sprouts","Food : Groceries","Food","Groceries","Houston",$0.00,$5.49,-$5080.99
"Discover",,U,,10/26/2021,"sprouts","Food : Groceries","Food","Groceries","",$26.94,$0.00,-$5107.93
"Discover",,U,,10/26/2021,"HouMD PMS Houston TX","RV : Hotel","RV","Hotel","Court Yard Houston",$1066.10,$0.00,-$6174.03
"Discover",,U,,10/27/2021,"Pho Fix","Food : Restaurants","Food","Restaurants","Hosuton (down town takeout place)",$40.27,$0.00,-$6214.30
"Discover",,U,,10/27/2021,"Romanos Flying Pizza","Food : Restaurants","Food","Restaurants","Houston",$66.29,$0.00,-$6280.59
"Discover",,U,,10/28/2021,"Krogers","Food : Groceries","Food","Groceries","",$3.19,$0.00,-$6283.78
"Discover",,U,,10/28/2021,"potbelly","Food : Restaurants","Food","Restaurants","Houston",$14.92,$0.00,-$6298.70
"Discover",,U,,10/28/2021,"Krogers","Food : Groceries","Food","Groceries","",$27.37,$0.00,-$6326.07
"Discover",,U,,10/28/2021,"Damicos Italian Market","Food : Restaurants","Food","Restaurants","Houston - Good Italian Place",$30.52,$0.00,-$6356.59
"Discover",,U,,10/29/2021,"itunes","Recreation : Entertainment","Recreation","Entertainment","",$2.99,$0.00,-$6359.58
"Discover",,U,,10/29/2021,"McDonalds","Food : Restaurants","Food","Restaurants","Orange TX",$9.82,$0.00,-$6369.40
"Discover",,U,,10/29/2021,"Gas","Transportation : Gas","Transportation","Gas","Heidelberg MS",$18.63,$0.00,-$6388.03
"Discover",,U,,10/29/2021,"Gas","Transportation : Gas","Transportation","Gas","Hammond LA",$23.61,$0.00,-$6411.64
"Discover",,U,,10/29/2021,"Gas","Transportation : Gas","Transportation","Gas","Houston",$32.14,$0.00,-$6443.78
"Discover",,U,,10/29/2021,"Barneys Roadhouse","Food : Restaurants","Food","Restaurants","Gadsden Al (takeout near motel)",$46.00,$0.00,-$6489.78
"Discover",,U,,10/30/2021,"Gas","Transportation : Gas","Transportation","Gas","Knoxville TN",$1.30,$0.00,-$6491.08
"Discover",,U,,10/30/2021,"dunkin donuts","Food : Restaurants","Food","Restaurants","Hampton NJ",$8.08,$0.00,-$6499.16
"Discover",,U,,10/30/2021,"GOlden Corrall","Food : Restaurants","Food","Restaurants","Hagertown MD",$9.11,$0.00,-$6508.27
"Discover",,U,,10/30/2021,"Gas","Transportation : Gas","Transportation","Gas","Knoxville TN",$13.50,$0.00,-$6521.77
"Discover",,U,,10/30/2021,"Gas","Transportation : Gas","Transportation","Gas","New Market VA",$15.38,$0.00,-$6537.15
"Discover",,U,,10/30/2021,"Gas","Transportation : Gas","Transportation","Gas","Mount Vernon NY",$26.43,$0.00,-$6563.58
"Discover",,U,,10/30/2021,"Gas","Transportation : Gas","Transportation","Gas","Raphine VA",$36.07,$0.00,-$6599.65
"Discover",,U,,10/30/2021,"Gas","Transportation : Gas","Transportation","Gas","Chattanooga TN",$37.78,$0.00,-$6637.43
"Discover",,U,,10/30/2021,"Gas","Transportation : Gas","Transportation","Gas","Bloomsbury NJ",$39.10,$0.00,-$6676.53
"Discover",,U,,10/30/2021,"Courtyard","RV : Hotel","RV","Hotel","Houston",$429.64,$0.00,-$7106.17
"Discover",,U,,10/31/2021,"CCi Hotel RES","RV : Hotel","RV","Hotel","",$0.00,$14.78,-$7091.39
"Discover",,U,,10/31/2021,"chipolte","Food : Restaurants","Food","Restaurants","Groton CT",$22.70,$0.00,-$7114.09
"Discover",,U,,10/31/2021,"country inn suites","RV : Hotel","RV","Hotel","Hagerstown MD",$119.96,$0.00,-$7234.05
"Discover",,U,,11/01/2021,"Lobos Pizza","Food : Restaurants","Food","Restaurants","Falmouth",$23.38,$0.00,-$7257.43
"Discover",,U,,11/01/2021,"CCi Hotel RES","RV : Hotel","RV","Hotel","",$147.83,$0.00,-$7405.26
"Discover",,U,,11/02/2021,"espn Plus","Recreation : Entertainment","Recreation","Entertainment","",$6.99,$0.00,-$7412.25
"Discover",,U,,11/02/2021,"star market","Food : Groceries","Food","Groceries","",$23.03,$0.00,-$7435.28
"Discover",,U,,11/02/2021,"Gas","Transportation : Gas","Transportation","Gas","Falmouth",$40.33,$0.00,-$7475.61
"Discover",,U,,11/02/2021,"Delfino","Food : Restaurants","Food","Restaurants","",$161.59,$0.00,-$7637.20
"Discover",,U,,11/03/2021,"walgreens","Personal : Prescriptions, Medicine","Personal","Prescriptions, Medicine","",$7.43,$0.00,-$7644.63
"Discover",,U,,11/03/2021,"cvs","Personal : Prescriptions, Medicine","Personal","Prescriptions, Medicine","Falmouth",$12.50,$0.00,-$7657.13
"Discover",,U,,11/03/2021,"peterson market dennis","Food : Groceries","Food","Groceries","",$14.53,$0.00,-$7671.66
"Discover",,U,,11/03/2021,"Cumberland Farms","Transportation : Gas","Transportation","Gas","south denns",$27.10,$0.00,-$7698.76
"Discover",,U,,11/03/2021,"Roche Brothers","Food : Groceries","Food","Groceries","Mashpee",$30.86,$0.00,-$7729.62
"Discover",,U,,11/03/2021,"monroe motors","Transportation : Repairs & Maintenance","Transportation","Repairs & Maintenance","",$68.72,$0.00,-$7798.34
"Discover",,U,,11/04/2021,"A slice of italy","Food : Restaurants","Food","Restaurants","Falmouth",$26.28,$0.00,-$7824.62
"Discover",,U,,11/04/2021,"stop & shop","Food : Groceries","Food","Groceries","",$242.86,$0.00,-$8067.48
"Discover",,U,,11/05/2021,"Falmouth Food Mart","Food : Groceries","Food","Groceries","",$10.49,$0.00,-$8077.97
"Discover",,U,,11/05/2021,"stop & shop","Food : Groceries","Food","Groceries","cotuit",$23.07,$0.00,-$8101.04
"Discover",,U,,11/06/2021,"Transfer : Dcu Checking",,,,"",$0.00,$2664.76,-$5436.28
"Discover",,U,,11/06/2021,"CAPE COD HOSPITIAL","Personal : Doctor, Dentist","Personal","Doctor, Dentist","",$0.00,$16.20,-$5420.08
"Discover",,U,,11/06/2021,"stop & shop","Food : Groceries","Food","Groceries","watertown",$17.98,$0.00,-$5438.06
"Discover",,U,,11/06/2021,"Gas","Transportation : Gas","Transportation","Gas","Falmouth",$44.29,$0.00,-$5482.35
"Discover",,U,,11/07/2021,"Thai Amarin","Food : Restaurants","Food","Restaurants","Newton Ma",$36.49,$0.00,-$5518.84
"Discover",,U,,11/08/2021,"CTS HYANNIS","Personal : Gifts","Personal","Gifts","",$25.44,$0.00,-$5544.28
"Discover",,U,,11/08/2021,"Kohls","Personal : cloths","Personal","cloths","",$40.99,$0.00,-$5585.27
"Discover",,U,,11/08/2021,"trader Joes","Food : Groceries","Food","Groceries","",$116.01,$0.00,-$5701.28
"Discover",,U,,11/10/2021,"Amazon","RV : Equipment/Supplies","RV","Equipment/Supplies","",$14.19,$0.00,-$5715.47
"Discover",,U,,11/11/2021,"Gas","Transportation : Gas","Transportation","Gas","",$39.25,$0.00,-$5754.72
"Discover",,U,,11/11/2021,"shaw's Market","Food : Groceries","Food","Groceries","falmouth",$66.89,$0.00,-$5821.61
"Discover",,U,,11/12/2021,"lakeview rv resort","RV : Campgrounds","RV","Campgrounds","",$402.00,$0.00,-$6223.61
"Discover",,U,,11/14/2021,"Gas","Transportation : Gas","Transportation","Gas","middleboro",$38.95,$0.00,-$6262.56
"Discover",,U,,11/15/2021,"Cash Market","Food : Restaurants","Food","Restaurants","Burritos",$12.29,$0.00,-$6274.85
"Discover",,U,,11/15/2021,"netflix","Recreation : Entertainment","Recreation","Entertainment","",$13.99,$0.00,-$6288.84
"Discover",,U,,11/15/2021,"caringbridge","Charity : Other","Charity","Other","",$25.00,$0.00,-$6313.84
"Discover",,U,,11/16/2021,"cvs","Personal : Prescriptions, Medicine","Personal","Prescriptions, Medicine","",$12.50,$0.00,-$6326.34
"Discover",,U,,11/16/2021,"cvs","Personal : Prescriptions, Medicine","Personal","Prescriptions, Medicine","",$16.25,$0.00,-$6342.59
"Discover",,U,,11/16/2021,"stop & shop","Food : Groceries","Food","Groceries","",$110.98,$0.00,-$6453.57
"Discover",,U,,11/17/2021,"Ocean State Joblot","RV : Equipment/Supplies","RV","Equipment/Supplies","",$0.00,$5.30,-$6448.27
"Discover",,U,,11/17/2021,"Nytimes","Recreation : Entertainment","Recreation","Entertainment","",$4.00,$0.00,-$6452.27
"Discover",,U,,11/17/2021,"wildfire Brick Oven","Food : Restaurants","Food","Restaurants","",$8.94,$0.00,-$6461.21
"Discover",,U,,11/17/2021,"Ocean State Joblot","RV : Equipment/Supplies","RV","Equipment/Supplies","",$21.04,$0.00,-$6482.25
"Discover",,U,,11/17/2021,"stop & shop","Food : Groceries","Food","Groceries","",$45.80,$0.00,-$6528.05
"Discover",,U,,11/18/2021,"daill paper","Food : Restaurants","Food","Restaurants","",$14.57,$0.00,-$6542.62
"Discover",,U,,11/18/2021,"Hyannis auto","Transportation : Repairs & Maintenance","Transportation","Repairs & Maintenance","",$35.00,$0.00,-$6577.62
"Discover",,U,,11/19/2021,"Cash Market","Food : Restaurants","Food","Restaurants","",$16.03,$0.00,-$6593.65
"Discover",,U,,11/19/2021,"Gas","Transportation : Gas","Transportation","Gas","East Falmouth",$40.74,$0.00,-$6634.39
"Discover",,U,,11/20/2021,"second glance","Personal : cloths","Personal","cloths","",$50.98,$0.00,-$6685.37
"Discover",,U,,11/21/2021,"airbnb","RV : Hotel","RV","Hotel","",$2107.70,$0.00,-$8793.07
"Discover",,U,,11/22/2021,"cvs","Personal : Prescriptions, Medicine","Personal","Prescriptions, Medicine","",$54.90,$0.00,-$8847.97
"Discover",,U,,11/22/2021,"stop & shop","Food : Groceries","Food","Groceries","",$120.34,$0.00,-$8968.31
"Discover",,U,,11/23/2021,"redbox","Recreation : Entertainment","Recreation","Entertainment","",$1.97,$0.00,-$8970.28
"Discover",,U,,11/23/2021,"Gas","Transportation : Gas","Transportation","Gas","centerville",$42.56,$0.00,-$9012.84
"Discover",,U,,11/24/2021,"Briarcliff RV resort","RV : Campgrounds","RV","Campgrounds","",$57.16,$0.00,-$9070.00
"Discover",,U,,11/24/2021,"Passport America","RV : clubs","RV","clubs","",$79.00,$0.00,-$9149.00
"Discover",,U,,11/26/2021,"Eugenes Henry's","Food : Restaurants","Food","Restaurants","",$9.56,$0.00,-$9158.56
"Discover",,U,,11/26/2021,"Lime Crime Makeup","Personal : Gifts","Personal","Gifts","",$11.69,$0.00,-$9170.25
"Discover",,U,,11/26/2021,"Olumpia Sports","Personal : Gifts","Personal","Gifts","",$11.98,$0.00,-$9182.23
"Discover",,U,,11/26/2021,"Charity Party","Personal : Gifts","Personal","Gifts","",$17.99,$0.00,-$9200.22
"Discover",,U,,11/26/2021,"Reel Island","Personal : Gifts","Personal","Gifts","",$20.79,$0.00,-$9221.01
"Discover",,U,,11/26/2021,"cvs","Personal : Prescriptions, Medicine","Personal","Prescriptions, Medicine","",$21.86,$0.00,-$9242.87
"Discover",,U,,11/26/2021,"Eight cousins books","Personal : Gifts","Personal","Gifts","",$26.50,$0.00,-$9269.37
"Discover",,U,,11/26/2021,"Fatface","Personal : Gifts","Personal","Gifts","",$30.00,$0.00,-$9299.37
"Discover",,U,,11/26/2021,"Gas","Transportation : Gas","Transportation","Gas","Falmouth",$35.56,$0.00,-$9334.93
"Discover",,U,,11/26/2021,"CTS HYANNIS","Personal : Gifts","Personal","Gifts","",$37.96,$0.00,-$9372.89
"Discover",,U,,11/26/2021,"Kappy's Fine wine","Personal : Gifts","Personal","Gifts","",$61.98,$0.00,-$9434.87
"Discover",,U,,11/27/2021,"CHembroider","Personal : Gifts","Personal","Gifts","",$20.97,$0.00,-$9455.84
"Discover",,U,,11/27/2021,"Amazon","Personal : Gifts","Personal","Gifts","",$133.17,$0.00,-$9589.01
"Discover",,U,,11/28/2021,"Amazon","Personal : Gifts","Personal","Gifts","",$7.65,$0.00,-$9596.66
"Discover",,U,,11/28/2021,"Citrus & Salt","Food : Restaurants","Food","Restaurants","",$50.00,$0.00,-$9646.66
"Discover",,U,,11/28/2021,"lomography","Personal : Gifts","Personal","Gifts","",$81.80,$0.00,-$9728.46
"Target",,U,,06/10/2013,"Transfer : Avidia Checking",,,,"",$0.00,$17.16,$17.16
"Target",,C,,06/11/2013,"Starting Balance","Income : Available this month","Income","Available this month",,$0.00,$0.00,$17.16
"Target",,U,,08/19/2013,,"Housing : Supplies","Hidden Categories","Housing ` Supplies","",$3.02,$0.00,$14.14
"Target",,U,,10/01/2013,"","Personal : Prescriptions, Medicine","Personal","Prescriptions, Medicine","",$24.82,$0.00,-$10.68
"Target",,U,,10/09/2013,,"Housing : Supplies","Hidden Categories","Housing ` Supplies","",$4.08,$0.00,-$14.76
"Target",,U,,10/10/2013,"Transfer : Avidia Checking",,,,"",$0.00,$3.02,-$11.74
"Target",,U,,10/24/2013,"","Housing : Supplies","Hidden Categories","Housing ` Supplies","",$3.02,$0.00,-$14.76
"Target",,U,,10/24/2013,"","Housing : Supplies","Hidden Categories","Housing ` Supplies","",$7.94,$0.00,-$22.70
"Target",,U,,11/12/2013,"Transfer : Avidia Checking",,,,"",$0.00,$28.90,$6.20
"Target",,U,,12/10/2013,"Transfer : Avidia Checking",,,,"",$0.00,$10.96,$17.16
"Target",,U,,12/27/2013,,"Personal : Prescriptions, Medicine","Personal","Prescriptions, Medicine","",$16.00,$0.00,$1.16
"Target",,U,,12/27/2013,,"Food : Groceries","Food","Groceries","(Split 1/2) ",$35.00,$0.00,-$69.71
"Target",,U,,12/27/2013,,"Housing : Supplies","Hidden Categories","Housing ` Supplies","(Split 2/2) ",$35.87,$0.00,-$69.71
"Target",,U,,12/31/2013,,"Personal : Prescriptions, Medicine","Personal","Prescriptions, Medicine","",$25.00,$0.00,-$94.71
"Target",,U,,01/04/2014,"","Food : Groceries","Food","Groceries","(Split 1/2) ",$32.00,$0.00,-$160.40
"Target",,U,,01/04/2014,"","Housing : Supplies","Hidden Categories","Housing ` Supplies","(Split 2/2) ",$33.69,$0.00,-$160.40
"Target",,U,,01/14/2014,"","Food : Groceries","Food","Groceries","(Split 1/2) ",$40.00,$0.00,-$242.45
"Target",,U,,01/14/2014,"","Housing : Supplies","Hidden Categories","Housing ` Supplies","(Split 2/2) ",$42.05,$0.00,-$242.45
"Target",,U,,01/17/2014,"","Personal : Prescriptions, Medicine","Personal","Prescriptions, Medicine","",$20.00,$0.00,-$262.45
"Target",,U,,01/17/2014,"","Food : Groceries","Food","Groceries","(Split 1/2) ",$40.00,$0.00,-$347.96
"Target",,U,,01/17/2014,"","Housing : Supplies","Hidden Categories","Housing ` Supplies","(Split 2/2) ",$45.51,$0.00,-$347.96
"Target",,U,,01/22/2014,"","Personal : cloths","Personal","cloths","(Split 1/3) ",$40.00,$0.00,-$532.43
"Target",,U,,01/22/2014,"","Housing : Supplies","Hidden Categories","Housing ` Supplies","(Split 2/3) ",$80.00,$0.00,-$532.43
"Target",,U,,01/22/2014,"","Food : Groceries","Food","Groceries","(Split 3/3) ",$64.47,$0.00,-$532.43
"Target",,U,,02/03/2014,"","Food : Groceries","Food","Groceries","(Split 1/2) ",$35.00,$0.00,-$608.58
"Target",,U,,02/03/2014,"","Housing : Supplies","Hidden Categories","Housing ` Supplies","(Split 2/2) ",$41.15,$0.00,-$608.58
"Target",,U,,02/06/2014,"","Food : Groceries","Food","Groceries","",$20.96,$0.00,-$629.54
"Target",,U,,02/08/2014,,"Housing : Supplies","Hidden Categories","Housing ` Supplies","",$0.00,$27.54,-$602.00
"Target",,U,,02/08/2014,,"Personal : Prescriptions, Medicine","Personal","Prescriptions, Medicine","",$15.59,$0.00,-$617.59
"Target",,U,,02/08/2014,,"Food : Groceries","Food","Groceries","(Split 1/2) ",$22.00,$0.00,-$665.24
"Target",,U,,02/08/2014,,"Housing : Supplies","Hidden Categories","Housing ` Supplies","(Split 2/2) ",$25.65,$0.00,-$665.24
"Target",,U,,02/10/2014,"Transfer : Avidia Checking",,,,"",$0.00,$177.56,-$487.68
"Target",,U,,02/18/2014,"","Housing : Supplies","Hidden Categories","Housing ` Supplies","",$0.00,$12.60,-$475.08
"Target",,U,,02/18/2014,"","Housing : Supplies","Hidden Categories","Housing ` Supplies","",$72.97,$0.00,-$548.05
"Target",,U,,03/04/2014,,"Housing : Supplies","Hidden Categories","Housing ` Supplies","(Split 1/2) ",$15.00,$0.00,-$578.05
"Target",,U,,03/04/2014,,"Food : Groceries","Food","Groceries","(Split 2/2) ",$15.00,$0.00,-$578.05
"Target",,U,,03/04/2014,"","Food : Groceries","Food","Groceries","(Split 1/2) ",$21.01,$0.00,-$620.07
"Target",,U,,03/04/2014,"","Housing : Supplies","Hidden Categories","Housing ` Supplies","(Split 2/2) ",$21.01,$0.00,-$620.07
"Target",,U,,03/10/2014,"Transfer : Avidia Checking",,,,"",$0.00,$504.84,-$115.23
"Target",,U,,03/12/2014,"","Food : Groceries","Food","Groceries","(Split 1/2) ",$28.64,$0.00,-$172.51
"Target",,U,,03/12/2014,"","Housing : Supplies","Hidden Categories","Housing ` Supplies","(Split 2/2) ",$28.64,$0.00,-$172.51
"Target",,U,,03/13/2014,"","Food : Groceries","Food","Groceries","(Split 1/2) ",$0.00,$6.17,-$160.17
"Target",,U,,03/13/2014,"","Housing : Supplies","Hidden Categories","Housing ` Supplies","(Split 2/2) ",$0.00,$6.17,-$160.17
"Target",,U,,03/16/2014,"","Food : Groceries","Food","Groceries","(Split 1/2) ",$18.78,$0.00,-$197.73
"Target",,U,,03/16/2014,"","Housing : Supplies","Hidden Categories","Housing ` Supplies","(Split 2/2) ",$18.78,$0.00,-$197.73
"Target",,U,,03/24/2014,"","Food : Groceries","Food","Groceries","(Split 1/2) ",$36.63,$0.00,-$271.36
"Target",,U,,03/24/2014,"","Housing : Supplies","Hidden Categories","Housing ` Supplies","(Split 2/2) ",$37.00,$0.00,-$271.36
"Target",,U,,04/01/2014,"Pharmacy","Personal : Prescriptions, Medicine","Personal","Prescriptions, Medicine","",$8.00,$0.00,-$279.36
"Target",,U,,04/10/2014,"Transfer : Avidia Checking",,,,"",$0.00,$132.39,-$146.97
"Target",,U,,04/13/2014,,"Food : Groceries","Food","Groceries","",$3.33,$0.00,-$150.30
"Target",,U,,04/13/2014,,"Food : Groceries","Food","Groceries","(Split 1/2) ",$49.00,$0.00,-$249.14
"Target",,U,,04/13/2014,,"Housing : Supplies","Hidden Categories","Housing ` Supplies","(Split 2/2) ",$49.84,$0.00,-$249.14
"Target",,U,,04/16/2014,"","Housing : Supplies","Hidden Categories","Housing ` Supplies","",$0.00,$5.74,-$243.40
"Target",,U,,04/16/2014,,"Food : Groceries","Food","Groceries","(Split 1/2) ",$30.43,$0.00,-$313.83
"Target",,U,,04/16/2014,,"Housing : Supplies","Hidden Categories","Housing ` Supplies","(Split 2/2) ",$40.00,$0.00,-$313.83
"Target",,U,,04/27/2014,"","Food : Groceries","Food","Groceries","",$0.00,$12.60,-$301.23
"Target",,U,,04/27/2014,,"Food : Groceries","Food","Groceries","(Split 1/2) ",$0.00,$0.00,-$301.23
"Target",,U,,04/27/2014,,"Housing : Supplies","Hidden Categories","Housing ` Supplies","(Split 2/2) ",$0.00,$0.00,-$301.23
"Target",,U,,04/27/2014,"","Food : Groceries","Food","Groceries","(Split 1/2) ",$70.00,$0.00,-$442.66
"Target",,U,,04/27/2014,"","Housing : Supplies","Hidden Categories","Housing ` Supplies","(Split 2/2) ",$71.43,$0.00,-$442.66
"Target",,U,,05/10/2014,"","Food : Groceries","Food","Groceries","(Split 1/2) ",$16.85,$0.00,-$474.51
"Target",,U,,05/10/2014,"","Housing : Supplies","Hidden Categories","Housing ` Supplies","(Split 2/2) ",$15.00,$0.00,-$474.51
"Target",,U,,05/12/2014,"Transfer : Avidia Checking",,,,"",$0.00,$164.13,-$310.38
"Target",,U,,05/14/2014,"Pharmacy","Personal : Prescriptions, Medicine","Personal","Prescriptions, Medicine","",$20.00,$0.00,-$330.38
"Target",,U,,05/23/2014,"Pharmacy","Personal : Prescriptions, Medicine","Personal","Prescriptions, Medicine","",$3.65,$0.00,-$334.03
"Target",,U,,05/23/2014,"","Food : Groceries","Food","Groceries","(Split 1/2) ",$10.00,$0.00,-$354.10
"Target",,U,,05/23/2014,"","Housing : Supplies","Hidden Categories","Housing ` Supplies","(Split 2/2) ",$10.07,$0.00,-$354.10
"Target",,U,,05/24/2014,"","Food : Groceries","Food","Groceries","(Split 1/2) ",$30.00,$0.00,-$430.13
"Target",,U,,05/24/2014,"","Housing : Supplies","Hidden Categories","Housing ` Supplies","(Split 2/2) ",$46.03,$0.00,-$430.13
"Target",,U,,06/04/2014,,"Personal : cloths","Personal","cloths","(Split 1/2) ",$24.00,$0.00,-$474.40
"Target",,U,,06/04/2014,,"Food : Groceries","Food","Groceries","(Split 2/2) ",$20.27,$0.00,-$474.40
"Target",,U,,06/08/2014,"Pharmacy","Personal : Prescriptions, Medicine","Personal","Prescriptions, Medicine","",$18.94,$0.00,-$493.34
"Target",,U,,06/10/2014,"Transfer : Avidia Checking",,,,"",$0.00,$327.54,-$165.80
"Target",,U,,06/14/2014,"","Food : Groceries","Food","Groceries","(Split 1/2) ",$64.00,$0.00,-$290.26
"Target",,U,,06/14/2014,"","Housing : Supplies","Hidden Categories","Housing ` Supplies","(Split 2/2) ",$60.46,$0.00,-$290.26
"Target",,U,,06/16/2014,"","Personal : cloths","Personal","cloths","",$94.83,$0.00,-$385.09
"Target",,U,,06/18/2014,"","Personal : Prescriptions, Medicine","Personal","Prescriptions, Medicine","(Split 1/2) ",$10.00,$0.00,-$407.43
"Target",,U,,06/18/2014,"","Housing : Supplies","Hidden Categories","Housing ` Supplies","(Split 2/2) ",$12.34,$0.00,-$407.43
"Target",,U,,06/24/2014,"","Food : Groceries","Food","Groceries","(Split 1/3) ",$9.08,$0.00,-$436.51
"Target",,U,,06/24/2014,"","Personal : Prescriptions, Medicine","Personal","Prescriptions, Medicine","(Split 2/3) ",$10.00,$0.00,-$436.51
"Target",,U,,06/24/2014,"","Housing : Supplies","Hidden Categories","Housing ` Supplies","(Split 3/3) ",$10.00,$0.00,-$436.51
"Target",,U,,06/26/2014,"","Housing : Supplies","Hidden Categories","Housing ` Supplies","",$26.49,$0.00,-$463.00
"Target",,U,,07/01/2014,"","Food : Groceries","Food","Groceries","",$20.33,$0.00,-$483.33
"Target",,U,,07/10/2014,"Transfer : Avidia Checking",,,,"",$0.00,$182.96,-$300.37
"Target",,U,,07/11/2014,"","Food : Groceries","Food","Groceries","",$56.55,$0.00,-$356.92
"Target",,U,,07/15/2014,"","Food : Groceries","Food","Groceries","",$9.57,$0.00,-$366.49
"Target",,U,,07/25/2014,"","Personal : Prescriptions, Medicine","Personal","Prescriptions, Medicine","",$3.65,$0.00,-$370.14
"Target",,U,,07/25/2014,,"Housing : Supplies","Hidden Categories","Housing ` Supplies","",$24.98,$0.00,-$395.12
"Target",,U,,07/26/2014,,"Personal : cloths","Personal","cloths","",$81.66,$0.00,-$476.78
"Target",,U,,08/06/2014,,"Personal : Prescriptions, Medicine","Personal","Prescriptions, Medicine","",$12.10,$0.00,-$488.88
"Target",,U,,08/11/2014,"Transfer : Avidia Checking",,,,"",$0.00,$374.08,-$114.80
"Target",,U,,08/14/2014,,"Housing : Supplies","Hidden Categories","Housing ` Supplies","",$161.38,$0.00,-$276.18
"Target",,U,,08/19/2014,"","Food : Groceries","Food","Groceries","",$13.07,$0.00,-$289.25
"Target",,U,,08/22/2014,,"Housing : Supplies","Hidden Categories","Housing ` Supplies","",$164.84,$0.00,-$454.09
"Target",,U,,08/31/2014,"","Food : Groceries","Food","Groceries","",$45.15,$0.00,-$499.24
"Target",,U,,09/06/2014,"","Personal : Prescriptions, Medicine","Personal","Prescriptions, Medicine","",$6.40,$0.00,-$505.64
"Target",,U,,09/09/2014,"Transfer : Avidia Checking",,,,"",$0.00,$131.96,-$373.68
"Target",,U,,09/12/2014,,"Housing : Supplies","Hidden Categories","Housing ` Supplies","",$13.83,$0.00,-$387.51
"Target",,U,,09/20/2014,"","Personal : Prescriptions, Medicine","Personal","Prescriptions, Medicine","",$3.65,$0.00,-$391.16
"Target",,U,,09/20/2014,"","Housing : Supplies","Hidden Categories","Housing ` Supplies","",$279.28,$0.00,-$670.44
"Target",,U,,10/01/2014,,"Housing : Supplies","Hidden Categories","Housing ` Supplies","",$0.00,$23.48,-$646.96
"Target",,U,,10/01/2014,,"Personal : Prescriptions, Medicine","Personal","Prescriptions, Medicine","",$3.65,$0.00,-$650.61
"Target",,U,,10/07/2014,,"Personal : Prescriptions, Medicine","Personal","Prescriptions, Medicine","",$19.79,$0.00,-$670.40
"Target",,U,,10/09/2014,,"Personal : Prescriptions, Medicine","Personal","Prescriptions, Medicine","",$3.65,$0.00,-$674.05
"Target",,U,,10/09/2014,"","Housing : Dog","Hidden Categories","Housing ` Dog","",$10.31,$0.00,-$684.36
"Target",,U,,10/10/2014,"Transfer : Avidia Checking",,,,"",$0.00,$381.64,-$302.72
"Target",,U,,10/13/2014,,"Food : Groceries","Food","Groceries","",$95.97,$0.00,-$398.69
"Target",,U,,10/14/2014,"","Personal : Prescriptions, Medicine","Personal","Prescriptions, Medicine","",$3.65,$0.00,-$402.34
"Target",,U,,10/14/2014,,"Housing : Supplies","Hidden Categories","Housing ` Supplies","",$16.14,$0.00,-$418.48
"Target",,U,,10/25/2014,,"Housing : Supplies","Hidden Categories","Housing ` Supplies","",$92.96,$0.00,-$511.44
"Target",,U,,10/29/2014,,"Housing : Dog","Hidden Categories","Housing ` Dog","",$10.08,$0.00,-$521.52
"Target",,U,,10/31/2014,,"Housing : Supplies","Hidden Categories","Housing ` Supplies","",$15.74,$0.00,-$537.26
"Target",,U,,10/31/2014,,"Housing : Supplies","Hidden Categories","Housing ` Supplies","",$38.35,$0.00,-$575.61
"Target",,U,,11/03/2014,,"Housing : Supplies","Hidden Categories","Housing ` Supplies","",$0.00,$38.85,-$536.76
"Target",,U,,11/03/2014,"","Housing : Supplies","Hidden Categories","Housing ` Supplies","",$23.44,$0.00,-$560.20
"Target",,U,,11/10/2014,"Transfer : Avidia Checking",,,,"",$0.00,$411.15,-$149.05
"Target",,U,,11/13/2014,,"Housing : Supplies","Hidden Categories","Housing ` Supplies","",$78.13,$0.00,-$227.18
"Target",,U,,12/02/2014,,"Housing : Supplies","Hidden Categories","Housing ` Supplies","",$49.71,$0.00,-$276.89
"Target",,U,,12/02/2014,,"Lisa Business : Business expenses","Lisa Business","Business expenses","(Split 1/2) Printer & ink",$150.00,$0.00,-$461.14
"Target",,U,,12/02/2014,,"Housing : Supplies","Hidden Categories","Housing ` Supplies","(Split 2/2) ",$34.25,$0.00,-$461.14
"Target",,U,,12/03/2014,,"Housing : Supplies","Hidden Categories","Housing ` Supplies","",$5.34,$0.00,-$466.48
"Target",,U,,12/03/2014,"Pharmacy","Personal : Prescriptions, Medicine","Personal","Prescriptions, Medicine","",$7.30,$0.00,-$473.78
"Target",,U,,12/03/2014,"","Housing : Supplies","Hidden Categories","Housing ` Supplies","(Split 1/3) ",$40.00,$0.00,-$560.54
"Target",,U,,12/03/2014,"","Personal : Miscellaneous","Personal","Miscellaneous","(Split 2/3) ",$20.00,$0.00,-$560.54
"Target",,U,,12/03/2014,"","Food : Groceries","Food","Groceries","(Split 3/3) ",$26.76,$0.00,-$560.54
"Target",,U,,12/08/2014,"Pharmacy","Personal : Prescriptions, Medicine","Personal","Prescriptions, Medicine","",$3.65,$0.00,-$564.19
"Target",,U,,12/08/2014,"","Housing : Supplies","Hidden Categories","Housing ` Supplies","(Split 1/2) ",$30.00,$0.00,-$601.61
"Target",,U,,12/08/2014,"","Food : Groceries","Food","Groceries","(Split 2/2) ",$7.42,$0.00,-$601.61
"Target",,U,,12/10/2014,"Transfer : Avidia Checking",,,,"",$0.00,$257.98,-$343.63
"Target",,U,,12/21/2014,"","Personal : Gifts","Personal","Gifts","(Split 1/2) gifts",$150.00,$0.00,-$546.96
"Target",,U,,12/21/2014,"","Housing : Supplies","Hidden Categories","Housing ` Supplies","(Split 2/2) supplies",$53.33,$0.00,-$546.96
"Target",,U,,12/24/2014,,"Personal : Gifts","Personal","Gifts","(Split 1/2) ",$15.49,$0.00,-$577.94
"Target",,U,,12/24/2014,,"Food : Groceries","Food","Groceries","(Split 2/2) ",$15.49,$0.00,-$577.94
"Target",,U,,12/25/2014,"","Personal : Gifts","Personal","Gifts","",$19.51,$0.00,-$597.45
"Target",,U,,12/25/2014,"","Personal : Gifts","Personal","Gifts","",$89.25,$0.00,-$686.70
"Target",,C,,01/02/2015,"","Personal : Gifts","Personal","Gifts","return",$0.00,$12.51,-$674.19
"Target",,C,,01/02/2015,"","Personal : cloths","Personal","cloths","",$49.71,$0.00,-$723.90
"Target",,C,,01/08/2015,"","Housing : Supplies","Hidden Categories","Housing ` Supplies","",$17.83,$0.00,-$741.73
"Target",,C,,01/11/2015,"","Housing : Supplies","Hidden Categories","Housing ` Supplies","",$53.01,$0.00,-$794.74
"Target",,C,,01/12/2015,"Transfer : Avidia Checking",,,,"",$0.00,$402.85,-$391.89
"Target",,U,,01/12/2015,"Adjustment Missed passed trans?","Housing : Supplies","Hidden Categories","Housing ` Supplies","",$35.74,$0.00,-$427.63
"Target",,C,,01/13/2015,"","Housing : Supplies","Hidden Categories","Housing ` Supplies","",$84.24,$0.00,-$511.87
"Target",,C,,01/20/2015,,"Food : Groceries","Food","Groceries","",$17.09,$0.00,-$528.96
"Target",,C,,01/20/2015,"Pharmacy","Personal : Prescriptions, Medicine","Personal","Prescriptions, Medicine","(Split 1/2) ",$15.00,$0.00,-$570.34
"Target",,C,,01/20/2015,"Pharmacy","Housing : Supplies","Hidden Categories","Housing ` Supplies","(Split 2/2) ",$26.38,$0.00,-$570.34
"Target",,U,,01/29/2015,"","Housing : Supplies","Hidden Categories","Housing ` Supplies","",$32.78,$0.00,-$603.12
"Target",,U,,01/31/2015,"Pharmacy","Personal : Prescriptions, Medicine","Personal","Prescriptions, Medicine","",$14.80,$0.00,-$617.92
"Target",,U,,02/07/2015,,"Housing : Supplies","Hidden Categories","Housing ` Supplies","",$22.90,$0.00,-$640.82
"Target",,U,,02/07/2015,"","Food : Groceries","Food","Groceries","",$38.22,$0.00,-$679.04
"Target",,C,,02/09/2015,"Transfer : Avidia Checking",,,,"one card",$0.00,$451.11,-$227.93
"Target",,U,,02/10/2015,"Pharmacy","Personal : Prescriptions, Medicine","Personal","Prescriptions, Medicine","",$4.00,$0.00,-$231.93
"Target",,U,,02/10/2015,,"Housing : Supplies","Hidden Categories","Housing ` Supplies","",$70.60,$0.00,-$302.53
"Target",,C,,03/09/2015,"Transfer : Avidia Checking",,,,"",$0.00,$326.01,$23.48
"Target",,U,,03/28/2015,,"Housing : Supplies","Hidden Categories","Housing ` Supplies","",$118.27,$0.00,-$94.79
"Target",,U,,03/29/2015,"","Food : Groceries","Food","Groceries","",$45.18,$0.00,-$139.97
"Target",,U,,04/02/2015,"Pharmacy","Personal : Prescriptions, Medicine","Personal","Prescriptions, Medicine","",$16.50,$0.00,-$156.47
"Target",,U,,04/02/2015,,"Housing : Supplies","Hidden Categories","Housing ` Supplies","",$92.91,$0.00,-$249.38
"Target",,U,,04/06/2015,,"Housing : Supplies","Hidden Categories","Housing ` Supplies","",$0.00,$21.76,-$227.62
"Target",,U,,04/06/2015,,"Housing : Supplies","Hidden Categories","Housing ` Supplies","",$0.00,$5.04,-$222.58
"Target",,U,,04/06/2015,,"Housing : Dog","Hidden Categories","Housing ` Dog","",$34.07,$0.00,-$256.65
"Target",,U,,04/10/2015,"","Food : Groceries","Food","Groceries","",$36.86,$0.00,-$293.51
"Target",,U,,04/14/2015,,"Housing : Supplies","Hidden Categories","Housing ` Supplies","",$0.00,$5.94,-$287.57
"Target",,U,,04/14/2015,"Pharmacy","Personal : Prescriptions, Medicine","Personal","Prescriptions, Medicine","",$25.00,$0.00,-$312.57
"Target",,U,,04/14/2015,,"Personal : cloths","Personal","cloths","",$41.85,$0.00,-$354.42
"Target",,U,,04/27/2015,"","Housing : Supplies","Hidden Categories","Housing ` Supplies","(Split 1/2) ",$90.00,$0.00,-$492.18
"Target",,U,,04/27/2015,"","Food : Groceries","Food","Groceries","(Split 2/2) ",$47.76,$0.00,-$492.18
"Target",,U,,05/11/2015,"Transfer : Avidia Checking",,,,"",$0.00,$316.99,-$175.19
"Target",,U,,05/16/2015,,"Personal : cloths","Personal","cloths","",$57.49,$0.00,-$232.68
"Target",,U,,05/25/2015,,"Housing : Supplies","Hidden Categories","Housing ` Supplies","",$90.59,$0.00,-$323.27
"Target",,U,,06/05/2015,,"Housing : Supplies","Hidden Categories","Housing ` Supplies","",$149.58,$0.00,-$472.85
"Target",,U,,06/10/2015,"Transfer : Avidia Checking",,,,"",$0.00,$198.67,-$274.18
"Target",,U,,06/20/2015,,"Housing : Supplies","Hidden Categories","Housing ` Supplies","",$25.00,$0.00,-$299.18
"Target",,U,,06/20/2015,"","Housing : Supplies","Hidden Categories","Housing ` Supplies","",$142.72,$0.00,-$441.90
"Target",,U,,07/10/2015,"Transfer : Avidia Checking",,,,"",$0.00,$297.66,-$144.24
"Target",,U,,07/14/2015,,"Housing : Dog","Hidden Categories","Housing ` Dog","(Split 1/3) ",$50.00,$0.00,-$306.65
"Target",,U,,07/14/2015,,"Housing : Supplies","Hidden Categories","Housing ` Supplies","(Split 2/3) ",$99.58,$0.00,-$306.65
"Target",,U,,07/14/2015,,"Personal : cloths","Personal","cloths","(Split 3/3) ",$12.83,$0.00,-$306.65
"Target",,U,,07/18/2015,"Pharmacy","Personal : Prescriptions, Medicine","Personal","Prescriptions, Medicine","",$25.00,$0.00,-$331.65
"Target",,U,,07/18/2015,"","Food : Groceries","Food","Groceries","",$28.38,$0.00,-$360.03
"Target",,U,,08/01/2015,"","Housing : Supplies","Hidden Categories","Housing ` Supplies","",$88.03,$0.00,-$448.06
"Target",,U,,08/05/2015,"","Housing : Dog","Hidden Categories","Housing ` Dog","",$25.74,$0.00,-$473.80
"Target",,U,,08/08/2015,"","Personal : cloths","Personal","cloths","",$0.00,$0.00,-$473.80
"Target",,U,,08/08/2015,,"Food : Groceries","Food","Groceries","",$34.35,$0.00,-$508.15
"Target",,U,,08/10/2015,"Transfer : Avidia Checking",,,,"",$0.00,$167.72,-$340.43
"Target",,U,,08/10/2015,"Pharmacy","Personal : Prescriptions, Medicine","Personal","Prescriptions, Medicine","",$16.50,$0.00,-$356.93
"Target",,U,,08/19/2015,"","Housing : Supplies","Hidden Categories","Housing ` Supplies","",$5.04,$0.00,-$361.97
"Target",,U,,08/21/2015,"","Housing : Supplies","Hidden Categories","Housing ` Supplies","",$27.80,$0.00,-$389.77
"Target",,U,,08/27/2015,"","Food : Groceries","Food","Groceries","",$15.81,$0.00,-$405.58
"Target",,U,,09/02/2015,,"Housing : Supplies","Hidden Categories","Housing ` Supplies","",$78.41,$0.00,-$483.99
"Target",,U,,09/05/2015,,"Food : Groceries","Food","Groceries","",$55.40,$0.00,-$539.39
"Target",,U,,09/07/2015,,"Personal : Prescriptions, Medicine","Personal","Prescriptions, Medicine","",$25.00,$0.00,-$564.39
"Target",,U,,09/07/2015,,"Housing : Supplies","Hidden Categories","Housing ` Supplies","",$192.11,$0.00,-$756.50
"Target",,U,,09/10/2015,"Transfer : Avidia Checking",,,,"",$0.00,$380.41,-$376.09
"Target",,U,,09/12/2015,,"Personal : Prescriptions, Medicine","Personal","Prescriptions, Medicine","",$8.00,$0.00,-$384.09
"Target",,U,,09/12/2015,,"Personal : Prescriptions, Medicine","Personal","Prescriptions, Medicine","",$8.07,$0.00,-$392.16
"Target",,U,,09/12/2015,,"Personal : Gifts","Personal","Gifts","",$136.06,$0.00,-$528.22
"Target",,U,,10/09/2015,,"Housing : Supplies","Hidden Categories","Housing ` Supplies","",$70.76,$0.00,-$598.98
"Target",,U,,10/13/2015,"Transfer : Avidia Checking",,,,"",$0.00,$399.57,-$199.41
"Target",,U,,10/20/2015,,"Housing : Supplies","Hidden Categories","Housing ` Supplies","",$39.78,$0.00,-$239.19
"Target",,U,,10/21/2015,,"Food : Groceries","Food","Groceries","",$3.33,$0.00,-$242.52
"Target",,U,,10/21/2015,,"Personal : Prescriptions, Medicine","Personal","Prescriptions, Medicine","",$8.00,$0.00,-$250.52
"Target",,U,,10/31/2015,,"Personal : cloths","Personal","cloths","",$13.30,$0.00,-$263.82
"Target",,U,,10/31/2015,,"Food : Groceries","Food","Groceries","",$40.93,$0.00,-$304.75
"Target",,U,,11/08/2015,,"Housing : Supplies","Hidden Categories","Housing ` Supplies","",$14.60,$0.00,-$319.35
"Target",,U,,11/08/2015,,"Housing : Supplies","Hidden Categories","Housing ` Supplies","",$62.09,$0.00,-$381.44
"Target",,U,,11/09/2015,"Transfer : Avidia Checking",,,,"",$0.00,$199.41,-$182.03
"Target",,U,,11/17/2015,"","Personal : Gifts","Personal","Gifts","",$70.24,$0.00,-$252.27
"Target",,U,,11/19/2015,,"Food : Groceries","Food","Groceries","",$11.20,$0.00,-$263.47
"Target",,U,,11/19/2015,"Pharmacy","Personal : Prescriptions, Medicine","Personal","Prescriptions, Medicine","",$13.49,$0.00,-$276.96
"Target",,U,,12/07/2015,,"Housing : Supplies","Hidden Categories","Housing ` Supplies","",$79.40,$0.00,-$356.36
"Target",,U,,12/09/2015,,"Housing : Supplies","Hidden Categories","Housing ` Supplies","",$74.14,$0.00,-$430.50
"Target",,U,,12/10/2015,"Transfer : Avidia Checking",,,,"",$0.00,$182.03,-$248.47
"Target",,U,,12/10/2015,,"Housing : Supplies","Hidden Categories","Housing ` Supplies","",$0.00,$23.31,-$225.16
"Target",,U,,12/21/2015,"Pharmacy","Personal : Prescriptions, Medicine","Personal","Prescriptions, Medicine","",$8.00,$0.00,-$233.16
"Target",,U,,12/23/2015,,"Housing : Supplies","Hidden Categories","Housing ` Supplies","",$0.00,$25.22,-$207.94
"Target",,U,,12/23/2015,,"Housing : Supplies","Hidden Categories","Housing ` Supplies","",$96.62,$0.00,-$304.56
"Target",,U,,01/01/2016,"","Housing : Supplies","Hidden Categories","Housing ` Supplies","",$94.30,$0.00,-$398.86
"Target",,U,,01/02/2016,"Pharmacy","Personal : Prescriptions, Medicine","Personal","Prescriptions, Medicine","",$77.22,$0.00,-$476.08
"Target",,U,,01/03/2016,,"Housing : Supplies","Hidden Categories","Housing ` Supplies","",$91.65,$0.00,-$567.73
"Target",,U,,01/11/2016,"Transfer : Avidia Checking",,,,"",$0.00,$225.16,-$342.57
"Target",,U,,01/12/2016,,"Food : Groceries","Food","Groceries","",$63.55,$0.00,-$406.12
"Target",,U,,01/16/2016,,"Housing : Supplies","Hidden Categories","Housing ` Supplies","",$0.00,$4.03,-$402.09
"Target",,U,,01/16/2016,"","Housing : Supplies","Hidden Categories","Housing ` Supplies","",$80.11,$0.00,-$482.20
"Target",,U,,01/22/2016,"Pharmacy","Personal : Prescriptions, Medicine","Personal","Prescriptions, Medicine","",$4.00,$0.00,-$486.20
"Target",,U,,01/23/2016,"","Housing : Supplies","Hidden Categories","Housing ` Supplies","",$75.30,$0.00,-$561.50
"Target",,U,,01/24/2016,,"Personal : cloths","Personal","cloths","",$28.89,$0.00,-$590.39
"Target",,U,,01/29/2016,,"Housing : Supplies","Hidden Categories","Housing ` Supplies","",$59.78,$0.00,-$650.17
"Target",,U,,01/29/2016,"Pharmacy","Personal : Prescriptions, Medicine","Personal","Prescriptions, Medicine","",$93.10,$0.00,-$743.27
"Target",,U,,02/10/2016,"Transfer : Avidia Checking",,,,"",$0.00,$342.57,-$400.70
"Target",,U,,02/13/2016,,"Housing : Supplies","Hidden Categories","Housing ` Supplies","",$99.31,$0.00,-$500.01
"Target",,U,,02/14/2016,,"Personal : cloths","Personal","cloths","",$27.03,$0.00,-$527.04
"Target",,U,,02/19/2016,,"Personal : Gifts","Personal","Gifts","",$75.29,$0.00,-$602.33
"Target",,U,,02/26/2016,,"Food : Groceries","Food","Groceries","",$31.66,$0.00,-$633.99
"Target",,U,,02/29/2016,,"Housing : Supplies","Hidden Categories","Housing ` Supplies","",$27.12,$0.00,-$661.11
"Target",,U,,03/10/2016,"Transfer : Avidia Checking",,,,"",$0.00,$400.70,-$260.41
"Target",,U,,04/03/2016,,"Housing : Supplies","Hidden Categories","Housing ` Supplies","",$99.72,$0.00,-$360.13
"Target",,U,,04/11/2016,"Transfer : Avidia Checking",,,,"",$0.00,$260.41,-$99.72
"Target",,U,,04/11/2016,"Pharmacy","Personal : Prescriptions, Medicine","Personal","Prescriptions, Medicine","",$4.60,$0.00,-$104.32
"Target",,U,,04/11/2016,"Pharmacy","Personal : Prescriptions, Medicine","Personal","Prescriptions, Medicine","",$129.82,$0.00,-$234.14
"Target",,U,,04/30/2016,"","Food : Groceries","Food","Groceries","",$43.55,$0.00,-$277.69
"Target",,U,,05/09/2016,"Transfer : Avidia Checking",,,,"",$0.00,$99.72,-$177.97
"Target",,U,,05/12/2016,"Pharmacy","Personal : Prescriptions, Medicine","Personal","Prescriptions, Medicine","",$12.16,$0.00,-$190.13
"Target",,U,,05/12/2016,"","Food : Groceries","Food","Groceries","",$138.15,$0.00,-$328.28
"Target",,U,,05/22/2016,"","Housing : Supplies","Hidden Categories","Housing ` Supplies","",$135.46,$0.00,-$463.74
"Target",,U,,05/27/2016,"Pharmacy","Personal : Prescriptions, Medicine","Personal","Prescriptions, Medicine","",$10.00,$0.00,-$473.74
"Target",,U,,05/27/2016,"","Personal : cloths","Personal","cloths","",$36.30,$0.00,-$510.04
"Target",,U,,06/10/2016,"Transfer : Avidia Checking",,,,"",$0.00,$177.97,-$332.07
"Target",,U,,06/12/2016,"","Food : Groceries","Food","Groceries","",$39.33,$0.00,-$371.40
"Target",,U,,06/12/2016,"","Housing : Supplies","Hidden Categories","Housing ` Supplies","",$59.07,$0.00,-$430.47
"Target",,U,,06/12/2016,,"Housing : Supplies","Hidden Categories","Housing ` Supplies","",$70.18,$0.00,-$500.65
"Target",,U,,06/18/2016,,"Food : Groceries","Food","Groceries","",$0.00,$6.55,-$494.10
"Target",,U,,06/30/2016,,"Food : Groceries","Food","Groceries","",$43.01,$0.00,-$537.11
"Target",,U,,06/30/2016,"Pharmacy","Personal : Prescriptions, Medicine","Personal","Prescriptions, Medicine","",$71.18,$0.00,-$608.29
"Target",,U,,07/11/2016,"Transfer : Avidia Checking",,,,"",$0.00,$332.07,-$276.22
"Target",,U,,07/15/2016,"Pharmacy","Personal : Prescriptions, Medicine","Personal","Prescriptions, Medicine","",$11.06,$0.00,-$287.28
"Target",,U,,07/15/2016,,"Food : Groceries","Food","Groceries","",$52.70,$0.00,-$339.98
"Target",,U,,07/22/2016,"Pharmacy","Personal : Prescriptions, Medicine","Personal","Prescriptions, Medicine","",$10.00,$0.00,-$349.98
"Target",,U,,07/22/2016,"","Housing : Supplies","Hidden Categories","Housing ` Supplies","",$91.45,$0.00,-$441.43
"Target",,U,,08/02/2016,"","Food : Groceries","Food","Groceries","",$36.66,$0.00,-$478.09
"Target",,U,,08/10/2016,"Transfer : Avidia Checking",,,,"",$0.00,$276.22,-$201.87
"Target",,U,,08/21/2016,"","RV : Equipment/Supplies","RV","Equipment/Supplies","",$152.57,$0.00,-$354.44
"Target",,U,,09/03/2016,"","Food : Groceries","Food","Groceries","",$63.69,$0.00,-$418.13
"Target",,U,,09/04/2016,"supplies","Housing : Supplies","Hidden Categories","Housing ` Supplies","",$7.65,$0.00,-$425.78
"Target",,U,,09/08/2016,,"Food : Groceries","Food","Groceries","",$26.74,$0.00,-$452.52
"Target",,U,,09/10/2016,"","Food : Groceries","Food","Groceries","",$28.20,$0.00,-$480.72
"Target",,U,,09/12/2016,"Transfer : Avidia Checking",,,,"",$0.00,$201.87,-$278.85
"Target",,U,,09/13/2016,"Pharmacy","Personal : Prescriptions, Medicine","Personal","Prescriptions, Medicine","",$12.04,$0.00,-$290.89
"Target",,U,,09/18/2016,"","Food : Groceries","Food","Groceries","",$8.51,$0.00,-$299.40
"Target",,U,,09/22/2016,"","Housing : Supplies","Hidden Categories","Housing ` Supplies","",$7.06,$0.00,-$306.46
"Target",,U,,09/25/2016,"","Food : Groceries","Food","Groceries","",$15.13,$0.00,-$321.59
"Target",,U,,09/25/2016,"","Housing : Supplies","Hidden Categories","Housing ` Supplies","",$68.53,$0.00,-$390.12
"Target",,U,,10/04/2016,"","Food : Groceries","Food","Groceries","",$38.58,$0.00,-$428.70
"Target",,U,,10/04/2016,"Pharmacy","Personal : Prescriptions, Medicine","Personal","Prescriptions, Medicine","",$45.00,$0.00,-$473.70
"Target",,U,,10/05/2016,,"Personal : cloths","Personal","cloths","",$37.12,$0.00,-$510.82
"Target",,U,,10/08/2016,,"Food : Groceries","Food","Groceries","",$9.49,$0.00,-$520.31
"Target",,U,,10/08/2016,,"Housing : Supplies","Hidden Categories","Housing ` Supplies","",$51.13,$0.00,-$571.44
"Target",,U,,10/11/2016,"Transfer : Avidia Checking",,,,"",$0.00,$278.85,-$292.59
"Target",,U,,10/23/2016,,"Housing : Supplies","Hidden Categories","Housing ` Supplies","",$7.11,$0.00,-$299.70
"Target",,U,,10/25/2016,,"Food : Groceries","Food","Groceries","",$31.22,$0.00,-$330.92
"Target",,U,,10/29/2016,,"Housing : Supplies","Hidden Categories","Housing ` Supplies","",$123.58,$0.00,-$454.50
"Target",,U,,11/06/2016,,"Housing : Supplies","Hidden Categories","Housing ` Supplies","",$0.00,$22.47,-$432.03
"Target",,U,,11/06/2016,,"Food : Groceries","Food","Groceries","",$52.42,$0.00,-$484.45
"Target",,U,,11/10/2016,"Transfer : Avidia Checking",,,,"",$0.00,$292.59,-$191.86
"Target",,U,,11/14/2016,,"Housing : Supplies","Hidden Categories","Housing ` Supplies","",$79.05,$0.00,-$270.91
"Target",,U,,11/15/2016,"","Food : Groceries","Food","Groceries","",$39.32,$0.00,-$310.23
"Target",,U,,11/18/2016,"","Housing : Supplies","Hidden Categories","Housing ` Supplies","",$13.96,$0.00,-$324.19
"Target",,U,,11/18/2016,"Pharmacy","Personal : Prescriptions, Medicine","Personal","Prescriptions, Medicine","",$39.73,$0.00,-$363.92
"Target",,U,,11/29/2016,,"Housing : Supplies","Hidden Categories","Housing ` Supplies","",$0.00,$7.66,-$356.26
"Target",,U,,11/29/2016,,"Food : Groceries","Food","Groceries","",$19.99,$0.00,-$376.25
"Target",,U,,12/03/2016,,"Housing : Supplies","Hidden Categories","Housing ` Supplies","",$45.37,$0.00,-$421.62
"Target",,U,,12/05/2016,,"Food : Groceries","Food","Groceries","",$40.51,$0.00,-$462.13
"Target",,U,,12/14/2016,"Adjument charge","Personal : BankFee","Personal","BankFee","",$1.00,$0.00,-$463.13
"Target",,U,,12/14/2016,"interest charge","Personal : BankFee","Personal","BankFee","",$9.35,$0.00,-$472.48
"Target",,U,,12/14/2016,"Returned Payment charge","Personal : BankFee","Personal","BankFee","",$25.00,$0.00,-$497.48
"Target",,U,,01/12/2017,"Transfer : Dcu Checking",,,,"",$0.00,$488.13,-$9.35
"Target",,U,,02/08/2017,,"RV : Equipment/Supplies","RV","Equipment/Supplies","",$350.59,$0.00,-$359.94
"Target",,U,,02/10/2017,,"RV : Equipment/Supplies","RV","Equipment/Supplies","",$0.00,$18.11,-$341.83
"Target",,U,,02/10/2017,"Transfer : Dcu Checking",,,,"",$0.00,$9.35,-$332.48
"Target",,U,,02/10/2017,,"Food : Groceries","Food","Groceries","",$57.32,$0.00,-$389.80
"Target",,U,,02/16/2017,"","RV : Equipment/Supplies","RV","Equipment/Supplies","",$0.00,$12.28,-$377.52
"Target",,U,,02/16/2017,"","RV : Equipment/Supplies","RV","Equipment/Supplies","",$184.84,$0.00,-$562.36
"Target",,U,,03/10/2017,"Transfer : Dcu Checking",,,,"",$0.00,$389.80,-$172.56
"Target",,U,,03/18/2017,"","RV : Equipment/Supplies","RV","Equipment/Supplies","Scrren Room",$140.19,$0.00,-$312.75
"Target",,U,,03/31/2017,,"RV : Equipment/Supplies","RV","Equipment/Supplies","",$80.81,$0.00,-$393.56
"Target",,U,,04/10/2017,"Transfer : Dcu Checking",,,,"",$0.00,$172.56,-$221.00
"Target",,U,,04/12/2017,"Pharmacy","Personal : Prescriptions, Medicine","Personal","Prescriptions, Medicine","",$35.95,$0.00,-$256.95
"Target",,U,,05/10/2017,"Transfer : Dcu Checking",,,,"",$0.00,$221.00,-$35.95
"Target",,U,,05/15/2017,"Marlboor","Food : Groceries","Food","Groceries","(Split 1/2) ",$20.00,$0.00,-$146.86
"Target",,U,,05/15/2017,"Marlboor","RV : Equipment/Supplies","RV","Equipment/Supplies","(Split 2/2) ",$90.91,$0.00,-$146.86
"Target",,U,,06/12/2017,"Transfer : Dcu Checking",,,,"",$0.00,$35.95,-$110.91
"Target",,U,,07/10/2017,"Transfer : Dcu Checking",,,,"",$0.00,$110.91,$0.00
"Target",,U,,07/19/2017,,"Recreation : Entertainment","Recreation","Entertainment","(Split 1/2) ",$51.39,$0.00,-$101.39
"Target",,U,,07/19/2017,,"Personal : cloths","Personal","cloths","(Split 2/2) ",$50.00,$0.00,-$101.39
"Target",,U,,07/20/2017,,"Personal : cloths","Personal","cloths","",$0.00,$22.44,-$78.95
"Target",,U,,07/20/2017,"","RV : Equipment/Supplies","RV","Equipment/Supplies","",$17.08,$0.00,-$96.03
"Target",,U,,07/20/2017,"","Food : Groceries","Food","Groceries","",$58.15,$0.00,-$154.18
"Target",,U,,08/03/2017,"Pharmacy","Personal : Prescriptions, Medicine","Personal","Prescriptions, Medicine","",$3.21,$0.00,-$157.39
"Target",,U,,08/03/2017,,"RV : Equipment/Supplies","RV","Equipment/Supplies","",$24.38,$0.00,-$181.77
"Target",,U,,08/03/2017,"","Food : Groceries","Food","Groceries","",$29.23,$0.00,-$211.00
"Target",,U,,09/08/2017,"","Food : Groceries","Food","Groceries","(Split 1/2) ",$80.53,$0.00,-$371.53
"Target",,U,,09/08/2017,"","RV : Equipment/Supplies","RV","Equipment/Supplies","(Split 2/2) ",$80.00,$0.00,-$371.53
"Target",,U,,09/10/2017,,"Food : Groceries","Food","Groceries","",$68.62,$0.00,-$440.15
"Target",,U,,09/11/2017,"Transfer : Dcu Checking",,,,"",$0.00,$211.00,-$229.15
"Target",,U,,10/10/2017,"Transfer : Dcu Checking",,,,"",$0.00,$229.15,$0.00
"Target",,U,,10/13/2017,"","Personal : cloths","Personal","cloths","(Split 1/2) ",$50.00,$0.00,-$126.34
"Target",,U,,10/13/2017,"","RV : Equipment/Supplies","RV","Equipment/Supplies","(Split 2/2) ",$76.34,$0.00,-$126.34
"Target",,U,,10/25/2017,"","RV : Equipment/Supplies","RV","Equipment/Supplies","",$0.00,$14.24,-$112.10
"Target",,U,,10/25/2017,"","RV : Equipment/Supplies","RV","Equipment/Supplies","(Split 1/2) ",$55.00,$0.00,-$222.34
"Target",,U,,10/25/2017,"","Food : Groceries","Food","Groceries","(Split 2/2) ",$55.24,$0.00,-$222.34
"Target",,U,,11/13/2017,,"Food : Groceries","Food","Groceries","",$85.46,$0.00,-$307.80
"Target",,U,,11/14/2017,"","Personal : Miscellaneous","Personal","Miscellaneous","",$0.00,$10.31,-$297.49
"Target",,U,,11/14/2017,,"RV : Equipment/Supplies","RV","Equipment/Supplies","",$76.04,$0.00,-$373.53
"Target",,U,,12/08/2017,"Transfer : Dcu Checking",,,,"",$0.00,$222.34,-$151.19
"Target",,U,,01/10/2018,"Transfer : Dcu Checking",,,,"",$0.00,$151.19,$0.00
"Target",,U,,01/22/2018,"","RV : Equipment/Supplies","RV","Equipment/Supplies","(Split 1/2) ",$40.00,$0.00,-$117.20
"Target",,U,,01/22/2018,"","Food : Groceries","Food","Groceries","(Split 2/2) ",$77.20,$0.00,-$117.20
"Target",,U,,02/06/2018,,"Food : Groceries","Food","Groceries","(Split 1/2) Groceries",$80.00,$0.00,-$234.51
"Target",,U,,02/06/2018,,"RV : Equipment/Supplies","RV","Equipment/Supplies","(Split 2/2) ",$37.31,$0.00,-$234.51
"Target",,U,,03/10/2018,,"Food : Groceries","Food","Groceries","(Split 1/2) ",$50.00,$0.00,-$326.66
"Target",,U,,03/10/2018,,"RV : Equipment/Supplies","RV","Equipment/Supplies","(Split 2/2) ",$42.15,$0.00,-$326.66
"Target",,U,,03/12/2018,"Transfer : Dcu Checking",,,,"",$0.00,$234.51,-$92.15
"Target",,U,,04/09/2018,"Transfer : Dcu Checking",,,,"",$0.00,$92.15,$0.00
"Target",,U,,04/27/2018,"","RV : Equipment/Supplies","RV","Equipment/Supplies","",$77.41,$0.00,-$77.41
"Target",,U,,05/11/2018,"Flagstaff","RV : Equipment/Supplies","RV","Equipment/Supplies","",$24.53,$0.00,-$101.94
"Target",,U,,06/11/2018,"Transfer : Dcu Checking",,,,"",$0.00,$101.94,$0.00
"Target",,U,,09/10/2018,"","Financial Help : Alyssa","Financial Help","Alyssa","apartment stuff",$132.72,$0.00,-$132.72
"Target",,U,,10/09/2018,"Transfer : Dcu Checking",,,,"",$0.00,$132.72,$0.00
"Target",,U,,02/10/2019,"","Food : Groceries","Food","Groceries","(Split 1/2) ",$40.00,$0.00,-$124.57
"Target",,U,,02/10/2019,"","RV : Equipment/Supplies","RV","Equipment/Supplies","(Split 2/2) ",$84.57,$0.00,-$124.57
"Target",,U,,02/11/2019,"Transfer : Dcu Checking",,,,"",$0.00,$124.57,$0.00
"Target",,U,,03/01/2019,"cloths","Personal : cloths","Personal","cloths","",$41.77,$0.00,-$41.77
"Target",,U,,03/07/2019,"Transfer : Dcu Checking",,,,"",$0.00,$41.77,$0.00
"Target",,U,,05/10/2019,"","Food : Groceries","Food","Groceries","(Split 1/2) ",$40.00,$0.00,-$74.53
"Target",,U,,05/10/2019,"","RV : Equipment/Supplies","RV","Equipment/Supplies","(Split 2/2) ",$34.53,$0.00,-$74.53
"Target",,U,,06/10/2019,"Transfer : Dcu Checking",,,,"",$0.00,$74.53,$0.00
"Target",,U,,07/08/2019,"","Personal : Miscellaneous","Personal","Miscellaneous","",$15.00,$0.00,-$15.00
"Target",,U,,07/08/2019,"","Food : Groceries","Food","Groceries","",$22.66,$0.00,-$37.66
"Target",,U,,07/08/2019,"cloths","Personal : cloths","Personal","cloths","",$30.00,$0.00,-$67.66
"Target",,U,,07/10/2019,"Transfer : Dcu Checking",,,,"",$0.00,$67.66,$0.00
"Target",,U,,08/12/2019,"Transfer : Dcu Checking",,,,"",$0.00,$20.51,$20.51
"Target",,U,,08/12/2019,,"Personal : cloths","Personal","cloths","(Split 1/2) ",$12.00,$0.00,$0.00
"Target",,U,,08/12/2019,,"Food : Groceries","Food","Groceries","(Split 2/2) ",$8.51,$0.00,$0.00
"Target",,U,,09/09/2019,"Transfer : Dcu Checking",,,,"",$0.00,$22.06,$22.06
"Target",,U,,09/30/2019,,"RV : Equipment/Supplies","RV","Equipment/Supplies","",$17.94,$0.00,$4.12
"Target",,U,,09/30/2019,,"Financial Help : Alyssa","Financial Help","Alyssa","",$40.00,$0.00,-$35.88
"Target",,U,,09/30/2019,"","Personal : cloths","Personal","cloths","",$60.00,$0.00,-$95.88
"Target",,U,,10/10/2019,"Transfer : Dcu Checking",,,,"",$0.00,$174.69,$78.81
"Target",,U,,10/28/2019,"random entertinament","Personal : cloths","Personal","cloths","",$78.81,$0.00,$0.00
"Target",,U,,11/11/2019,"","Personal : cloths","Personal","cloths","(Split 1/2) ",$50.00,$0.00,-$88.56
"Target",,U,,11/11/2019,"","RV : Equipment/Supplies","RV","Equipment/Supplies","(Split 2/2) ",$38.56,$0.00,-$88.56
"Target",,U,,11/12/2019,"Transfer : Dcu Checking",,,,"",$0.00,$88.56,$0.00
"Target",,U,,11/24/2019,"groceries","Food : Groceries","Food","Groceries","",$30.00,$0.00,-$30.00
"Target",,U,,11/24/2019,"","Personal : Gifts","Personal","Gifts","",$100.00,$0.00,-$130.00
"Target",,U,,11/24/2019,"","RV : Equipment/Supplies","RV","Equipment/Supplies","",$120.19,$0.00,-$250.19
"Target",,U,,12/09/2019,"Transfer : Dcu Checking",,,,"",$0.00,$250.19,$0.00
"Target",,U,,10/08/2020,"Hyannis Target","RV : Equipment/Supplies","RV","Equipment/Supplies","",$14.24,$0.00,-$14.24
"Target",,U,,11/07/2020,"Braintree Target","RV : Equipment/Supplies","RV","Equipment/Supplies","",$52.68,$0.00,-$66.92
"Target",,U,,11/09/2020,"Transfer : Dcu Checking",,,,"",$0.00,$101.40,$34.48
"Target",,U,,11/10/2020,"Hyannis Target","RV : Equipment/Supplies","RV","Equipment/Supplies","",$5.64,$0.00,$28.84
"Target",,U,,12/04/2020,"","RV : Equipment/Supplies","RV","Equipment/Supplies","",$50.46,$0.00,-$21.62
"Target",,U,,12/10/2020,"Transfer : Dcu Checking",,,,"",$0.00,$47.04,$25.42
"Target",,U,,12/31/2020,"","RV : Equipment/Supplies","RV","Equipment/Supplies","Adjustment because Last year I was not adding taget Transactions",$113.88,$0.00,-$88.46
"Target",,U,,01/07/2021,"","Personal : cloths","Personal","cloths","",$99.91,$0.00,-$188.37
"Target",,U,,01/11/2021,"Transfer : Dcu Checking",,,,"",$0.00,$50.46,-$137.91
"Target",,U,,01/11/2021,"","RV : Equipment/Supplies","RV","Equipment/Supplies","",$2.75,$0.00,-$140.66
"Target",,U,,01/11/2021,"","RV : Equipment/Supplies","RV","Equipment/Supplies","",$333.08,$0.00,-$473.74
"Target",,U,,01/15/2021,"","RV : Equipment/Supplies","RV","Equipment/Supplies","",$18.15,$0.00,-$491.89
"Target",,U,,01/15/2021,"","RV : Equipment/Supplies","RV","Equipment/Supplies","",$164.26,$0.00,-$656.15
"Target",,U,,01/16/2021,"","Personal : Prescriptions, Medicine","Personal","Prescriptions, Medicine",,$10.00,$0.00,-$666.15
"Target",,U,,01/16/2021,,"Personal : cloths","Personal","cloths","",$20.64,$0.00,-$686.79
"Target",,U,,01/23/2021,,"Personal : Gifts","Personal","Gifts","",$38.55,$0.00,-$725.34
"Target",,U,,02/06/2021,,"RV : Equipment/Supplies","RV","Equipment/Supplies","",$83.61,$0.00,-$808.95
"Target",,U,,02/07/2021,,"Personal : Prescriptions, Medicine","Personal","Prescriptions, Medicine","",$20.00,$0.00,-$828.95
"Target",,U,,02/09/2021,,"RV : Equipment/Supplies","RV","Equipment/Supplies","",$22.93,$0.00,-$851.88
"Target",,U,,02/10/2021,"Transfer : Dcu Checking",,,,"",$0.00,$435.74,-$416.14
"Target",,U,,02/16/2021,,"Food : Groceries","Food","Groceries","",$46.87,$0.00,-$463.01
"Target",,U,,03/09/2021,,"Personal : Prescriptions, Medicine","Personal","Prescriptions, Medicine","",$10.00,$0.00,-$473.01
"Target",,U,,03/09/2021,,"RV : Equipment/Supplies","RV","Equipment/Supplies","",$14.25,$0.00,-$487.26
"Target",,U,,03/10/2021,"Transfer : Dcu Checking",,,,"",$0.00,$416.14,-$71.12
"Target",,U,,03/16/2021,,"RV : Equipment/Supplies","RV","Equipment/Supplies","",$0.00,$6.05,-$65.07
"Target",,U,,03/16/2021,,"RV : Equipment/Supplies","RV","Equipment/Supplies","",$24.20,$0.00,-$89.27
"Target",,U,,03/16/2021,,"RV : Equipment/Supplies","RV","Equipment/Supplies","",$98.05,$0.00,-$187.32
"Target",,U,,04/09/2021,"Transfer : Dcu Checking",,,,"",$0.00,$71.12,-$116.20
"Target",,U,,04/10/2021,,"Personal : Prescriptions, Medicine","Personal","Prescriptions, Medicine","",$20.00,$0.00,-$136.20
"Target",,U,,04/10/2021,,"RV : Equipment/Supplies","RV","Equipment/Supplies","",$34.46,$0.00,-$170.66
"Target",,U,,05/04/2021,"Transfer : Dcu Checking",,,,"",$0.00,$170.66,$0.00
"Target",,U,,05/09/2021,,"Personal : Prescriptions, Medicine","Personal","Prescriptions, Medicine","",$1.18,$0.00,-$1.18
"Target",,U,,05/09/2021,,"Personal : Prescriptions, Medicine","Personal","Prescriptions, Medicine","",$40.00,$0.00,-$41.18
"Target",,U,,05/09/2021,,"RV : Equipment/Supplies","RV","Equipment/Supplies","",$85.95,$0.00,-$127.13
"Target",,U,,05/10/2021,,"RV : Equipment/Supplies","RV","Equipment/Supplies","",$224.95,$0.00,-$352.08
"Target",,U,,05/12/2021,,"RV : Equipment/Supplies","RV","Equipment/Supplies","",$0.00,$10.09,-$341.99
"Target",,U,,05/22/2021,,"RV : Equipment/Supplies","RV","Equipment/Supplies","",$22.20,$0.00,-$364.19
"Target",,U,,05/26/2021,,"Personal : Gifts","Personal","Gifts","",$19.47,$0.00,-$383.66
"Target",,U,,06/01/2021,,"RV : Equipment/Supplies","RV","Equipment/Supplies","",$24.12,$0.00,-$407.78
"Target",,U,,06/05/2021,"","Personal : Prescriptions, Medicine","Personal","Prescriptions, Medicine","",$20.00,$0.00,-$427.78
"Target",,U,,06/05/2021,"","Personal : Gifts","Personal","Gifts","(Split 1/2) Kim Birthday",$253.00,$0.00,-$831.81
"Target",,U,,06/05/2021,"","RV : Equipment/Supplies","RV","Equipment/Supplies","(Split 2/2) ",$151.03,$0.00,-$831.81
"Target",,U,,06/09/2021,"Transfer : Dcu Checking",,,,"",$0.00,$352.08,-$479.73
"Target",,U,,07/12/2021,"Transfer : Dcu Checking",,,,"",$0.00,$479.73,$0.00
"Target",,U,,10/11/2021,,"RV : Equipment/Supplies","RV","Equipment/Supplies","",$33.25,$0.00,-$33.25
"Target",,U,,11/10/2021,"Transfer : Dcu Checking",,,,"",$0.00,$33.25,$0.00
"Target Lisa",,U,,06/17/2013,"Transfer : Avidia Checking",,,,"",$0.00,$116.71,$116.71
"Target Lisa",,C,,06/18/2013,"Starting Balance","Income : Available this month","Income","Available this month",,$0.00,$0.00,$116.71
"Target Lisa",,U,,06/18/2013,"target","Food : Groceries","Food","Groceries","(Split 1/2) ",$58.00,$0.00,$0.00
"Target Lisa",,U,,06/18/2013,"target","Housing : Supplies","Hidden Categories","Housing ` Supplies","(Split 2/2) ",$58.71,$0.00,$0.00
"Target Lisa",,U,,07/15/2013,"Transfer : Avidia Checking",,,,"",$0.00,$563.64,$563.64
"Target Lisa",,U,,07/19/2013,"target","Food : Groceries","Food","Groceries","(Split 1/4) ",$150.00,$0.00,$0.30
"Target Lisa",,U,,07/19/2013,"target","Personal : Gifts","Personal","Gifts","(Split 2/4) approx",$200.00,$0.00,$0.30
"Target Lisa",,U,,07/19/2013,"target","Personal : Prescriptions, Medicine","Personal","Prescriptions, Medicine","(Split 3/4) aproximate",$70.00,$0.00,$0.30
"Target Lisa",,U,,07/19/2013,"target","Housing : Supplies","Hidden Categories","Housing ` Supplies","(Split 4/4) ",$143.34,$0.00,$0.30
"Target Lisa",,U,,08/14/2013,"Adj balance","Housing : Supplies","Hidden Categories","Housing ` Supplies","",$110.50,$0.00,-$110.20
"Target Lisa",,U,,08/15/2013,"Transfer : Avidia Checking",,,,"",$0.00,$110.20,$0.00
"Target Lisa",,U,,09/14/2013,"Adj balance","Food : Groceries","Food","Groceries","(Split 1/2) 200",$200.00,$0.00,-$412.25
"Target Lisa",,U,,09/14/2013,"Adj balance","Housing : Supplies","Hidden Categories","Housing ` Supplies","(Split 2/2) 212.25",$212.25,$0.00,-$412.25
"Target Lisa",,U,,09/16/2013,"Transfer : Avidia Checking",,,,"",$0.00,$412.25,$0.00
"Target Lisa",,U,,10/14/2013,"Adj balance",,,,"",$0.00,$0.00,$0.00
"Target Lisa",,U,,10/14/2013,"Adj balance","Food : Groceries","Food","Groceries","(Split 1/2) ",$170.00,$0.00,-$342.90
"Target Lisa",,U,,10/14/2013,"Adj balance","Housing : Supplies","Hidden Categories","Housing ` Supplies","(Split 2/2) ",$172.90,$0.00,-$342.90
"Target Lisa",,U,,10/15/2013,"Transfer : Avidia Checking",,,,"",$0.00,$342.90,$0.00
"Target Lisa",,U,,11/11/2013,"Adj balance","Food : Groceries","Food","Groceries","(Split 1/2) ",$53.62,$0.00,-$153.62
"Target Lisa",,U,,11/11/2013,"Adj balance","Housing : Supplies","Hidden Categories","Housing ` Supplies","(Split 2/2) ",$100.00,$0.00,-$153.62
"Target Lisa",,U,,11/15/2013,"Transfer : Avidia Checking",,,,"",$0.00,$153.62,$0.00
"Target Lisa",,U,,12/09/2013,"bal adj","Food : Groceries","Food","Groceries","(Split 1/2) ",$170.84,$0.00,-$670.84
"Target Lisa",,U,,12/09/2013,"bal adj","Housing : Supplies","Hidden Categories","Housing ` Supplies","(Split 2/2) ",$500.00,$0.00,-$670.84
"Target Lisa",,U,,12/10/2013,"Transfer : Avidia Checking",,,,"",$0.00,$500.00,-$170.84
"Target Lisa",,U,,12/16/2013,"Transfer : Avidia Checking",,,,"",$0.00,$170.84,$0.00
"Target Lisa",,U,,02/12/2014,"bal adj","Food : Groceries","Food","Groceries","(Split 1/2) ",$97.00,$0.00,-$197.18
"Target Lisa",,U,,02/12/2014,"bal adj","Housing : Supplies","Hidden Categories","Housing ` Supplies","(Split 2/2) ",$100.18,$0.00,-$197.18
"Target Lisa",,U,,02/18/2014,"Transfer : Avidia Checking",,,,"",$0.00,$197.18,$0.00
"DCU Savings",,C,,07/15/2013,"Starting Balance","Income : Available this month","Income","Available this month",,$0.00,$0.00,$0.00
"DCU Savings",,U,,07/19/2013,"Transfer : Avidia Checking",,,,"",$0.00,$1000.00,$1000.00
"DCU Savings",,U,,07/19/2013,"DCU","Personal : Miscellaneous","Personal","Miscellaneous","",$395.00,$0.00,$605.00
"DCU Savings",,U,,07/31/2013,"interest","Income : Available this month","Income","Available this month","",$0.00,$0.01,$605.01
"DCU Savings",,U,,08/19/2013,"DCU","Personal : Miscellaneous","Personal","Miscellaneous","",$0.00,$395.00,$1000.01
"DCU Savings",,U,,08/31/2013,"interest","Food : Groceries","Food","Groceries","",$0.00,$0.03,$1000.04
"DCU Savings",,U,,09/30/2013,"Transfer : DCU Home Equity Credit line",,,,"",$0.00,$3000.00,$4000.04
"DCU Savings",,U,,09/30/2013,"interest","Food : Groceries","Food","Groceries","",$0.00,$0.05,$4000.09
"DCU Savings",,U,,10/07/2013,"Transfer : Dcu Checking",,,,"",$3700.00,$0.00,$300.09
"DCU Savings",,U,,10/24/2013,"Transfer : DCU Home Equity Credit line",,,,"",$100.00,$0.00,$200.09
"DCU Savings",,U,,10/31/2013,"interest","Food : Groceries","Food","Groceries","",$0.00,$0.04,$200.13
"DCU Savings",,U,,11/25/2013,"Transfer : DCU Home Equity Credit line",,,,"",$65.00,$0.00,$135.13
"DCU Savings",,U,,11/30/2013,"interest","Income : Available this month","Income","Available this month","",$0.00,$0.01,$135.14
"DCU Savings",,U,,12/23/2013,"Transfer : DCU Home Equity Credit line",,,,"",$100.00,$0.00,$35.14
"DCU Savings",,U,,01/31/2014,"interest","Income : Available this month","Income","Available this month","",$0.00,$0.09,$35.23
"DCU Savings",,U,,02/28/2014,"interest","Income : Available next month","Income","Available next month","",$0.00,$0.08,$35.31
"DCU Savings",,U,,03/31/2014,"interest","Income : Available next month","Income","Available next month","",$0.00,$0.09,$35.40
"DCU Savings",,U,,04/30/2014,"interest","Income : Available next month","Income","Available next month","",$0.00,$0.09,$35.49
"DCU Savings",,U,,05/31/2014,"interest","Income : Available next month","Income","Available next month","",$0.00,$0.09,$35.58
"DCU Savings",,U,,06/25/2014,"Transfer : DCU Home Equity Credit line",,,,"",$30.58,$0.00,$5.00
"DCU Savings",,U,,06/30/2014,"interest","Income : Available next month","Income","Available next month","",$0.00,$0.07,$5.07
"DCU Savings",,U,,07/14/2014,"Transfer : DCU Home Equity Credit line",,,,"",$0.00,$6000.00,$6005.07
"DCU Savings",,U,,07/14/2014,"Transfer : Dcu Checking",,,,"",$5900.00,$0.00,$105.07
"DCU Savings",,U,,07/31/2014,"interest","Income : Available next month","Income","Available next month","",$0.00,$0.16,$105.23
"DCU Savings",,U,,08/25/2014,"Transfer : DCU Home Equity Credit line",,,,"",$100.23,$0.00,$5.00
"DCU Savings",,U,,08/31/2014,"interest","Income : Available next month","Income","Available next month","",$0.00,$0.21,$5.21
"DCU Savings",,U,,09/30/2014,"interest","Income : Available next month","Income","Available next month","",$0.00,$0.01,$5.22
"DCU Savings",,U,,10/30/2014,"interest","Income : Available next month","Income","Available next month","",$0.00,$0.01,$5.23
"DCU Savings",,U,,11/30/2014,"interest","Income : Available next month","Income","Available next month","",$0.00,$0.01,$5.24
"DCU Savings",,U,,12/31/2014,"interest","Income : Available next month","Income","Available next month","",$0.00,$0.01,$5.25
"DCU Savings",,U,,01/31/2015,"interest","Income : Available next month","Income","Available next month","",$0.00,$0.01,$5.26
"DCU Savings",,U,,02/28/2015,"interest","Income : Available next month","Income","Available next month","",$0.00,$0.01,$5.27
"DCU Savings",,U,,03/31/2015,"interest","Income : Available next month","Income","Available next month","",$0.00,$0.01,$5.28
"DCU Savings",,U,,04/30/2015,"interest","Income : Available next month","Income","Available next month","",$0.00,$0.01,$5.29
"DCU Savings",,U,,05/31/2015,"interest","Income : Available next month","Income","Available next month","",$0.00,$0.01,$5.30
"DCU Savings",,U,,06/30/2015,"interest","Income : Available next month","Income","Available next month","",$0.00,$0.01,$5.31
"DCU Savings",,U,,07/31/2015,"interest","Income : Available next month","Income","Available next month","",$0.00,$0.01,$5.32
"DCU Savings",,U,,08/31/2015,"interest","Income : Available next month","Income","Available next month","",$0.00,$0.01,$5.33
"DCU Savings",,U,,09/30/2015,"interest","Income : Available next month","Income","Available next month","",$0.00,$0.01,$5.34
"DCU Savings",,U,,10/31/2015,"interest","Income : Available next month","Income","Available next month","",$0.00,$0.01,$5.35
"DCU Savings",,U,,11/30/2015,"interest","Income : Available next month","Income","Available next month","",$0.00,$0.01,$5.36
"DCU Savings",,U,,12/31/2015,"interest","Income : Available next month","Income","Available next month","",$0.00,$0.01,$5.37
"DCU Savings",,U,,01/31/2016,"interest","Income : Available next month","Income","Available next month","",$0.00,$0.01,$5.38
"DCU Savings",,U,,02/29/2016,"interest","Income : Available next month","Income","Available next month","",$0.00,$0.01,$5.39
"DCU Savings",,U,,03/31/2016,"interest","Income : Available next month","Income","Available next month","",$0.00,$0.01,$5.40
"DCU Savings",,U,,04/30/2016,"interest","Income : Available next month","Income","Available next month","",$0.00,$0.01,$5.41
"DCU Savings",,U,,05/25/2016,"Transfer : DCU Home Equity Credit line",,,,"",$0.41,$0.00,$5.00
"DCU Savings",,U,,05/30/2016,"interest","Income : Available next month","Income","Available next month","",$0.00,$0.01,$5.01
"DCU Savings",,U,,06/25/2016,"Transfer : DCU Home Equity Credit line",,,,"",$0.01,$0.00,$5.00
"DCU Savings",,U,,06/30/2016,"interest","Income : Available next month","Income","Available next month","",$0.00,$0.01,$5.01
"DCU Savings",,U,,07/25/2016,"Transfer : DCU Home Equity Credit line",,,,"",$0.01,$0.00,$5.00
"DCU Savings",,U,,07/31/2016,"interest","Income : Available next month","Income","Available next month","",$0.00,$0.01,$5.01
"DCU Savings",,U,,08/31/2016,"Transfer : DCU Home Equity Credit line",,,,"",$0.00,$4000.00,$4005.01
"DCU Savings",,U,,08/31/2016,"interest","Income : Available next month","Income","Available next month","",$0.00,$0.01,$4005.02
"DCU Savings",,U,,08/31/2016,"Transfer : Dcu Checking",,,,"",$4000.00,$0.00,$5.02
"DCU Savings",,U,,09/30/2016,"interest","Income : Available next month","Income","Available next month","",$0.00,$0.01,$5.03
"DCU Savings",,U,,10/31/2016,"interest","Income : Available next month","Income","Available next month","",$0.00,$0.01,$5.04
"DCU Savings",,U,,11/30/2016,"interest","Income : Available next month","Income","Available next month","",$0.00,$0.02,$5.06
"DCU Savings",,U,,12/12/2016,"income","Income : Available next month","Income","Available next month","",$0.00,$16016.34,$16021.40
"DCU Savings",,U,,12/31/2016,"interest","Income : Available next month","Income","Available next month","",$0.00,$2.48,$16023.88
"DCU Savings",,U,,01/31/2017,"interest","Income : Available next month","Income","Available next month","",$0.00,$3.83,$16027.71
"DCU Savings",,U,,02/28/2017,"interest","Income : Available next month","Income","Available next month","",$0.00,$3.46,$16031.17
"DCU Savings",,U,,03/31/2017,"interest","Income : Available next month","Income","Available next month","",$0.00,$3.83,$16035.00
"DCU Savings",,U,,04/30/2017,"interest","Income : Available next month","Income","Available next month","",$0.00,$3.71,$16038.71
"DCU Savings",,U,,05/31/2017,"interest","Income : Available next month","Income","Available next month","",$0.00,$3.83,$16042.54
"DCU Savings",,U,,06/30/2017,"income","Income : Available next month","Income","Available next month","",$0.00,$3.71,$16046.25
"DCU Savings",,U,,07/09/2017,"Transfer : DCU LTD account",,,,"",$15000.00,$0.00,$1046.25
"DCU Savings",,U,,07/31/2017,"interest","Income : Available next month","Income","Available next month","",$0.00,$3.36,$1049.61
"DCU Savings",,U,,08/31/2017,"interest","Income : Available next month","Income","Available next month","",$0.00,$4.25,$1053.86
"DCU Savings",,U,,08/31/2017,"bank  fee","Personal : BankFee","Personal","BankFee","",$0.00,$2.50,$1056.36
"DCU Savings",,U,,09/30/2017,"bank  fee","Personal : BankFee","Personal","BankFee","",$0.00,$5.00,$1061.36
"DCU Savings",,U,,09/30/2017,"interest","Income : Available next month","Income","Available next month","",$0.00,$4.11,$1065.47
"DCU Savings",,U,,10/31/2017,"interest","Income : Available next month","Income","Available next month","",$0.00,$4.25,$1069.72
"DCU Savings",,U,,11/30/2017,"interest","Income : Available next month","Income","Available next month","",$0.00,$4.11,$1073.83
"DCU Savings",,U,,12/31/2017,"interest","Income : Available next month","Income","Available next month","",$0.00,$4.25,$1078.08
"DCU Savings",,U,,01/31/2018,"interest","Income : Available next month","Income","Available next month","",$0.00,$4.25,$1082.33
"DCU Savings",,U,,02/28/2018,"interest","Income : Available next month","Income","Available next month","",$0.00,$3.84,$1086.17
"DCU Savings",,U,,03/31/2018,"interest","Income : Available next month","Income","Available next month","",$0.00,$4.25,$1090.42
"DCU Savings",,U,,04/30/2018,"interest","Income : Available next month","Income","Available next month","",$0.00,$4.13,$1094.55
"DCU Savings",,U,,05/31/2018,"interest","Income : Available next month","Income","Available next month","",$0.00,$4.27,$1098.82
"DCU Savings",,U,,06/30/2018,"interest","Income : Available next month","Income","Available next month","",$0.00,$4.13,$1102.95
"DCU Savings",,U,,06/30/2018,"bank  fee","Personal : BankFee","Personal","BankFee","reimburst",$0.00,$1.00,$1103.95
"DCU Savings",,U,,07/31/2018,"interest","Income : Available next month","Income","Available next month","",$0.00,$4.27,$1108.22
"DCU Savings",,U,,08/31/2018,"interest","Income : Available next month","Income","Available next month","",$0.00,$4.27,$1112.49
"DCU Savings",,U,,09/30/2018,"interest","Income : Available next month","Income","Available next month","",$0.00,$4.13,$1116.62
"DCU Savings",,U,,10/31/2018,"interest","Income : Available next month","Income","Available next month","",$0.00,$4.27,$1120.89
"DCU Savings",,U,,11/30/2018,"interest","Income : Available next month","Income","Available next month","",$0.00,$4.96,$1125.85
"DCU Savings",,U,,12/31/2018,"interest","Income : Available next month","Income","Available next month","",$0.00,$5.12,$1130.97
"DCU Savings",,U,,01/31/2019,"interest","Income : Available next month","Income","Available next month","",$0.00,$5.12,$1136.09
"DCU Savings",,U,,02/28/2019,"interest","Income : Available next month","Income","Available next month","",$0.00,$4.63,$1140.72
"DCU Savings",,U,,03/31/2019,"interest","Income : Available next month","Income","Available next month","",$0.00,$5.13,$1145.85
"DCU Savings",,U,,04/30/2019,"interest","Income : Available next month","Income","Available next month","",$0.00,$4.96,$1150.81
"DCU Savings",,U,,04/30/2019,"bank  fee","Personal : BankFee","Personal","BankFee","",$0.00,$3.00,$1153.81
"DCU Savings",,U,,05/31/2019,"interest","Income : Available next month","Income","Available next month","",$0.00,$5.13,$1158.94
"DCU Savings",,U,,06/30/2019,"interest","Income : Available next month","Income","Available next month","",$0.00,$4.96,$1163.90
"DCU Savings",,U,,07/31/2019,"interest","Income : Available next month","Income","Available next month","",$0.00,$5.13,$1169.03
"DCU Savings",,U,,08/31/2019,"interest","Income : Available next month","Income","Available next month","",$0.00,$5.13,$1174.16
"DCU Savings",,U,,09/30/2019,"interest","Income : Available next month","Income","Available next month","",$0.00,$4.97,$1179.13
"DCU Savings",,U,,10/31/2019,"interest","Income : Available next month","Income","Available next month","",$0.00,$5.13,$1184.26
"DCU Savings",,U,,11/30/2019,"interest","Income : Available next month","Income","Available next month","",$0.00,$4.97,$1189.23
"DCU Savings",,U,,11/30/2019,"bank  fee","Personal : BankFee","Personal","BankFee","",$0.00,$2.50,$1191.73
"DCU Savings",,U,,01/31/2020,"bankfee","Personal : BankFee","Personal","BankFee","",$0.00,$5.50,$1197.23
"DCU Savings",,U,,01/31/2020,"interest","Income : Available next month","Income","Available next month","",$0.00,$5.14,$1202.37
"DCU Savings",,U,,01/31/2020,"interest","Income : Available next month","Income","Available next month","",$0.00,$5.14,$1207.51
"DCU Savings",,U,,02/29/2020,"interest","Income : Available next month","Income","Available next month","",$0.00,$4.81,$1212.32
"DCU Savings",,U,,03/31/2020,"interest","Income : Available next month","Income","Available next month","",$0.00,$5.14,$1217.46
"DCU Savings",,U,,04/17/2020,"Transfer : DCU LTD account",,,,"",$0.00,$2623.94,$3841.40
"DCU Savings",,U,,11/03/2020,"Transfer : Dcu Checking",,,,"",$2000.00,$0.00,$1841.40
"DCU Savings",,U,,12/07/2020,"Transfer : Dcu Checking",,,,"",$1000.00,$0.00,$841.40
"DCU Home Equity Credit line",,U,,09/30/2013,"Transfer : DCU Savings",,,,"",$3000.00,$0.00,-$3000.00
"DCU Home Equity Credit line",,U,,10/24/2013,"Transfer : DCU Savings",,,,"",$0.00,$100.00,-$2900.00
"DCU Home Equity Credit line",,U,,10/24/2013,"Interest Payment","Loans : HALOC Interest Payment","Loans","HALOC Interest Payment","",$7.89,$0.00,-$2907.89
"DCU Home Equity Credit line",,C,,11/01/2013,"Starting Balance","Income : Available this month","Income","Available this month",,$0.00,$0.00,-$2907.89
"DCU Home Equity Credit line",,U,,11/09/2013,"Transfer : Dcu Checking",,,,"",$0.00,$400.00,-$2507.89
"DCU Home Equity Credit line",,U,,11/09/2013,"Interest Payment","Loans : HALOC Interest Payment","Loans","HALOC Interest Payment","",$5.10,$0.00,-$2512.99
"DCU Home Equity Credit line",,U,,11/09/2013,"Transfer : Dcu Checking",,,,"",$3700.00,$0.00,-$6212.99
"DCU Home Equity Credit line",,U,,11/25/2013,"Transfer : DCU Savings",,,,"",$0.00,$65.00,-$6147.99
"DCU Home Equity Credit line",,U,,11/25/2013,"Interest Payment","Loans : HALOC Interest Payment","Loans","HALOC Interest Payment","",$10.89,$0.00,-$6158.88
"DCU Home Equity Credit line",,U,,12/11/2013,"Transfer : Dcu Checking",,,,"",$3200.00,$0.00,-$9358.88
"DCU Home Equity Credit line",,U,,12/23/2013,"Transfer : DCU Savings",,,,"",$0.00,$100.00,-$9258.88
"DCU Home Equity Credit line",,U,,12/23/2013,"Interest Payment","Loans : HALOC Interest Payment","Loans","HALOC Interest Payment","",$23.11,$0.00,-$9281.99
"DCU Home Equity Credit line",,U,,01/15/2014,"Transfer : Dcu Checking",,,,"",$3000.00,$0.00,-$12281.99
"DCU Home Equity Credit line",,U,,01/22/2014,"Transfer : Dcu Checking",,,,"",$0.00,$100.00,-$12181.99
"DCU Home Equity Credit line",,U,,01/22/2014,"Interest Payment","Loans : HALOC Interest Payment","Loans","HALOC Interest Payment","",$32.81,$0.00,-$12214.80
"DCU Home Equity Credit line",,U,,01/29/2014,"Transfer : Dcu Checking",,,,"",$1200.00,$0.00,-$13414.80
"DCU Home Equity Credit line",,U,,02/08/2014,"Transfer : Dcu Checking",,,,"",$3500.00,$0.00,-$16914.80
"DCU Home Equity Credit line",,U,,02/20/2014,"Transfer : Dcu Checking",,,,"",$0.00,$200.00,-$16714.80
"DCU Home Equity Credit line",,U,,02/20/2014,"Interest Payment","Loans : HALOC Interest Payment","Loans","HALOC Interest Payment","",$38.18,$0.00,-$16752.98
"DCU Home Equity Credit line",,U,,02/27/2014,"Transfer : Dcu Checking",,,,"",$500.00,$0.00,-$17252.98
"DCU Home Equity Credit line",,U,,02/28/2014,"Transfer : Dcu Checking",,,,"",$2000.00,$0.00,-$19252.98
"DCU Home Equity Credit line",,U,,03/10/2014,"Transfer : Dcu Checking",,,,"",$3200.00,$0.00,-$22452.98
"DCU Home Equity Credit line",,U,,03/21/2014,"Transfer : Dcu Checking",,,,"",$0.00,$200.00,-$22252.98
"DCU Home Equity Credit line",,U,,03/21/2014,"interest","Loans : HALOC Interest Payment","Loans","HALOC Interest Payment","",$47.18,$0.00,-$22300.16
"DCU Home Equity Credit line",,U,,04/04/2014,"Transfer : Dcu Checking",,,,"",$300.00,$0.00,-$22600.16
"DCU Home Equity Credit line",,U,,04/10/2014,"Transfer : Dcu Checking",,,,"",$3500.00,$0.00,-$26100.16
"DCU Home Equity Credit line",,U,,04/21/2014,"Transfer : Dcu Checking",,,,"",$0.00,$350.00,-$25750.16
"DCU Home Equity Credit line",,U,,04/21/2014,"interest","Loans : HALOC Interest Payment","Loans","HALOC Interest Payment","",$60.41,$0.00,-$25810.57
"DCU Home Equity Credit line",,U,,04/28/2014,"Transfer : Dcu Checking",,,,"",$500.00,$0.00,-$26310.57
"DCU Home Equity Credit line",,U,,05/05/2014,"Transfer : Dcu Checking",,,,"",$1800.00,$0.00,-$28110.57
"DCU Home Equity Credit line",,U,,05/21/2014,"Transfer : Dcu Checking",,,,"",$0.00,$275.00,-$27835.57
"DCU Home Equity Credit line",,U,,05/21/2014,"interest","Loans : HALOC Interest Payment","Loans","HALOC Interest Payment","",$66.96,$0.00,-$27902.53
"DCU Home Equity Credit line",,U,,06/05/2014,"Transfer : Dcu Checking",,,,"",$1600.00,$0.00,-$29502.53
"DCU Home Equity Credit line",,U,,06/25/2014,"Transfer : DCU Savings",,,,"",$0.00,$30.58,-$29471.95
"DCU Home Equity Credit line",,U,,06/25/2014,"Paid interest","Loans : HALOC Interest Payment","Loans","HALOC Interest Payment","",$30.58,$0.00,-$29502.53
"DCU Home Equity Credit line",,U,,06/28/2014,"Transfer : Dcu Checking",,,,"",$0.00,$175.00,-$29327.53
"DCU Home Equity Credit line",,U,,06/28/2014,"interest","Loans : HALOC Interest Payment","Loans","HALOC Interest Payment","",$59.59,$0.00,-$29387.12
"DCU Home Equity Credit line",,C,,06/30/2014,"Transfer : Avidia Checking",,,,"4133",$0.00,$1000.00,-$28387.12
"DCU Home Equity Credit line",,U,,06/30/2014,"interest","Loans : HALOC Interest Payment","Loans","HALOC Interest Payment","",$4.83,$0.00,-$28391.95
"DCU Home Equity Credit line",,U,,07/14/2014,"Transfer : DCU Savings",,,,"",$6000.00,$0.00,-$34391.95
"DCU Home Equity Credit line",,U,,07/16/2014,"Deposit","Income : Available this month","Income","Available this month","",$0.00,$314.81,-$34077.14
"DCU Home Equity Credit line",,U,,07/16/2014,"interest","Loans : HALOC Interest Payment","Loans","HALOC Interest Payment","",$38.32,$0.00,-$34115.46
"DCU Home Equity Credit line",,U,,07/22/2014,"Transfer : Dcu Checking",,,,"",$0.00,$2000.00,-$32115.46
"DCU Home Equity Credit line",,U,,07/22/2014,"interest","Loans : HALOC Interest Payment","Loans","HALOC Interest Payment","",$16.82,$0.00,-$32132.28
"DCU Home Equity Credit line",,U,,08/06/2014,"Transfer : Dcu Checking",,,,"",$3000.00,$0.00,-$35132.28
"DCU Home Equity Credit line",,U,,08/25/2014,"Transfer : DCU Savings",,,,"",$0.00,$100.23,-$35032.05
"DCU Home Equity Credit line",,U,,08/25/2014,"interest","Loans : HALOC Interest Payment","Loans","HALOC Interest Payment","",$94.48,$0.00,-$35126.53
"DCU Home Equity Credit line",,U,,08/26/2014,"Transfer : Avidia Checking",,,,"",$0.00,$1000.00,-$34126.53
"DCU Home Equity Credit line",,U,,08/26/2014,"interest","Loans : HALOC Interest Payment","Loans","HALOC Interest Payment","",$2.89,$0.00,-$34129.42
"DCU Home Equity Credit line",,U,,09/12/2014,"Transfer : Dcu Checking",,,,"",$4000.00,$0.00,-$38129.42
"DCU Home Equity Credit line",,U,,09/22/2014,"Transfer : Dcu Checking",,,,"",$0.00,$500.00,-$37629.42
"DCU Home Equity Credit line",,U,,09/22/2014,"interest","Loans : HALOC Interest Payment","Loans","HALOC Interest Payment","",$79.03,$0.00,-$37708.45
"DCU Home Equity Credit line",,U,,10/14/2014,"Transfer : Dcu Checking",,,,"",$3500.00,$0.00,-$41208.45
"DCU Home Equity Credit line",,U,,10/21/2014,"Transfer : Robert Cash Account",,,,"",$0.00,$597.40,-$40611.05
"DCU Home Equity Credit line",,U,,10/21/2014,"interest","Loans : HALOC Interest Payment","Loans","HALOC Interest Payment","",$91.90,$0.00,-$40702.95
"DCU Home Equity Credit line",,U,,10/24/2014,"Transfer : Robert Cash Account",,,,"",$0.00,$900.00,-$39802.95
"DCU Home Equity Credit line",,U,,10/24/2014,"interest","Loans : HALOC Interest Payment","Loans","HALOC Interest Payment","",$113.75,$0.00,-$39916.70
"DCU Home Equity Credit line",,U,,12/09/2014,"Transfer : Dcu Checking",,,,"",$3000.00,$0.00,-$42916.70
"DCU Home Equity Credit line",,U,,12/11/2014,"Deposit","Income : Available this month","Income","Available this month","",$0.00,$107.27,-$42809.43
"DCU Home Equity Credit line",,U,,12/11/2014,"interest","Loans : HALOC Interest Payment","Loans","HALOC Interest Payment","",$56.26,$0.00,-$42865.69
"DCU Home Equity Credit line",,U,,12/12/2014,"Deposit","Income : Available this month","Income","Available this month","",$0.00,$673.28,-$42192.41
"DCU Home Equity Credit line",,U,,12/12/2014,"Deposit","Income : Available this month","Income","Available this month","",$0.00,$291.90,-$41900.51
"DCU Home Equity Credit line",,U,,12/12/2014,"intersest","Loans : HALOC Interest Payment","Loans","HALOC Interest Payment","",$3.52,$0.00,-$41904.03
"DCU Home Equity Credit line",,U,,01/08/2015,"Transfer : Dcu Checking",,,,"",$2700.00,$0.00,-$44604.03
"DCU Home Equity Credit line",,U,,01/20/2015,"Deposit","Income : Available this month","Income","Available this month","",$0.00,$541.87,-$44062.16
"DCU Home Equity Credit line",,U,,01/20/2015,"interest","Loans : HALOC Interest Payment","Loans","HALOC Interest Payment","",$136.98,$0.00,-$44199.14
"DCU Home Equity Credit line",,U,,01/29/2015,"Transfer : Dcu Checking",,,,"",$5000.00,$0.00,-$49199.14
"DCU Home Equity Credit line",,U,,01/29/2015,"Transfer : Dcu Checking",,,,"",$10000.00,$0.00,-$59199.14
"DCU Home Equity Credit line",,U,,02/05/2015,"Transfer : Dcu Checking",,,,"",$27500.00,$0.00,-$86699.14
"DCU Home Equity Credit line",,U,,02/20/2015,"Transfer : Dcu Checking",,,,"",$0.00,$600.00,-$86099.14
"DCU Home Equity Credit line",,U,,02/20/2015,"interest","Loans : HALOC Interest Payment","Loans","HALOC Interest Payment","173.65",$173.65,$0.00,-$86272.79
"DCU Home Equity Credit line",,U,,03/23/2015,"Transfer : Dcu Checking",,,,"",$0.00,$900.00,-$85372.79
"DCU Home Equity Credit line",,U,,03/23/2015,"interest","Loans : HALOC Interest Payment","Loans","HALOC Interest Payment","",$219.82,$0.00,-$85592.61
"DCU Home Equity Credit line",,U,,04/03/2015,"Transfer : Dcu Checking",,,,"",$3000.00,$0.00,-$88592.61
"DCU Home Equity Credit line",,U,,04/21/2015,"Deposit","Income : Available this month","Income","Available this month","",$0.00,$910.04,-$87682.57
"DCU Home Equity Credit line",,U,,04/21/2015,"interest","Loans : HALOC Interest Payment","Loans","HALOC Interest Payment","",$208.46,$0.00,-$87891.03
"DCU Home Equity Credit line",,U,,05/04/2015,"Transfer : Dcu Checking",,,,"",$3000.00,$0.00,-$90891.03
"DCU Home Equity Credit line",,U,,05/22/2015,"Payment","Income : Available this month","Income","Available this month","Payment",$0.00,$878.91,-$90012.12
"DCU Home Equity Credit line",,U,,05/22/2015,"interest","Loans : HALOC Interest Payment","Loans","HALOC Interest Payment","",$228.38,$0.00,-$90240.50
"DCU Home Equity Credit line",,U,,06/03/2015,"Transfer : Dcu Checking",,,,"",$2000.00,$0.00,-$92240.50
"DCU Home Equity Credit line",,U,,06/19/2015,"Payment","Income : Available next month","Income","Available next month","",$0.00,$369.07,-$91871.43
"DCU Home Equity Credit line",,U,,06/19/2015,"interest","Loans : HALOC Interest Payment","Loans","HALOC Interest Payment","",$210.30,$0.00,-$92081.73
"DCU Home Equity Credit line",,U,,06/24/2015,"Transfer : Dcu Checking",,,,"",$0.00,$4466.66,-$87615.07
"DCU Home Equity Credit line",,U,,06/24/2015,"Payment","Income : Available next month","Income","Available next month","",$0.00,$533.34,-$87081.73
"DCU Home Equity Credit line",,U,,06/24/2015,"interest","Loans : HALOC Interest Payment","Loans","HALOC Interest Payment","",$37.84,$0.00,-$87119.57
"DCU Home Equity Credit line",,U,,07/06/2015,"Transfer : Dcu Checking",,,,"",$1500.00,$0.00,-$88619.57
"DCU Home Equity Credit line",,U,,07/21/2015,"Payment","Income : Available next month","Income","Available next month","",$0.00,$871.20,-$87748.37
"DCU Home Equity Credit line",,U,,07/21/2015,"interest","Loans : HALOC Interest Payment","Loans","HALOC Interest Payment","",$195.19,$0.00,-$87943.56
"DCU Home Equity Credit line",,U,,08/03/2015,"Transfer : Dcu Checking",,,,"",$2400.00,$0.00,-$90343.56
"DCU Home Equity Credit line",,U,,08/21/2015,"Payment","Income : Available this month","Income","Available this month","",$0.00,$200.00,-$90143.56
"DCU Home Equity Credit line",,U,,08/21/2015,"interest","Loans : HALOC Interest Payment","Loans","HALOC Interest Payment","",$227.63,$0.00,-$90371.19
"DCU Home Equity Credit line",,U,,08/24/2015,"Transfer : Avidia Checking",,,,"Check from DCU this alon with 200 above was 1000 loan payment",$0.00,$800.00,-$89571.19
"DCU Home Equity Credit line",,U,,09/02/2015,"Transfer : Dcu Checking",,,,"",$3500.00,$0.00,-$93071.19
"DCU Home Equity Credit line",,U,,09/17/2015,"Transfer : Dcu Checking",,,,"",$0.00,$1000.00,-$92071.19
"DCU Home Equity Credit line",,U,,09/17/2015,"interest","Loans : HALOC Interest Payment","Loans","HALOC Interest Payment","",$203.09,$0.00,-$92274.28
"DCU Home Equity Credit line",,U,,10/01/2015,"Transfer : Dcu Checking",,,,"",$7500.00,$0.00,-$99774.28
"DCU Home Equity Credit line",,U,,10/17/2015,"Transfer : Dcu Checking",,,,"",$0.00,$1200.00,-$98574.28
"DCU Home Equity Credit line",,U,,10/17/2015,"interest","Loans : HALOC Interest Payment","Loans","HALOC Interest Payment","",$237.39,$0.00,-$98811.67
"DCU Home Equity Credit line",,U,,11/19/2015,"Transfer : Dcu Checking",,,,"",$0.00,$2000.00,-$96811.67
"DCU Home Equity Credit line",,U,,11/19/2015,"interest","Loans : HALOC Interest Payment","Loans","HALOC Interest Payment","",$268.01,$0.00,-$97079.68
"DCU Home Equity Credit line",,U,,12/15/2015,"Transfer : Dcu Checking",,,,"",$0.00,$1200.00,-$95879.68
"DCU Home Equity Credit line",,U,,12/15/2015,"interest","Loans : HALOC Interest Payment","Loans","HALOC Interest Payment","",$207.46,$0.00,-$96087.14
"DCU Home Equity Credit line",,U,,01/16/2016,"interest","Loans : HALOC Interest Payment","Loans","HALOC Interest Payment","",$262.60,$0.00,-$96349.74
"DCU Home Equity Credit line",,U,,01/19/2016,"Transfer : Dcu Checking",,,,"",$0.00,$1000.00,-$95349.74
"DCU Home Equity Credit line",,U,,01/19/2016,"interest","Loans : HALOC Interest Payment","Loans","HALOC Interest Payment","",$288.66,$0.00,-$95638.40
"DCU Home Equity Credit line",,U,,02/19/2016,"Transfer : Dcu Checking",,,,"",$0.00,$1000.00,-$94638.40
"DCU Home Equity Credit line",,U,,02/29/2016,"Transfer : Dcu Checking",,,,"",$2500.00,$0.00,-$97138.40
"DCU Home Equity Credit line",,U,,03/19/2016,"Transfer : Dcu Checking",,,,"",$0.00,$1000.00,-$96138.40
"DCU Home Equity Credit line",,U,,03/19/2016,"interest","Loans : HALOC Interest Payment","Loans","HALOC Interest Payment","",$248.61,$0.00,-$96387.01
"DCU Home Equity Credit line",,U,,04/18/2016,"Transfer : Dcu Checking",,,,"",$0.00,$1000.00,-$95387.01
"DCU Home Equity Credit line",,U,,04/18/2016,"interest","Loans : HALOC Interest Payment","Loans","HALOC Interest Payment","",$257.47,$0.00,-$95644.48
"DCU Home Equity Credit line",,U,,04/20/2016,"Transfer : Dcu Checking",,,,"",$0.00,$24970.19,-$70674.29
"DCU Home Equity Credit line",,U,,04/20/2016,"interest","Loans : HALOC Interest Payment","Loans","HALOC Interest Payment","",$17.03,$0.00,-$70691.32
"DCU Home Equity Credit line",,U,,04/26/2016,"Loan chk","Personal : Miscellaneous","Personal","Miscellaneous","",$100.00,$0.00,-$70791.32
"DCU Home Equity Credit line",,U,,05/25/2016,"Transfer : DCU Savings",,,,"",$0.00,$0.41,-$70790.91
"DCU Home Equity Credit line",,U,,05/27/2016,"Transfer : Dcu Checking",,,,"",$0.00,$3000.00,-$67790.91
"DCU Home Equity Credit line",,U,,05/27/2016,"interest","Loans : HALOC Interest Payment","Loans","HALOC Interest Payment","",$232.77,$0.00,-$68023.68
"DCU Home Equity Credit line",,U,,06/25/2016,"Transfer : DCU Savings",,,,"",$0.00,$0.01,-$68023.67
"DCU Home Equity Credit line",,U,,06/28/2016,"Transfer : Dcu Checking",,,,"",$0.00,$1000.00,-$67023.67
"DCU Home Equity Credit line",,U,,06/28/2016,"","Loans : HALOC Interest Payment","Loans","HALOC Interest Payment","",$193.81,$0.00,-$67217.48
"DCU Home Equity Credit line",,U,,07/25/2016,"Transfer : DCU Savings",,,,"",$0.00,$0.01,-$67217.47
"DCU Home Equity Credit line",,U,,07/29/2016,"Transfer : Dcu Checking",,,,"",$0.00,$1500.00,-$65717.47
"DCU Home Equity Credit line",,U,,07/29/2016,"","Loans : HALOC Interest Payment","Loans","HALOC Interest Payment","",$185.53,$0.00,-$65903.00
"DCU Home Equity Credit line",,U,,07/31/2016,"Transfer : Dcu Checking",,,,"",$0.00,$1000.00,-$64903.00
"DCU Home Equity Credit line",,U,,08/05/2016,"Greg Martel for Mac","Lisa Business : Business expenses","Lisa Business","Business expenses","",$650.00,$0.00,-$65553.00
"DCU Home Equity Credit line",,U,,08/17/2016,"Transfer : Dcu Checking",,,,"",$0.00,$2000.00,-$63553.00
"DCU Home Equity Credit line",,U,,08/17/2016,"interest","Loans : HALOC Interest Payment","Loans","HALOC Interest Payment","",$104.85,$0.00,-$63657.85
"DCU Home Equity Credit line",,U,,08/17/2016,"Transfer : Dcu Checking",,,,"",$700.00,$0.00,-$64357.85
"DCU Home Equity Credit line",,U,,08/31/2016,"Transfer : Dcu Checking",,,,"",$4000.00,$0.00,-$68357.85
"DCU Home Equity Credit line",,U,,08/31/2016,"Transfer : DCU Savings",,,,"",$4000.00,$0.00,-$72357.85
"DCU Home Equity Credit line",,U,,09/10/2016,"Transfer : Dcu Checking",,,,"",$5000.00,$0.00,-$77357.85
"DCU Home Equity Credit line",,U,,09/22/2016,"Transfer : Dcu Checking",,,,"",$0.00,$1000.00,-$76357.85
"DCU Home Equity Credit line",,U,,10/22/2016,"Transfer : Dcu Checking",,,,"",$0.00,$1100.00,-$75257.85
"DCU Home Equity Credit line",,U,,10/22/2016,"interest","Loans : HALOC Interest Payment","Loans","HALOC Interest Payment","",$204.60,$0.00,-$75462.45
"DCU Home Equity Credit line",,U,,10/24/2016,"Transfer : Robert Cash Account",,,,"",$0.00,$38000.00,-$37462.45
"DCU Home Equity Credit line",,U,,10/24/2016,"interest","Loans : HALOC Interest Payment","Loans","HALOC Interest Payment","",$13.48,$0.00,-$37475.93
"DCU Home Equity Credit line",,U,,11/15/2016,"Transfer : Dcu Checking",,,,"",$0.00,$5000.00,-$32475.93
"DCU Home Equity Credit line",,U,,11/15/2016,"interest","Loans : HALOC Interest Payment","Loans","HALOC Interest Payment","",$73.87,$0.00,-$32549.80
"DCU Home Equity Credit line",,U,,11/16/2016,"Transfer : Dcu Checking",,,,"",$0.00,$4000.00,-$28549.80
"DCU Home Equity Credit line",,U,,12/06/2016,"Transfer : Robert Cash Account",,,,"",$0.00,$10005.26,-$18544.54
"DCU Home Equity Credit line",,U,,12/06/2016,"Transfer : Dcu Checking",,,,"",$0.00,$6000.00,-$12544.54
"DCU Home Equity Credit line",,U,,12/06/2016,"interest","Loans : HALOC Interest Payment","Loans","HALOC Interest Payment","",$54.18,$0.00,-$12598.72
"DCU Home Equity Credit line",,U,,12/12/2016,"Transfer : Robert Cash Account",,,,"",$0.00,$12839.74,$241.02
"DCU Home Equity Credit line",,U,,12/12/2016,"interest","Loans : HALOC Interest Payment","Loans","HALOC Interest Payment","",$6.86,$0.00,$234.16
"DCU Home Equity Credit line",,U,,12/20/2016,"balance",,,,"Zero out aftr the fact - -",$234.16,$0.00,$0.00
"Dcu Checking",,U,,08/14/2013,"Transfer : Robert Cash Account",,,,"Open Account",$0.00,$40.00,$40.00
"Dcu Checking",,C,,08/14/2013,"Starting Balance","Income : Available this month","Income","Available this month",,$0.00,$0.00,$40.00
"Dcu Checking",,U,,10/07/2013,"Transfer : DCU Savings",,,,"",$0.00,$3700.00,$3740.00
"Dcu Checking",,U,,10/07/2013,"Mount Holyoke","Education : College","Education","College","",$3491.75,$0.00,$248.25
"Dcu Checking",,U,,11/09/2013,"Transfer : DCU Home Equity Credit line",,,,"",$0.00,$3700.00,$3948.25
"Dcu Checking",,U,,11/09/2013,"Transfer : DCU Home Equity Credit line",,,,"",$400.00,$0.00,$3548.25
"Dcu Checking",,U,,11/12/2013,"Mount Holyoke","Education : College","Education","College","",$3491.75,$0.00,$56.50
"Dcu Checking",,U,,12/11/2013,"Transfer : DCU Home Equity Credit line",,,,"",$0.00,$3200.00,$3256.50
"Dcu Checking",,U,,12/12/2013,"Mount Holyoke","Education : College","Education","College","",$35.00,$0.00,$3221.50
"Dcu Checking",,U,,12/12/2013,"Mount Holyoke","Education : College","Education","College","",$3013.20,$0.00,$208.30
"Dcu Checking",,U,,01/15/2014,"Transfer : DCU Home Equity Credit line",,,,"",$0.00,$3000.00,$3208.30
"Dcu Checking",,U,,01/16/2014,"Mount Holyoke","Education : College","Education","College","",$3013.20,$0.00,$195.10
"Dcu Checking",,U,,01/22/2014,"Transfer : DCU Home Equity Credit line",,,,"",$100.00,$0.00,$95.10
"Dcu Checking",,U,,01/29/2014,"Transfer : DCU Home Equity Credit line",,,,"",$0.00,$1200.00,$1295.10
"Dcu Checking",,U,,02/08/2014,"Transfer : DCU Home Equity Credit line",,,,"",$0.00,$3500.00,$4795.10
"Dcu Checking",,U,,02/10/2014,"softright","Personal : Health Insurance","Personal","Health Insurance","check #94",$954.00,$0.00,$3841.10
"Dcu Checking",,U,,02/11/2014,"Mount Holyoke","Education : College","Education","College","",$3015.87,$0.00,$825.23
"Dcu Checking",,U,,02/20/2014,"Transfer : DCU Home Equity Credit line",,,,"",$200.00,$0.00,$625.23
"Dcu Checking",,U,,02/27/2014,"Transfer : DCU Home Equity Credit line",,,,"",$0.00,$500.00,$1125.23
"Dcu Checking",,U,,02/28/2014,"Transfer : DCU Home Equity Credit line",,,,"",$0.00,$2000.00,$3125.23
"Dcu Checking",,U,,03/06/2014,"softright","Personal : Health Insurance","Personal","Health Insurance","CHECK #93",$954.00,$0.00,$2171.23
"Dcu Checking",,U,,03/06/2014,"Transfer : Discover",,,,"",$1560.52,$0.00,$610.71
"Dcu Checking",,U,,03/10/2014,"Transfer : DCU Home Equity Credit line",,,,"",$0.00,$3200.00,$3810.71
"Dcu Checking",,U,,03/18/2014,"Mount Holyoke","Education : College","Education","College","",$3480.36,$0.00,$330.35
"Dcu Checking",,U,,03/21/2014,"Transfer : DCU Home Equity Credit line",,,,"",$200.00,$0.00,$130.35
"Dcu Checking",,U,,03/24/2014,"Deposit","Income : Available this month","Income","Available this month","From Karina",$0.00,$1000.00,$1130.35
"Dcu Checking",,U,,04/04/2014,"Transfer : DCU Home Equity Credit line",,,,"",$0.00,$300.00,$1430.35
"Dcu Checking",,U,,04/07/2014,"Transfer : Discover",,,,"",$1179.77,$0.00,$250.58
"Dcu Checking",,U,,04/10/2014,"Transfer : DCU Home Equity Credit line",,,,"",$0.00,$3500.00,$3750.58
"Dcu Checking",,U,,04/11/2014,"Mount Holyoke","Education : College","Education","College","",$3354.37,$0.00,$396.21
"Dcu Checking",,U,,04/21/2014,"Transfer : DCU Home Equity Credit line",,,,"",$350.00,$0.00,$46.21
"Dcu Checking",,U,,04/28/2014,"Transfer : DCU Home Equity Credit line",,,,"",$0.00,$500.00,$546.21
"Dcu Checking",,U,,04/28/2014,"Robin Schulman","Recreation : His","Recreation","His","Bike tuneup",$169.06,$0.00,$377.15
"Dcu Checking",,U,,05/05/2014,"Transfer : DCU Home Equity Credit line",,,,"",$0.00,$1800.00,$2177.15
"Dcu Checking",,U,,05/06/2014,"Transfer : Discover",,,,"",$1822.27,$0.00,$354.88
"Dcu Checking",,U,,05/21/2014,"Transfer : DCU Home Equity Credit line",,,,"",$275.00,$0.00,$79.88
"Dcu Checking",,U,,06/05/2014,"Transfer : DCU Home Equity Credit line",,,,"",$0.00,$1600.00,$1679.88
"Dcu Checking",,U,,06/06/2014,"Transfer : Discover",,,,"",$1490.12,$0.00,$189.76
"Dcu Checking",,U,,06/19/2014,"Mount Holyoke","Education : College","Education","College","",$8.00,$0.00,$181.76
"Dcu Checking",,U,,06/28/2014,"Transfer : DCU Home Equity Credit line",,,,"",$175.00,$0.00,$6.76
"Dcu Checking",,U,,07/07/2014,"bank  fee","Personal : BankFee","Personal","BankFee","",$30.00,$0.00,-$23.24
"Dcu Checking",,U,,07/09/2014,"bank fee","Personal : BankFee","Personal","BankFee","",$30.00,$0.00,-$53.24
"Dcu Checking",,U,,07/11/2014,"bank  fee","Personal : BankFee","Personal","BankFee","",$30.00,$0.00,-$83.24
"Dcu Checking",,U,,07/14/2014,"Transfer : DCU Savings",,,,"",$0.00,$5900.00,$5816.76
"Dcu Checking",,U,,07/16/2014,"Uconn","Education : College","Education","College","",$3210.25,$0.00,$2606.51
"Dcu Checking",,U,,07/22/2014,"Transfer : DCU Home Equity Credit line",,,,"",$2000.00,$0.00,$606.51
"Dcu Checking",,U,,08/06/2014,"Transfer : DCU Home Equity Credit line",,,,"",$0.00,$3000.00,$3606.51
"Dcu Checking",,U,,08/18/2014,"Uconn","Education : College","Education","College","",$3439.58,$0.00,$166.93
"Dcu Checking",,U,,09/12/2014,"Transfer : DCU Home Equity Credit line",,,,"",$0.00,$4000.00,$4166.93
"Dcu Checking",,U,,09/16/2014,"Uconn","Education : College","Education","College","",$3439.59,$0.00,$727.34
"Dcu Checking",,U,,09/22/2014,"Transfer : DCU Home Equity Credit line",,,,"",$500.00,$0.00,$227.34
"Dcu Checking",,U,,10/14/2014,"Transfer : DCU Home Equity Credit line",,,,"",$0.00,$3500.00,$3727.34
"Dcu Checking",,U,,10/16/2014,"Uconn","Education : College","Education","College","",$3439.58,$0.00,$287.76
"Dcu Checking",,U,,11/21/2014,"interest","Income : Available next month","Income","Available next month","",$0.00,$0.01,$287.77
"Dcu Checking",,U,,12/09/2014,"Transfer : DCU Home Equity Credit line",,,,"",$0.00,$3000.00,$3287.77
"Dcu Checking",,U,,12/16/2014,"Uconn","Education : College","Education","College","",$2769.00,$0.00,$518.77
"Dcu Checking",,U,,01/08/2015,"Transfer : DCU Home Equity Credit line",,,,"",$0.00,$2700.00,$3218.77
"Dcu Checking",,U,,01/16/2015,"Uconn","Education : College","Education","College","",$2769.00,$0.00,$449.77
"Dcu Checking",,U,,01/29/2015,"Transfer : DCU Home Equity Credit line",,,,"",$0.00,$10000.00,$10449.77
"Dcu Checking",,U,,01/29/2015,"Transfer : DCU Home Equity Credit line",,,,"",$0.00,$5000.00,$15449.77
"Dcu Checking",,U,96,01/30/2015,"Transfer : Avidia Checking",,,,"",$5000.00,$0.00,$10449.77
"Dcu Checking",,U,,02/03/2015,"Transfer : Discover",,,,"",$3109.58,$0.00,$7340.19
"Dcu Checking",,U,,02/05/2015,"Transfer : DCU Home Equity Credit line",,,,"",$0.00,$27500.00,$34840.19
"Dcu Checking",,U,,02/05/2015,"Bank Check FOR RV",,,,"",$21500.00,$0.00,$13340.19
"Dcu Checking",,U,,02/06/2015,"Deposit","Income : Available this month","Income","Available this month","",$0.00,$200.00,$13540.19
"Dcu Checking",,U,97,02/09/2015,"Mass dot",,,,"Sales tax",$1500.00,$0.00,$12040.19
"Dcu Checking",,U,,02/17/2015,"Uconn","Education : College","Education","College","",$2769.00,$0.00,$9271.19
"Dcu Checking",,U,,02/20/2015,"Transfer : DCU Home Equity Credit line",,,,"",$600.00,$0.00,$8671.19
"Dcu Checking",,U,,03/03/2015,"Transfer : Discover",,,,"",$3776.60,$0.00,$4894.59
"Dcu Checking",,U,,03/16/2015,"Uconn","Education : College","Education","College","",$2619.00,$0.00,$2275.59
"Dcu Checking",,U,,03/23/2015,"Transfer : DCU Home Equity Credit line",,,,"",$900.00,$0.00,$1375.59
"Dcu Checking",,U,,04/03/2015,"Transfer : DCU Home Equity Credit line",,,,"",$0.00,$3000.00,$4375.59
"Dcu Checking",,U,,04/06/2015,"Transfer : Discover",,,,"",$3786.42,$0.00,$589.17
"Dcu Checking",,U,,05/04/2015,"Transfer : DCU Home Equity Credit line",,,,"",$0.00,$3000.00,$3589.17
"Dcu Checking",,U,,05/06/2015,"Transfer : Discover",,,,"",$2896.65,$0.00,$692.52
"Dcu Checking",,U,,05/22/2015,"Transfer : Robert Cash Account",,,,"",$671.01,$0.00,$21.51
"Dcu Checking",,U,,06/03/2015,"Transfer : DCU Home Equity Credit line",,,,"",$0.00,$2000.00,$2021.51
"Dcu Checking",,U,,06/06/2015,"Transfer : Discover",,,,"",$1797.58,$0.00,$223.93
"Dcu Checking",,U,,06/24/2015,"income","Income : Available next month","Income","Available next month","",$0.00,$4466.66,$4690.59
"Dcu Checking",,U,,06/24/2015,"Transfer : DCU Home Equity Credit line",,,,"",$4466.66,$0.00,$223.93
"Dcu Checking",,U,,07/06/2015,"Transfer : DCU Home Equity Credit line",,,,"",$0.00,$1500.00,$1723.93
"Dcu Checking",,U,,07/06/2015,"Transfer : Discover",,,,"",$1489.28,$0.00,$234.65
"Dcu Checking",,U,,07/13/2015,"Deposit","Income : Available this month","Income","Available this month","",$0.00,$300.00,$534.65
"Dcu Checking",,U,,07/21/2015,"Transfer : Robert Cash Account",,,,"",$515.22,$0.00,$19.43
"Dcu Checking",,U,,08/03/2015,"Transfer : DCU Home Equity Credit line",,,,"",$0.00,$2400.00,$2419.43
"Dcu Checking",,U,,08/06/2015,"Transfer : Discover",,,,"",$2122.11,$0.00,$297.32
"Dcu Checking",,U,,09/02/2015,"Transfer : DCU Home Equity Credit line",,,,"",$0.00,$3500.00,$3797.32
"Dcu Checking",,U,,09/06/2015,"Transfer : Discover",,,,"",$2619.67,$0.00,$1177.65
"Dcu Checking",,U,,09/17/2015,"Transfer : DCU Home Equity Credit line",,,,"",$1000.00,$0.00,$177.65
"Dcu Checking",,U,,10/01/2015,"Transfer : DCU Home Equity Credit line",,,,"",$0.00,$7500.00,$7677.65
"Dcu Checking",,U,,10/06/2015,"Transfer : Discover",,,,"",$5287.82,$0.00,$2389.83
"Dcu Checking",,U,,10/17/2015,"Transfer : DCU Home Equity Credit line",,,,"",$1200.00,$0.00,$1189.83
"Dcu Checking",,U,,10/29/2015,"income","Income : Available next month","Income","Available next month","Oracle",$0.00,$3759.49,$4949.32
"Dcu Checking",,U,,11/06/2015,"Transfer : Discover",,,,"",$4093.33,$0.00,$855.99
"Dcu Checking",,U,,11/12/2015,"income","Income : Available next month","Income","Available next month","oracle",$0.00,$3454.35,$4310.34
"Dcu Checking",,U,,11/19/2015,"Transfer : DCU Home Equity Credit line",,,,"",$2000.00,$0.00,$2310.34
"Dcu Checking",,U,,11/27/2015,"income","Income : Available next month","Income","Available next month","oracle",$0.00,$3378.65,$5688.99
"Dcu Checking",,U,,12/06/2015,"Transfer : Discover",,,,"",$1733.40,$0.00,$3955.59
"Dcu Checking",,U,,12/14/2015,"income","Income : Available next month","Income","Available next month","oracle",$0.00,$3535.13,$7490.72
"Dcu Checking",,U,,12/15/2015,"Transfer : DCU Home Equity Credit line",,,,"",$1200.00,$0.00,$6290.72
"Dcu Checking",,U,,12/16/2015,"Uconn","Education : College","Education","College","",$791.25,$0.00,$5499.47
"Dcu Checking",,U,,12/30/2015,"oracle","Income : Available next month","Income","Available next month","",$0.00,$3372.09,$8871.56
"Dcu Checking",,U,,01/06/2016,"Transfer : Discover",,,,"",$4011.68,$0.00,$4859.88
"Dcu Checking",,U,,01/14/2016,"oracle","Income : Available next month","Income","Available next month","",$0.00,$3536.54,$8396.42
"Dcu Checking",,U,,01/19/2016,"Transfer : DCU Home Equity Credit line",,,,"",$1000.00,$0.00,$7396.42
"Dcu Checking",,U,,01/19/2016,"Uconn","Education : College","Education","College","",$3021.92,$0.00,$4374.50
"Dcu Checking",,U,,01/28/2016,"oracle","Income : Available next month","Income","Available next month","",$0.00,$3536.54,$7911.04
"Dcu Checking",,U,,02/01/2016,"Safety Insurance","Transportation : Car Insurance","Transportation","Car Insurance","(Split 1/2) ",$200.00,$0.00,$7528.45
"Dcu Checking",,U,,02/01/2016,"Safety Insurance","Housing : House/Rental Insurance","Hidden Categories","Housing ` House/Rental Insurance","(Split 2/2) ",$182.59,$0.00,$7528.45
"Dcu Checking",,U,,02/04/2016,"Safety Insurance","Transportation : Car Insurance","Transportation","Car Insurance","(Split 1/2) ",$200.00,$0.00,$7145.86
"Dcu Checking",,U,,02/04/2016,"Safety Insurance","Housing : House/Rental Insurance","Hidden Categories","Housing ` House/Rental Insurance","(Split 2/2) ",$182.59,$0.00,$7145.86
"Dcu Checking",,U,,02/06/2016,"Transfer : Discover",,,,"",$2740.02,$0.00,$4405.84
"Dcu Checking",,U,,02/11/2016,"oracle","Income : Available next month","Income","Available next month","",$0.00,$3536.54,$7942.38
"Dcu Checking",,U,,02/16/2016,"Uconn","Education : College","Education","College","",$3046.91,$0.00,$4895.47
"Dcu Checking",,U,,02/19/2016,"Transfer : DCU Home Equity Credit line",,,,"",$1000.00,$0.00,$3895.47
"Dcu Checking",,U,,02/26/2016,"oracle","Income : Available next month","Income","Available next month","",$0.00,$3536.54,$7432.01
"Dcu Checking",,U,,02/29/2016,"Transfer : DCU Home Equity Credit line",,,,"",$0.00,$2500.00,$9932.01
"Dcu Checking",,U,,03/06/2016,"Transfer : Discover",,,,"",$5979.58,$0.00,$3952.43
"Dcu Checking",,U,,03/14/2016,"oracle","Income : Available next month","Income","Available next month","",$0.00,$3526.13,$7478.56
"Dcu Checking",,U,,03/16/2016,"Uconn","Education : College","Education","College","",$3046.92,$0.00,$4431.64
"Dcu Checking",,U,,03/19/2016,"Transfer : DCU Home Equity Credit line",,,,"",$1000.00,$0.00,$3431.64
"Dcu Checking",,U,,03/30/2016,"oracle","Income : Available next month","Income","Available next month","",$0.00,$3358.42,$6790.06
"Dcu Checking",,U,,04/05/2016,"Safety Insurance","Transportation : Car Insurance","Transportation","Car Insurance","(Split 1/2) ",$200.00,$0.00,$6407.47
"Dcu Checking",,U,,04/05/2016,"Safety Insurance","Housing : House/Rental Insurance","Hidden Categories","Housing ` House/Rental Insurance","(Split 2/2) ",$182.59,$0.00,$6407.47
"Dcu Checking",,U,,04/06/2016,"Transfer : Discover",,,,"",$3525.50,$0.00,$2881.97
"Dcu Checking",,U,,04/07/2016,"Transfer : Avidia Checking",,,,"",$2000.00,$0.00,$881.97
"Dcu Checking",,U,,04/14/2016,"oracle","Income : Available next month","Income","Available next month","",$0.00,$3514.06,$4396.03
"Dcu Checking",,U,,04/18/2016,"Transfer : DCU Home Equity Credit line",,,,"",$1000.00,$0.00,$3396.03
"Dcu Checking",,U,,04/20/2016,"Mom Inheritance","Income : Available next month","Income","Available next month","",$0.00,$38270.19,$41666.22
"Dcu Checking",,U,,04/20/2016,"Karina Loan","Income : Available next month","Income","Available next month","",$5300.00,$0.00,$36366.22
"Dcu Checking",,U,,04/20/2016,"Transfer : DCU Home Equity Credit line",,,,"",$24970.19,$0.00,$11396.03
"Dcu Checking",,U,,04/26/2016,"Mass college of Art","Education : College","Education","College","",$1270.00,$0.00,$10126.03
"Dcu Checking",,U,,04/28/2016,"oracle","Income : Available next month","Income","Available next month","",$0.00,$3358.43,$13484.46
"Dcu Checking",,U,,05/06/2016,"Transfer : Discover",,,,"",$5112.57,$0.00,$8371.89
"Dcu Checking",,U,,05/09/2016,"Safety Insurance","Housing : House/Rental Insurance","Hidden Categories","Housing ` House/Rental Insurance","(Split 1/2) ",$100.00,$0.00,$8104.20
"Dcu Checking",,U,,05/09/2016,"Safety Insurance","Transportation : Car Insurance","Transportation","Car Insurance","(Split 2/2) ",$167.69,$0.00,$8104.20
"Dcu Checking",,U,,05/12/2016,"oracle","Income : Available next month","Income","Available next month","",$0.00,$3514.05,$11618.25
"Dcu Checking",,U,,05/27/2016,"oracle","Income : Available next month","Income","Available next month","",$0.00,$3358.44,$14976.69
"Dcu Checking",,U,,05/27/2016,"Transfer : DCU Home Equity Credit line",,,,"",$3000.00,$0.00,$11976.69
"Dcu Checking",,U,,06/07/2016,"Transfer : Discover",,,,"",$5507.56,$0.00,$6469.13
"Dcu Checking",,U,,06/14/2016,"oracle","Income : Available next month","Income","Available next month","",$0.00,$3514.05,$9983.18
"Dcu Checking",,U,101,06/21/2016,"United States treasury","Income Tax : Estimated","Hidden Categories","Income Tax ` Estimated","",$3000.00,$0.00,$6983.18
"Dcu Checking",,U,,06/23/2016,"Common Wealth Ma","income tax : state","income tax","state","",$500.00,$0.00,$6483.18
"Dcu Checking",,U,,06/25/2016,"Mass college of Art","Education : College","Education","College","",$0.00,$1270.00,$7753.18
"Dcu Checking",,U,,06/28/2016,"Transfer : DCU Home Equity Credit line",,,,"",$1000.00,$0.00,$6753.18
"Dcu Checking",,U,,06/29/2016,"oracle","Income : Available next month","Income","Available next month","",$0.00,$3358.43,$10111.61
"Dcu Checking",,U,,07/01/2016,"Safety Insurance","Transportation : Car Insurance","Transportation","Car Insurance","(Split 1/2) ",$49.50,$0.00,$9992.11
"Dcu Checking",,U,,07/01/2016,"Safety Insurance","Housing : House/Rental Insurance","Hidden Categories","Housing ` House/Rental Insurance","(Split 2/2) ",$70.00,$0.00,$9992.11
"Dcu Checking",,U,,07/07/2016,"Transfer : Discover",,,,"",$2423.72,$0.00,$7568.39
"Dcu Checking",,U,,07/14/2016,"oracle","Income : Available next month","Income","Available next month","",$0.00,$3514.06,$11082.45
"Dcu Checking",,U,,07/18/2016,"Uconn","Education : College","Education","College","",$3579.50,$0.00,$7502.95
"Dcu Checking",,U,,07/28/2016,"oracle","Income : Available next month","Income","Available next month","",$0.00,$3358.42,$10861.37
"Dcu Checking",,U,,07/29/2016,"Transfer : DCU Home Equity Credit line",,,,"",$1500.00,$0.00,$9361.37
"Dcu Checking",,U,,07/31/2016,"Transfer : DCU Home Equity Credit line",,,,"",$1000.00,$0.00,$8361.37
"Dcu Checking",,U,,08/03/2016,"Safety Insurance","Housing : House/Rental Insurance","Hidden Categories","Housing ` House/Rental Insurance","(Split 1/2) ",$135.00,$0.00,$7926.37
"Dcu Checking",,U,,08/03/2016,"Safety Insurance","Transportation : Car Insurance","Transportation","Car Insurance","(Split 2/2) ",$300.00,$0.00,$7926.37
"Dcu Checking",,U,,08/08/2016,"Transfer : Discover",,,,"",$1464.66,$0.00,$6461.71
"Dcu Checking",,U,,08/12/2016,"oracle","Income : Available next month","Income","Available next month","",$0.00,$3514.06,$9975.77
"Dcu Checking",,U,,08/16/2016,"Uconn","Education : College","Education","College","",$3579.50,$0.00,$6396.27
"Dcu Checking",,U,,08/17/2016,"Transfer : DCU Home Equity Credit line",,,,"",$0.00,$700.00,$7096.27
"Dcu Checking",,U,,08/17/2016,"Transfer : DCU Home Equity Credit line",,,,"",$2000.00,$0.00,$5096.27
"Dcu Checking",,U,,08/18/2016,"Transfer : avidia - Lisa Business",,,,"",$0.00,$5000.00,$10096.27
"Dcu Checking",,U,,08/18/2016,"Deposit","Income : Available this month","Income","Available this month","",$0.00,$391.00,$10487.27
"Dcu Checking",,U,104,08/23/2016,"Handelman Construction","Housing : Maintenance & Repairs","Hidden Categories","Housing ` Maintenance & Repairs","",$3900.00,$0.00,$6587.27
"Dcu Checking",,U,107,08/29/2016,"Laurie Chase","Personal : Miscellaneous","Personal","Miscellaneous","Hair cuts",$85.00,$0.00,$6502.27
"Dcu Checking",,U,,08/30/2016,"oracle","Income : Available next month","Income","Available next month","",$0.00,$3358.43,$9860.70
"Dcu Checking",,U,,08/31/2016,"Transfer : DCU Home Equity Credit line",,,,"",$0.00,$4000.00,$13860.70
"Dcu Checking",,U,,08/31/2016,"Transfer : DCU Savings",,,,"",$0.00,$4000.00,$17860.70
"Dcu Checking",,U,105,09/01/2016,"Handelman Construction","Housing : Maintenance & Repairs","Hidden Categories","Housing ` Maintenance & Repairs","",$4661.00,$0.00,$13199.70
"Dcu Checking",,U,108,09/02/2016,"Alans Glassworks","Housing : Maintenance & Repairs","Hidden Categories","Housing ` Maintenance & Repairs","",$250.00,$0.00,$12949.70
"Dcu Checking",,U,,09/06/2016,"Safety Insurance","Transportation : Car Insurance","Transportation","Car Insurance","(Split 1/2) ",$100.00,$0.00,$12514.70
"Dcu Checking",,U,,09/06/2016,"Safety Insurance","Housing : House/Rental Insurance","Hidden Categories","Housing ` House/Rental Insurance","(Split 2/2) ",$335.00,$0.00,$12514.70
"Dcu Checking",,U,109,09/07/2016,"Rebecca Sefloff","Recreation : Alyssa Horse","Recreation","Alyssa Horse","",$65.00,$0.00,$12449.70
"Dcu Checking",,U,,09/07/2016,"Transfer : Discover",,,,"",$2371.97,$0.00,$10077.73
"Dcu Checking",,U,110,09/08/2016,"Uconn","Recreation : Alyssa Horse","Recreation","Alyssa Horse","",$435.00,$0.00,$9642.73
"Dcu Checking",,U,,09/10/2016,"Transfer : DCU Home Equity Credit line",,,,"",$0.00,$5000.00,$14642.73
"Dcu Checking",,U,,09/13/2016,"irs","Income Tax : Estimated","Hidden Categories","Income Tax ` Estimated","",$3000.00,$0.00,$11642.73
"Dcu Checking",,U,,09/14/2016,"oracle","Income : Available next month","Income","Available next month","",$0.00,$3514.06,$15156.79
"Dcu Checking",,U,,09/14/2016,"Common Wealth Ma","Income Tax : Estimated","Hidden Categories","Income Tax ` Estimated","",$500.00,$0.00,$14656.79
"Dcu Checking",,U,130,09/15/2016,"Alans Glassworks","Housing : Maintenance & Repairs","Hidden Categories","Housing ` Maintenance & Repairs","",$226.25,$0.00,$14430.54
"Dcu Checking",,U,,09/16/2016,"Uconn","Education : College","Education","College","",$5249.50,$0.00,$9181.04
"Dcu Checking",,U,,09/22/2016,"Transfer : DCU Home Equity Credit line",,,,"",$1000.00,$0.00,$8181.04
"Dcu Checking",,U,126,09/27/2016,"oracle","Transportation : Parking","Transportation","Parking","",$40.00,$0.00,$8141.04
"Dcu Checking",,U,127,09/27/2016,"Brads RV","RV : Maintenance","RV","Maintenance","",$2000.00,$0.00,$6141.04
"Dcu Checking",,U,,09/28/2016,"Common Wealth Ma","Income Tax : Estimated","Hidden Categories","Income Tax ` Estimated","Not sure but I think this was for mom's taxes",$22.82,$0.00,$6118.22
"Dcu Checking",,U,,09/29/2016,"oracle","Income : Available next month","Income","Available next month","",$0.00,$3358.42,$9476.64
"Dcu Checking",,U,128,09/30/2016,"Marlborough police","Charity : Other","Charity","Other","",$35.00,$0.00,$9441.64
"Dcu Checking",,U,129,09/30/2016,"Mary Mattei","Recreation : Entertainment","Recreation","Entertainment","Play Tickets",$135.00,$0.00,$9306.64
"Dcu Checking",,U,125,10/03/2016,"","Housing : Maintenance & Repairs","Hidden Categories","Housing ` Maintenance & Repairs","",$2119.53,$0.00,$7187.11
"Dcu Checking",,U,,10/04/2016,"Safety Insurance","Housing : House/Rental Insurance","Hidden Categories","Housing ` House/Rental Insurance","(Split 1/2) ",$100.00,$0.00,$6752.11
"Dcu Checking",,U,,10/04/2016,"Safety Insurance","Transportation : Car Insurance","Transportation","Car Insurance","(Split 2/2) ",$335.00,$0.00,$6752.11
"Dcu Checking",,U,131,10/05/2016,"Greg Martel","Housing : Maintenance & Repairs","Hidden Categories","Housing ` Maintenance & Repairs","Greg gift - for years and years of snowblowing etc. - still owe him",$450.00,$0.00,$6302.11
"Dcu Checking",,U,,10/06/2016,"Transfer : avidia - Lisa Business",,,,"",$0.00,$3000.00,$9302.11
"Dcu Checking",,U,,10/07/2016,"Transfer : Discover",,,,"",$2004.97,$0.00,$7297.14
"Dcu Checking",,U,,10/13/2016,"oracle","Income : Available next month","Income","Available next month","",$0.00,$3514.06,$10811.20
"Dcu Checking",,U,,10/17/2016,"Uconn","Education : College","Education","College","",$5249.50,$0.00,$5561.70
"Dcu Checking",,U,,10/22/2016,"Transfer : DCU Home Equity Credit line",,,,"",$1100.00,$0.00,$4461.70
"Dcu Checking",,U,,10/24/2016,"income","Income : Available next month","Income","Available next month","",$0.00,$5000.00,$9461.70
"Dcu Checking",,U,,10/27/2016,"income","Income : Available next month","Income","Available next month","",$0.00,$240.00,$9701.70
"Dcu Checking",,U,,10/28/2016,"oracle","Income : Available next month","Income","Available next month","",$0.00,$3514.05,$13215.75
"Dcu Checking",,U,,10/31/2016,"Safety Insurance","Transportation : Car Insurance","Transportation","Car Insurance","(Split 1/2) ",$335.00,$0.00,$12780.75
"Dcu Checking",,U,,10/31/2016,"Safety Insurance","Housing : House/Rental Insurance","Hidden Categories","Housing ` House/Rental Insurance","(Split 2/2) ",$100.00,$0.00,$12780.75
"Dcu Checking",,U,,11/01/2016,"NGRID","Housing : Electricity","Hidden Categories","Housing ` Electricity","",$89.15,$0.00,$12691.60
"Dcu Checking",,U,,11/01/2016,"Safety Insurance","Transportation : Car Insurance","Transportation","Car Insurance","(Split 1/2) ",$335.00,$0.00,$12256.60
"Dcu Checking",,U,,11/01/2016,"Safety Insurance","Housing : House/Rental Insurance","Hidden Categories","Housing ` House/Rental Insurance","(Split 2/2) ",$100.00,$0.00,$12256.60
"Dcu Checking",,U,,11/01/2016,"city of marlboro","Housing : Real Estate Tax","Hidden Categories","Housing ` Real Estate Tax","",$2640.95,$0.00,$9615.65
"Dcu Checking",,U,,11/02/2016,"verizon wireless","Housing : Cell Phones","Hidden Categories","Housing ` Cell Phones",,$182.10,$0.00,$9433.55
"Dcu Checking",,U,,11/07/2016,"Transfer : Discover",,,,"",$2622.53,$0.00,$6811.02
"Dcu Checking",,U,133,11/09/2016,"Russell Swinton","Personal : Gifts","Personal","Gifts","",$100.00,$0.00,$6711.02
"Dcu Checking",,U,,11/14/2016,"oracle","Income : Available next month","Income","Available next month","",$0.00,$3871.35,$10582.37
"Dcu Checking",,U,,11/15/2016,"Common Wealth Ma","Transportation : Auto Excise","Transportation","Auto Excise","",$45.00,$0.00,$10537.37
"Dcu Checking",,U,134,11/15/2016,"Mitch Gorka","Housing : Maintenance & Repairs","Hidden Categories","Housing ` Maintenance & Repairs","",$156.69,$0.00,$10380.68
"Dcu Checking",,U,,11/15/2016,"Transfer : DCU Home Equity Credit line",,,,"",$5000.00,$0.00,$5380.68
"Dcu Checking",,U,,11/16/2016,"Transfer : Lisa Cash Account",,,,"",$0.00,$6200.00,$11580.68
"Dcu Checking",,U,,11/16/2016,"Transfer : DCU Home Equity Credit line",,,,"",$4000.00,$0.00,$7580.68
"Dcu Checking",,U,135,11/25/2016,"Mass dot","Transportation : Registration","Transportation","Registration","PERMIT TEST",$30.00,$0.00,$7550.68
"Dcu Checking",,U,132,11/25/2016,"Joshua Mattei-Lownes","Personal : Gifts","Personal","Gifts","",$50.00,$0.00,$7500.68
"Dcu Checking",,U,,11/29/2016,"oracle","Income : Available next month","Income","Available next month","",$0.00,$3871.34,$11372.02
"Dcu Checking",,U,,11/29/2016,"city of marlboro","Housing : Water","Hidden Categories","Housing ` Water","",$285.88,$0.00,$11086.14
"Dcu Checking",,U,,12/01/2016,"Save the children","Charity : Other","Charity","Other","",$28.00,$0.00,$11058.14
"Dcu Checking",,U,,12/02/2016,"verizon wireless","Housing : Cell Phones","Hidden Categories","Housing ` Cell Phones","",$182.10,$0.00,$10876.04
"Dcu Checking",,U,,12/05/2016,"Safety Insurance","Transportation : Car Insurance","Transportation","Car Insurance","(Split 1/2) ",$380.00,$0.00,$10376.04
"Dcu Checking",,U,,12/05/2016,"Safety Insurance","Housing : House/Rental Insurance","Hidden Categories","Housing ` House/Rental Insurance","(Split 2/2) ",$120.00,$0.00,$10376.04
"Dcu Checking",,U,,12/06/2016,"Transfer : DCU Home Equity Credit line",,,,"",$6000.00,$0.00,$4376.04
"Dcu Checking",,U,,12/07/2016,"bank  fee","Personal : BankFee","Personal","BankFee","Insufficeint funds",$30.00,$0.00,$4346.04
"Dcu Checking",,U,,12/07/2016,"Transfer : Discover",,,,"",$4866.69,$0.00,-$520.65
"Dcu Checking",,U,,12/09/2016,"income","Income : Available next month","Income","Available next month","(Split 1/2) House Sale",$0.00,$354768.22,$356247.57
"Dcu Checking",,U,,12/09/2016,"income / Transfer : Lisa Cash Account",,,,"(Split 2/2) House Sale",$0.00,$2000.00,$356247.57
"Dcu Checking",,U,,12/14/2016,"oracle","Income : Available next month","Income","Available next month","",$0.00,$3871.35,$360118.92
"Dcu Checking",,U,,12/14/2016,"Time Factory Watch Wrentham","Personal : Gifts","Personal","Gifts","Luke watch christmas",$26.55,$0.00,$360092.37
"Dcu Checking",,U,,12/16/2016,"Transfer : Lisa Cash Account",,,,"",$200.00,$0.00,$359892.37
"Dcu Checking",,U,,12/23/2016,"Pizza by evan","Food : Restaurants","Food","Restaurants","",$73.13,$0.00,$359819.24
"Dcu Checking",,U,,12/23/2016,"Transfer : Lisa Cash Account",,,,"",$200.00,$0.00,$359619.24
"Dcu Checking",,U,,12/24/2016,"Transfer : DCU LTD account",,,,"",$30000.00,$0.00,$329619.24
"Dcu Checking",,U,,12/24/2016,"Transfer : DCU LTD account",,,,"",$270000.00,$0.00,$59619.24
"Dcu Checking",,U,,12/27/2016,"paypal","Income : Available next month","Income","Available next month","",$0.00,$0.12,$59619.36
"Dcu Checking",,U,,12/27/2016,"paypal","Income : Available next month","Income","Available next month","",$0.00,$0.06,$59619.42
"Dcu Checking",,U,,12/27/2016,"paypal","Lisa Business : Misc","Lisa Business","Misc","",$0.18,$0.00,$59619.24
"Dcu Checking",,U,,12/28/2016,"Rv Consumers Group","RV : Equipment/Supplies","RV","Equipment/Supplies","Using paypal RV database used in making buying decision",$99.00,$0.00,$59520.24
"Dcu Checking",,U,,12/28/2016,"Safety Insurance","Transportation : Car Insurance","Transportation","Car Insurance","(Split 1/2) ",$300.00,$0.00,$59115.74
"Dcu Checking",,U,,12/28/2016,"Safety Insurance","Housing : House/Rental Insurance","Hidden Categories","Housing ` House/Rental Insurance","(Split 2/2) ",$104.50,$0.00,$59115.74
"Dcu Checking",,U,,12/29/2016,"oracle","Income : Available next month","Income","Available next month","",$0.00,$3871.35,$62987.09
"Dcu Checking",,U,,12/29/2016,"Nancy's Candy","Personal : Gifts","Personal","Gifts","",$54.79,$0.00,$62932.30
"Dcu Checking",,U,,12/29/2016,"NSA RV Products","RV : Equipment/Supplies","RV","Equipment/Supplies","Drop Hitch paid using paypal",$82.95,$0.00,$62849.35
"Dcu Checking",,U,111,12/30/2016,"Isabel Nanez","Personal : Gifts","Personal","Gifts","",$50.00,$0.00,$62799.35
"Dcu Checking",,U,,12/31/2016,"Transfer : Lisa Cash Account",,,,"",$200.00,$0.00,$62599.35
"Dcu Checking",,U,,01/03/2017,"Save the children","Charity : Other","Charity","Other","",$28.00,$0.00,$62571.35
"Dcu Checking",,U,116,01/03/2017,"Gloria and Greg Martel","Personal : Gifts","Personal","Gifts","Dumpster run",$300.00,$0.00,$62271.35
"Dcu Checking",,U,,01/03/2017,"Uconn","Education : College","Education","College","",$14268.00,$0.00,$48003.35
"Dcu Checking",,U,,01/04/2017,"NGRID","Housing : Electricity","Hidden Categories","Housing ` Electricity","",$162.32,$0.00,$47841.03
"Dcu Checking",,U,,01/04/2017,"verizon wireless","Housing : Cell Phones","Hidden Categories","Housing ` Cell Phones","",$182.10,$0.00,$47658.93
"Dcu Checking",,U,115,01/04/2017,"Accu septic","Personal : Gifts","Personal","Gifts","Paid for septic tank work at cape (Partial Rent)",$445.00,$0.00,$47213.93
"Dcu Checking",,U,,01/05/2017,"Laura  Mattei F","Recreation : Entertainment","Recreation","Entertainment","Christmas in Albany",$150.00,$0.00,$47063.93
"Dcu Checking",,U,,01/09/2017,"e-ZPass","RV : Tolls","RV","Tolls","",$45.00,$0.00,$47018.93
"Dcu Checking",,U,,01/09/2017,"Transfer : Discover",,,,"",$3610.56,$0.00,$43408.37
"Dcu Checking",,U,,01/11/2017,"Eversource","Housing : Gas","Hidden Categories","Housing ` Gas","",$234.14,$0.00,$43174.23
"Dcu Checking",,U,,01/12/2017,"oracle","Income : Available next month","Income","Available next month","",$0.00,$3538.07,$46712.30
"Dcu Checking",,U,,01/12/2017,"Transfer : Target",,,,"",$488.13,$0.00,$46224.17
"Dcu Checking",,U,,01/17/2017,"Transfer : Lisa Cash Account",,,,"",$200.00,$0.00,$46024.17
"Dcu Checking",,U,,01/23/2017,"Delancy Station Riverview FL","RV : Campgrounds","RV","Campgrounds","",$0.00,$354.43,$46378.60
"Dcu Checking",,U,,01/30/2017,"Transfer : DCU LTD account",,,,"",$0.00,$85000.00,$131378.60
"Dcu Checking",,U,,01/30/2017,"oracle","Income : Available next month","Income","Available next month","",$0.00,$3538.06,$134916.66
"Dcu Checking",,U,117,01/31/2017,"FORT MYERS RV","RV : PURCHASE","RV","PURCHASE",,$3000.00,$0.00,$131916.66
"Dcu Checking",,U,,02/01/2017,"Save the children","Charity : Other","Charity","Other","",$28.00,$0.00,$131888.66
"Dcu Checking",,U,,02/01/2017,"verizon wireless","Housing : Cell Phones","Hidden Categories","Housing ` Cell Phones","",$244.34,$0.00,$131644.32
"Dcu Checking",,U,,02/03/2017,"bank fee","Personal : BankFee","Personal","BankFee","",$15.00,$0.00,$131629.32
"Dcu Checking",,U,,02/03/2017,"FORT MYERS RV","RV : PURCHASE","RV","PURCHASE","",$109805.61,$0.00,$21823.71
"Dcu Checking",,U,,02/06/2017,"Transfer : Lisa Cash Account",,,,"",$80.00,$0.00,$21743.71
"Dcu Checking",,U,,02/07/2017,"Transfer : Discover",,,,"",$5742.21,$0.00,$16001.50
"Dcu Checking",,U,,02/09/2017,"e-ZPass","RV : Tolls","RV","Tolls","",$10.00,$0.00,$15991.50
"Dcu Checking",,U,118,02/09/2017,"Mass dot","RV : PURCHASE","RV","PURCHASE","",$364.54,$0.00,$15626.96
"Dcu Checking",,U,,02/10/2017,"Transfer : Target",,,,"",$9.35,$0.00,$15617.61
"Dcu Checking",,U,,02/14/2017,"oracle","Income : Available next month","Income","Available next month","",$0.00,$3538.07,$19155.68
"Dcu Checking",,U,,02/15/2017,"Fort myers beach","Transportation : Parking","Transportation","Parking","",$4.00,$0.00,$19151.68
"Dcu Checking",,U,,02/18/2017,"Captiva Beach","Transportation : Parking","Transportation","Parking","",$6.00,$0.00,$19145.68
"Dcu Checking",,U,,02/18/2017,"Pastaris Fort Myers","Food : Restaurants","Food","Restaurants","Good Pizza in Fort Myers",$39.00,$0.00,$19106.68
"Dcu Checking",,U,,02/18/2017,"Transfer : Lisa Cash Account",,,,"",$100.00,$0.00,$19006.68
"Dcu Checking",,U,,02/23/2017,"Mtn Country Park","Recreation : Entertainment","Recreation","Entertainment","Some Park don't remember",$21.09,$0.00,$18985.59
"Dcu Checking",,U,119,02/24/2017,"Nancy & Dennis","Housing : Storage","Hidden Categories","Housing ` Storage","",$200.00,$0.00,$18785.59
"Dcu Checking",,U,,02/27/2017,"income","Income : Available next month","Income","Available next month","Check for totaled car",$0.00,$3601.25,$22386.84
"Dcu Checking",,U,,02/27/2017,"oracle","Income : Available next month","Income","Available next month","",$0.00,$3538.06,$25924.90
"Dcu Checking",,U,,03/01/2017,"Save the children","Charity : Other","Charity","Other","",$28.00,$0.00,$25896.90
"Dcu Checking",,U,106,03/01/2017,"Land Yacht Harbor","RV : Campgrounds","RV","Campgrounds","",$87.00,$0.00,$25809.90
"Dcu Checking",,U,,03/03/2017,"verizon wireless","Housing : Cell Phones","Hidden Categories","Housing ` Cell Phones","",$261.82,$0.00,$25548.08
"Dcu Checking",,U,,03/04/2017,"Transfer : Lisa Cash Account",,,,"",$100.00,$0.00,$25448.08
"Dcu Checking",,U,,03/07/2017,"Transfer : Discover",,,,"",$5251.31,$0.00,$20196.77
"Dcu Checking",,U,,03/10/2017,"Transfer : Target",,,,"",$389.80,$0.00,$19806.97
"Dcu Checking",,U,,03/14/2017,"oracle","Income : Available next month","Income","Available next month","",$0.00,$1749.13,$21556.10
"Dcu Checking",,U,,03/14/2017,"Transfer : Lisa Cash Account",,,,"",$100.00,$0.00,$21456.10
"Dcu Checking",,U,,03/16/2017,"Port of Call New Orleans","Food : Restaurants","Food","Restaurants","Burgers and beer",$47.96,$0.00,$21408.14
"Dcu Checking",,U,122,03/16/2017,"Paynes RV Park","RV : Campgrounds","RV","Campgrounds","Paynes RV Bellingraph Alabama  - nice people - big sites - lots of pretty old RVs and nothing to do at Park - but beautiful garden near by",$81.75,$0.00,$21326.39
"Dcu Checking",,U,,03/22/2017,"Transfer : Lisa Cash Account",,,,"",$100.00,$0.00,$21226.39
"Dcu Checking",,U,,03/24/2017,"Safety Insurance","Transportation : Car Insurance","Transportation","Car Insurance","",$133.00,$0.00,$21093.39
"Dcu Checking",,U,,03/30/2017,"oracle","Income : Available next month","Income","Available next month","",$0.00,$1740.30,$22833.69
"Dcu Checking",,U,,03/30/2017,"Nickerson","RV : Campgrounds","RV","Campgrounds","Connecticut",$240.00,$0.00,$22593.69
"Dcu Checking",,U,,04/03/2017,"Save the children","Charity : Other","Charity","Other","",$28.00,$0.00,$22565.69
"Dcu Checking",,U,123,04/03/2017,"Nickerson","RV : Campgrounds","RV","Campgrounds","",$80.00,$0.00,$22485.69
"Dcu Checking",,U,,04/03/2017,"Transfer : Lisa Cash Account",,,,"",$100.00,$0.00,$22385.69
"Dcu Checking",,U,,04/03/2017,"verizon wireless","Housing : Cell Phones","Hidden Categories","Housing ` Cell Phones","",$237.52,$0.00,$22148.17
"Dcu Checking",,U,,04/04/2017,"Transfer : DCU LTD account",,,,"To make payment to retirement",$0.00,$15000.00,$37148.17
"Dcu Checking",,U,124,04/04/2017,"Nickerson","RV : Campgrounds","RV","Campgrounds","",$40.00,$0.00,$37108.17
"Dcu Checking",,U,,04/06/2017,"Transfer : Discover",,,,"",$3193.06,$0.00,$33915.11
"Dcu Checking",,U,,04/10/2017,"Transfer : Target",,,,"",$172.56,$0.00,$33742.55
"Dcu Checking",,U,137,04/10/2017,"Transfer : Etrade-Retirement","Savings : Retirement","Savings","Retirement","",$6500.00,$0.00,$27242.55
"Dcu Checking",,U,138,04/10/2017,"Transfer : Etrade-Retirement","Savings : Retirement","Savings","Retirement","",$6500.00,$0.00,$20742.55
"Dcu Checking",,U,,04/11/2017,"Ma excise","Transportation : Auto Excise","Transportation","Auto Excise","",$375.00,$0.00,$20367.55
"Dcu Checking",,U,,04/12/2017,"Deposit","Education : College","Education","College","(Split 1/2) School Check return",$0.00,$4000.00,$24914.65
"Dcu Checking",,U,,04/12/2017,"Deposit","Income : Available next month","Income","Available next month","(Split 2/2) School Check return",$0.00,$547.10,$24914.65
"Dcu Checking",,U,,04/13/2017,"oracle","Income : Available next month","Income","Available next month","",$0.00,$1738.63,$26653.28
"Dcu Checking",,U,136,04/13/2017,"Anna Mattei","Personal : Gifts","Personal","Gifts","",$70.00,$0.00,$26583.28
"Dcu Checking",,U,,04/15/2017,"Uconn","Education : College","Education","College","",$15.80,$0.00,$26567.48
"Dcu Checking",,U,,04/17/2017,"Deposit","Income : Available next month","Income","Available next month","Income tax refund",$0.00,$2000.00,$28567.48
"Dcu Checking",,U,,04/17/2017,"Virgin Atlantic","Recreation : Vacation","Recreation","Vacation","",$782.66,$0.00,$27784.82
"Dcu Checking",,U,,04/24/2017,"Transfer : Lisa Cash Account",,,,"",$200.00,$0.00,$27584.82
"Dcu Checking",,U,139,04/24/2017,"Town of Dennis","Transportation : Auto Excise","Transportation","Auto Excise","",$260.30,$0.00,$27324.52
"Dcu Checking",,U,,04/26/2017,"","Personal : Miscellaneous","Personal","Miscellaneous","",$30.00,$0.00,$27294.52
"Dcu Checking",,U,,04/29/2017,"Flower Power","Personal : Gifts","Personal","Gifts","",$52.00,$0.00,$27242.52
"Dcu Checking",,U,,05/01/2017,"Save the children","Charity : Other","Charity","Other","",$28.00,$0.00,$27214.52
"Dcu Checking",,U,,05/02/2017,"oracle","Income : Available next month","Income","Available next month","Last check",$0.00,$2810.07,$30024.59
"Dcu Checking",,U,,05/03/2017,"verizon wireless","Housing : Cell Phones","Hidden Categories","Housing ` Cell Phones","",$237.64,$0.00,$29786.95
"Dcu Checking",,U,,05/05/2017,"Transfer : DCU LTD account",,,,"",$0.00,$30000.00,$59786.95
"Dcu Checking",,U,,05/08/2017,"e-ZPass","RV : Tolls","RV","Tolls","",$10.00,$0.00,$59776.95
"Dcu Checking",,U,,05/08/2017,"Transfer : Discover",,,,"",$4473.60,$0.00,$55303.35
"Dcu Checking",,U,,05/10/2017,"Transfer : Target",,,,"",$221.00,$0.00,$55082.35
"Dcu Checking",,U,,05/15/2017,"Deposit","Income : Available next month","Income","Available next month","MOM INHERITANCE",$0.00,$16105.00,$71187.35
"Dcu Checking",,U,,05/15/2017,"e-ZPass","RV : Tolls","RV","Tolls","",$10.00,$0.00,$71177.35
"Dcu Checking",,U,,05/18/2017,"oracle","Income : Available next month","Income","Available next month","Inheritance",$0.00,$4190.04,$75367.39
"Dcu Checking",,U,,05/24/2017,"Transfer : Lisa Cash Account",,,,"",$60.00,$0.00,$75307.39
"Dcu Checking",,U,,05/24/2017,"Student Loan","Education : College","Education","College","",$19006.28,$0.00,$56301.11
"Dcu Checking",,U,,05/25/2017,"e-ZPass","RV : Tolls","RV","Tolls","",$10.00,$0.00,$56291.11
"Dcu Checking",,U,,05/26/2017,"oracle","Income : Available next month","Income","Available next month","",$0.00,$1.66,$56292.77
"Dcu Checking",,U,,05/30/2017,"Transfer : Lisa Cash Account",,,,"",$100.00,$0.00,$56192.77
"Dcu Checking",,U,,06/01/2017,"Save the children","Charity : Other","Charity","Other",,$28.00,$0.00,$56164.77
"Dcu Checking",,U,,06/01/2017,"verizon wireless","Housing : Cell Phones","Hidden Categories","Housing ` Cell Phones",,$237.64,$0.00,$55927.13
"Dcu Checking",,U,,06/05/2017,"Transfer : Lisa Cash Account",,,,"",$60.00,$0.00,$55867.13
"Dcu Checking",,U,,06/07/2017,"Transfer : Discover",,,,"",$5847.91,$0.00,$50019.22
"Dcu Checking",,U,141,06/08/2017,"Mom gift","Personal : Gifts","Personal","Gifts","",$200.00,$0.00,$49819.22
"Dcu Checking",,U,,06/12/2017,"Transfer : Target",,,,"",$35.95,$0.00,$49783.27
"Dcu Checking",,U,140,06/12/2017,"Cliff Lander","Personal : Gifts","Personal","Gifts","",$50.00,$0.00,$49733.27
"Dcu Checking",,U,,06/12/2017,"Transfer : Lisa Cash Account",,,,"",$60.00,$0.00,$49673.27
"Dcu Checking",,U,,06/14/2017,"Ma Health Connector","Personal : Health Insurance","Personal","Health Insurance","",$592.67,$0.00,$49080.60
"Dcu Checking",,U,,06/19/2017,"KOA Canandaigura","RV : Campgrounds","RV","Campgrounds","",$49.00,$0.00,$49031.60
"Dcu Checking",,U,,06/21/2017,"unemployment","Income : Available next month","Income","Available next month","",$0.00,$631.00,$49662.60
"Dcu Checking",,U,,06/23/2017,"e-ZPass","RV : Tolls","RV","Tolls","",$10.00,$0.00,$49652.60
"Dcu Checking",,U,,06/23/2017,"Town of Dennis","RV : excise tax","RV","excise tax","",$1455.21,$0.00,$48197.39
"Dcu Checking",,U,,06/26/2017,"e-ZPass","RV : Tolls","RV","Tolls","",$10.00,$0.00,$48187.39
"Dcu Checking",,U,,06/26/2017,"e-ZPass","RV : Tolls","RV","Tolls","",$45.00,$0.00,$48142.39
"Dcu Checking",,U,,06/26/2017,"alyssa loan","Loans : LoanAlyssa","Loans","LoanAlyssa","",$1200.00,$0.00,$46942.39
"Dcu Checking",,U,,06/27/2017,"unemployment","Income : Available next month","Income","Available next month","",$0.00,$631.00,$47573.39
"Dcu Checking",,U,,07/03/2017,"e-ZPass","RV : Tolls","RV","Tolls","",$10.00,$0.00,$47563.39
"Dcu Checking",,U,,07/03/2017,"e-ZPass","RV : Tolls","RV","Tolls","",$10.00,$0.00,$47553.39
"Dcu Checking",,U,,07/03/2017,"Save the children","Charity : Other","Charity","Other",,$28.00,$0.00,$47525.39
"Dcu Checking",,U,,07/05/2017,"verizon wireless","Housing : Cell Phones","Hidden Categories","Housing ` Cell Phones","",$237.64,$0.00,$47287.75
"Dcu Checking",,U,,07/06/2017,"unemployment","Income : Available next month","Income","Available next month","",$0.00,$631.00,$47918.75
"Dcu Checking",,U,,07/06/2017,"Transfer : Discover",,,,"",$5562.94,$0.00,$42355.81
"Dcu Checking",,U,,07/09/2017,"Transfer : DCU LTD account",,,,"",$22000.00,$0.00,$20355.81
"Dcu Checking",,U,,07/10/2017,"e-ZPass","RV : Tolls","RV","Tolls","Need to check this I think we go overcharged",$45.00,$0.00,$20310.81
"Dcu Checking",,U,,07/10/2017,"Transfer : Target",,,,"",$110.91,$0.00,$20199.90
"Dcu Checking",,U,142,07/11/2017,"Forest Preserve district of Kane County","RV : Campgrounds","RV","Campgrounds","Paul Wolff Campground in Elgin outside of chicago",$100.00,$0.00,$20099.90
"Dcu Checking",,U,,07/12/2017,"unemployment","Income : Available next month","Income","Available next month","",$0.00,$631.00,$20730.90
"Dcu Checking",,U,,07/12/2017,"Woodmans / Transfer : Lisa Cash Account",,,,"(Split 1/2) Nice Grocery Store in Wisconsin",$60.00,$0.00,$20603.96
"Dcu Checking",,U,,07/12/2017,"Woodmans","Food : Groceries","Food","Groceries","(Split 2/2) Nice Grocery Store in Wisconsin",$66.94,$0.00,$20603.96
"Dcu Checking",,U,,07/13/2017,"e-ZPass","RV : Tolls","RV","Tolls","",$10.00,$0.00,$20593.96
"Dcu Checking",,U,,07/14/2017,,"Transportation : Parking","Transportation","Parking","",$3.60,$0.00,$20590.36
"Dcu Checking",,U,,07/14/2017,"","Transportation : Parking","Transportation","Parking","",$3.90,$0.00,$20586.46
"Dcu Checking",,U,,07/14/2017,"University Square Debit","Transportation : Parking","Transportation","Parking","",$7.00,$0.00,$20579.46
"Dcu Checking",,U,,07/15/2017,"Deposit","Income : Available next month","Income","Available next month","",$0.00,$1498.47,$22077.93
"Dcu Checking",,U,,07/15/2017,"Transfer : Lisa Cash Account",,,,"",$100.00,$0.00,$21977.93
"Dcu Checking",,U,,07/17/2017,"boston city","Transportation : Parking","Transportation","Parking","",$1.79,$0.00,$21976.14
"Dcu Checking",,U,,07/17/2017,"Save the children","Charity : Other","Charity","Other","",$3.00,$0.00,$21973.14
"Dcu Checking",,U,,07/17/2017,"dane county","Transportation : Parking","Transportation","Parking","",$3.60,$0.00,$21969.54
"Dcu Checking",,U,,07/17/2017,"boston city","Transportation : Parking","Transportation","Parking","ticket",$65.00,$0.00,$21904.54
"Dcu Checking",,U,,07/19/2017,"Safety Insurance","Transportation : Car Insurance","Transportation","Car Insurance","",$235.50,$0.00,$21669.04
"Dcu Checking",,U,,07/20/2017,"Manana","Food : Restaurants","Food","Restaurants","Minniopolis - pupusa",$41.01,$0.00,$21628.03
"Dcu Checking",,U,,07/21/2017,"Meter","Transportation : Parking","Transportation","Parking","Near Sculpture park",$4.00,$0.00,$21624.03
"Dcu Checking",,U,,07/24/2017,"Transfer : Lisa Cash Account",,,,"",$80.00,$0.00,$21544.03
"Dcu Checking",,U,,07/26/2017,"Ma Health Connector","Personal : Health Insurance","Personal","Health Insurance","",$346.67,$0.00,$21197.36
"Dcu Checking",,U,,07/27/2017,"Enchanted forest Gift","Personal : Miscellaneous","Personal","Miscellaneous","",$20.00,$0.00,$21177.36
"Dcu Checking",,U,145,07/31/2017,"dane county parks","RV : Campgrounds","RV","Campgrounds","Campground in wisconsin near madison - with bike trails and bike aid stations",$27.00,$0.00,$21150.36
"Dcu Checking",,U,144,07/31/2017,"dane county parks","RV : Campgrounds","RV","Campgrounds","",$108.00,$0.00,$21042.36
"Dcu Checking",,U,,08/01/2017,"Save the children","Charity : Other","Charity","Other","",$31.00,$0.00,$21011.36
"Dcu Checking",,U,,08/01/2017,"verizon wireless","Housing : Cell Phones","Hidden Categories","Housing ` Cell Phones","",$237.70,$0.00,$20773.66
"Dcu Checking",,U,,08/06/2017,"Transfer : Discover",,,,"",$3436.36,$0.00,$17337.30
"Dcu Checking",,U,,08/07/2017,"Empire guest house","RV : Campgrounds","RV","Campgrounds","",$43.20,$0.00,$17294.10
"Dcu Checking",,U,146,08/09/2017,"ALexander Shooting park","RV : Campgrounds","RV","Campgrounds","Campground near ? with shooting park met guy with Huge bus RV",$44.00,$0.00,$17250.10
"Dcu Checking",,U,,08/10/2017,"bank  fee","Personal : BankFee","Personal","BankFee","",$2.50,$0.00,$17247.60
"Dcu Checking",,U,,08/10/2017,"Transfer : Lisa Cash Account",,,,"",$80.00,$0.00,$17167.60
"Dcu Checking",,U,,08/24/2017,"Ma Health Connector","Personal : Health Insurance","Personal","Health Insurance","",$592.67,$0.00,$16574.93
"Dcu Checking",,U,147,08/28/2017,"Isa Mattei","Personal : Gifts","Personal","Gifts","",$65.00,$0.00,$16509.93
"Dcu Checking",,U,,08/28/2017,"Glacier Family Foods","Food : Groceries","Food","Groceries","",$70.38,$0.00,$16439.55
"Dcu Checking",,U,,08/29/2017,"Two Sisters","Food : Restaurants","Food","Restaurants","",$56.80,$0.00,$16382.75
"Dcu Checking",,U,148,08/30/2017,"Juniper Campground","RV : Campgrounds","RV","Campgrounds","Idaho Falls MET Hector nice campgournd along river",$18.00,$0.00,$16364.75
"Dcu Checking",,U,149,08/30/2017,"Juniper Campground","RV : Campgrounds","RV","Campgrounds","",$18.00,$0.00,$16346.75
"Dcu Checking",,U,,09/01/2017,"Save the children","Charity : Other","Charity","Other","",$31.00,$0.00,$16315.75
"Dcu Checking",,U,,09/01/2017,"glaceir family foods","Food : Groceries","Food","Groceries","",$79.02,$0.00,$16236.73
"Dcu Checking",,U,,09/01/2017,"verizon wireless","Housing : Cell Phones","Hidden Categories","Housing ` Cell Phones",,$237.70,$0.00,$15999.03
"Dcu Checking",,U,,09/02/2017,"bank  fee","Personal : BankFee","Personal","BankFee","",$3.00,$0.00,$15996.03
"Dcu Checking",,U,,09/02/2017,"Transfer : Lisa Cash Account",,,,"",$100.00,$0.00,$15896.03
"Dcu Checking",,U,,09/05/2017,"Forest service payment","RV : Campgrounds","RV","Campgrounds","",$20.00,$0.00,$15876.03
"Dcu Checking",,U,,09/05/2017,"Hob non on hiiggins","Food : Restaurants","Food","Restaurants","Panckakes (and free french) toast for me  - good meal we all enjoyed in Missoula MT",$36.00,$0.00,$15840.03
"Dcu Checking",,U,,09/05/2017,"Jellystone Rv Park","RV : Campgrounds","RV","Campgrounds","",$52.95,$0.00,$15787.08
"Dcu Checking",,U,,09/05/2017,"Safety Insurance","Transportation : Car Insurance","Transportation","Car Insurance","",$241.50,$0.00,$15545.58
"Dcu Checking",,U,,09/06/2017,"Forest service payment","RV : Campgrounds","RV","Campgrounds","?? - what place",$20.00,$0.00,$15525.58
"Dcu Checking",,U,,09/06/2017,"Transfer : Discover",,,,"",$3162.70,$0.00,$12362.88
"Dcu Checking",,U,seattle parking,09/09/2017,"transportatin: parking","Transportation : Parking","Transportation","Parking","",$2.30,$0.00,$12360.58
"Dcu Checking",,U,,09/11/2017,"Carwash","Transportation : Repairs & Maintenance","Transportation","Repairs & Maintenance","Car wash",$6.00,$0.00,$12354.58
"Dcu Checking",,U,152,09/11/2017,"Wildrose RV","RV : Campgrounds","RV","Campgrounds","Near Spokan - Don - nice buy born and bread in Montana",$63.00,$0.00,$12291.58
"Dcu Checking",,U,,09/11/2017,"Transfer : Lisa Cash Account",,,,"",$100.00,$0.00,$12191.58
"Dcu Checking",,U,,09/11/2017,"Transfer : Target",,,,"",$211.00,$0.00,$11980.58
"Dcu Checking",,U,,09/12/2017,"Seattle parking","Transportation : Parking","Transportation","Parking","",$1.50,$0.00,$11979.08
"Dcu Checking",,U,,09/12/2017,"Seattle parking","Transportation : Parking","Transportation","Parking","",$3.00,$0.00,$11976.08
"Dcu Checking",,U,,09/12/2017,"Seattle parking","Transportation : Parking","Transportation","Parking","",$3.50,$0.00,$11972.58
"Dcu Checking",,U,,09/12/2017,"Seattle parking","Transportation : Parking","Transportation","Parking","",$4.67,$0.00,$11967.91
"Dcu Checking",,U,,09/18/2017,"bank  fee","Personal : BankFee","Personal","BankFee","",$2.00,$0.00,$11965.91
"Dcu Checking",,U,,09/18/2017,"Transfer : Lisa Cash Account",,,,"",$200.00,$0.00,$11765.91
"Dcu Checking",,U,,09/19/2017,"Transfer : DCU LTD account",,,,"",$0.00,$10000.00,$21765.91
"Dcu Checking",,U,,09/22/2017,"Doswallips STATE PARK PASS","Recreation : Entertainment","Recreation","Entertainment","",$30.00,$0.00,$21735.91
"Dcu Checking",,U,,09/25/2017,"Ma Health Connector","Personal : Health Insurance","Personal","Health Insurance","",$594.83,$0.00,$21141.08
"Dcu Checking",,U,,09/27/2017,"Jetblue","Transportation : Air/train/bus/etc","Transportation","Air/train/bus/etc","Headphones",$5.00,$0.00,$21136.08
"Dcu Checking",,U,,09/27/2017,"Mom  and Dad Lander Gift","Financial Help : Mom And Dad","Financial Help","Mom And Dad","",$7000.00,$0.00,$14136.08
"Dcu Checking",,U,,09/28/2017,"Seeking Alpha","Income : Available next month","Income","Available next month","",$0.00,$114.12,$14250.20
"Dcu Checking",,U,,09/30/2017,"Frankies Modern","Food : Restaurants","Food","Restaurants","VICOTORIA BC - Good Meal - Spaghetti and meatballs(L), Lamb Sandwich (me), Calamari and mac and cheese (A)",$62.17,$0.00,$14188.03
"Dcu Checking",,U,,10/02/2017,"Save the children","Charity : Other","Charity","Other","",$31.00,$0.00,$14157.03
"Dcu Checking",,U,,10/04/2017,"verizon wireless","Housing : Cell Phones","Hidden Categories","Housing ` Cell Phones","",$157.78,$0.00,$13999.25
"Dcu Checking",,U,,10/06/2017,"Transfer : Discover",,,,"",$2907.28,$0.00,$11091.97
"Dcu Checking",,U,,10/09/2017,"Safety Insurance","Transportation : Car Insurance","Transportation","Car Insurance","",$241.50,$0.00,$10850.47
"Dcu Checking",,U,,10/10/2017,"Transfer : Target",,,,"",$229.15,$0.00,$10621.32
"Dcu Checking",,U,165,10/13/2017,"OPRD","RV : Campgrounds","RV","Campgrounds","Nehalem Bay State Park",$87.00,$0.00,$10534.32
"Dcu Checking",,U,,10/14/2017,"Parks Oregon City","RV : Campgrounds","RV","Campgrounds","Clackmette",$90.00,$0.00,$10444.32
"Dcu Checking",,U,,10/16/2017,"bank  fee","Personal : BankFee","Personal","BankFee","",$0.75,$0.00,$10443.57
"Dcu Checking",,U,,10/16/2017,"parking","Transportation : Parking","Transportation","Parking","",$0.80,$0.00,$10442.77
"Dcu Checking",,U,,10/16/2017,"parking","Transportation : Parking","Transportation","Parking","",$3.80,$0.00,$10438.97
"Dcu Checking",,U,,10/16/2017,"parking","Transportation : Parking","Transportation","Parking","",$4.00,$0.00,$10434.97
"Dcu Checking",,U,,10/16/2017,"Rooster Rock","Recreation : Entertainment","Recreation","Entertainment","Oregon state park",$5.00,$0.00,$10429.97
"Dcu Checking",,U,,10/16/2017,"Silver Falls","Recreation : Entertainment","Recreation","Entertainment","REally beautiful Oregon state park with lots of FALLS",$5.00,$0.00,$10424.97
"Dcu Checking",,U,155,10/16/2017,"Yoga Center of cape code","Personal : Fitness","Personal","Fitness","Lisa yoga",$14.00,$0.00,$10410.97
"Dcu Checking",,U,,10/16/2017,"Olumpic NP","RV : Campgrounds","RV","Campgrounds","",$60.00,$0.00,$10350.97
"Dcu Checking",,U,,10/17/2017,"Transfer : Lisa Cash Account",,,,"",$60.00,$0.00,$10290.97
"Dcu Checking",,U,,10/19/2017,"Portland parking","Recreation : Entertainment","Recreation","Entertainment","",$2.00,$0.00,$10288.97
"Dcu Checking",,U,,10/19/2017,"Spicer Brothers Produce","Food : Groceries","Food","Groceries","",$7.13,$0.00,$10281.84
"Dcu Checking",,U,,10/20/2017,"Parks Oregon City","RV : Campgrounds","RV","Campgrounds","",$60.00,$0.00,$10221.84
"Dcu Checking",,U,,10/20/2017,"Parks Oregon City","RV : Campgrounds","RV","Campgrounds","",$150.00,$0.00,$10071.84
"Dcu Checking",,U,,10/21/2017,"Porland parking","Recreation : Entertainment","Recreation","Entertainment","",$2.00,$0.00,$10069.84
"Dcu Checking",,U,,10/21/2017,"Porland parking","Recreation : Entertainment","Recreation","Entertainment","",$6.00,$0.00,$10063.84
"Dcu Checking",,U,,10/24/2017,"Ma Health Connector","Personal : Health Insurance","Personal","Health Insurance","",$593.75,$0.00,$9470.09
"Dcu Checking",,U,,10/25/2017,"Transfer : DCU LTD account",,,,"",$0.00,$10000.00,$19470.09
"Dcu Checking",,U,,10/25/2017,"parking","Transportation : Parking","Transportation","Parking","",$2.40,$0.00,$19467.69
"Dcu Checking",,U,,10/25/2017,"Safety Insurance","Transportation : Car Insurance","Transportation","Car Insurance","",$241.50,$0.00,$19226.19
"Dcu Checking",,U,,10/27/2017,"Deposit","Income : Available next month","Income","Available next month","GIFt",$0.00,$50.00,$19276.19
"Dcu Checking",,U,,10/27/2017,"Transfer : Lisa Cash Account",,,,"",$50.00,$0.00,$19226.19
"Dcu Checking",,U,,10/30/2017,"OR state Parks","RV : Campgrounds","RV","Campgrounds","Steward STate park Oregon",$52.00,$0.00,$19174.19
"Dcu Checking",,U,,11/01/2017,"Save the children","Charity : Other","Charity","Other","",$31.00,$0.00,$19143.19
"Dcu Checking",,U,,11/01/2017,"verizon wireless","Housing : Cell Phones","Hidden Categories","Housing ` Cell Phones","",$172.60,$0.00,$18970.59
"Dcu Checking",,U,157,11/02/2017,"OPRD","RV : Campgrounds","RV","Campgrounds","Yoga Squirrel B41 - Arrived at night NICE PARK",$22.00,$0.00,$18948.59
"Dcu Checking",,U,,11/02/2017,"Jacks Landing","RV : Campgrounds","RV","Campgrounds","GRANTS PASS - 1 Night Pass thru fine for one night",$42.28,$0.00,$18906.31
"Dcu Checking",,U,,11/03/2017,"Joshua Mattei-Lownes","Personal : Gifts","Personal","Gifts","",$50.00,$0.00,$18856.31
"Dcu Checking",,U,,11/06/2017,"Transfer : Discover",,,,"",$4183.53,$0.00,$14672.78
"Dcu Checking",,U,,11/09/2017,"CHinook RV Park","RV : Campgrounds","RV","Campgrounds","Near Drive thru TREE",$34.18,$0.00,$14638.60
"Dcu Checking",,U,158,11/09/2017,"CHinook RV Park","RV : Campgrounds","RV","Campgrounds","",$60.00,$0.00,$14578.60
"Dcu Checking",,U,159,11/10/2017,"POMO RV PARK","RV : Campgrounds","RV","Campgrounds","Fort Brag Near Mendicino",$102.20,$0.00,$14476.40
"Dcu Checking",,U,,11/13/2017,"Noodle Palace","Food : Restaurants","Food","Restaurants","GREAT PHO in Santa Rosa",$45.95,$0.00,$14430.45
"Dcu Checking",,U,,11/13/2017,"Matanzas Creek","Recreation : Entertainment","Recreation","Entertainment","and WINE - nice winery",$47.43,$0.00,$14383.02
"Dcu Checking",,U,163,11/13/2017,"Victor Martinez","Transportation : Repairs & Maintenance","Transportation","Repairs & Maintenance","",$200.00,$0.00,$14183.02
"Dcu Checking",,U,,11/15/2017,"parking","Transportation : Parking","Transportation","Parking","",$2.25,$0.00,$14180.77
"Dcu Checking",,U,,11/16/2017,"parking","Transportation : Parking","Transportation","Parking","",$1.75,$0.00,$14179.02
"Dcu Checking",,U,,11/18/2017,"Aled Auto","RV : Maintenance","RV","Maintenance","",$126.67,$0.00,$14052.35
"Dcu Checking",,U,,11/24/2017,"Harry's Cafe","Food : Restaurants","Food","Restaurants","IN SAC - great little place",$42.59,$0.00,$14009.76
"Dcu Checking",,U,,11/24/2017,"Cal Expo","RV : Campgrounds","RV","Campgrounds","",$200.00,$0.00,$13809.76
"Dcu Checking",,U,,11/24/2017,"Ma Health Connector","Personal : Health Insurance","Personal","Health Insurance","",$593.75,$0.00,$13216.01
"Dcu Checking",,U,160,11/27/2017,"POMO RV PARK","RV : Campgrounds","RV","Campgrounds","",$51.10,$0.00,$13164.91
"Dcu Checking",,U,,11/27/2017,"Gas","RV : gasoline","RV","gasoline","",$100.00,$0.00,$13064.91
"Dcu Checking",,U,,12/01/2017,"Save the children","Charity : Other","Charity","Other","",$31.00,$0.00,$13033.91
"Dcu Checking",,U,,12/02/2017,"Monteray Parking","Transportation : Parking","Transportation","Parking","",$3.00,$0.00,$13030.91
"Dcu Checking",,U,,12/04/2017,"verizon wireless","Housing : Cell Phones","Hidden Categories","Housing ` Cell Phones","",$172.60,$0.00,$12858.31
"Dcu Checking",,U,,12/04/2017,"Safety Insurance","Transportation : Car Insurance","Transportation","Car Insurance","",$241.50,$0.00,$12616.81
"Dcu Checking",,U,,12/05/2017,"Arco","RV : gasoline","RV","gasoline","",$100.00,$0.00,$12516.81
"Dcu Checking",,U,,12/06/2017,"Transfer : Discover",,,,"",$2838.29,$0.00,$9678.52
"Dcu Checking",,U,,12/07/2017,"Ma Health Connector","Personal : Health Insurance","Personal","Health Insurance","",$83.91,$0.00,$9594.61
"Dcu Checking",,U,164,12/08/2017,"serafine","Personal : Gifts","Personal","Gifts","",$50.00,$0.00,$9544.61
"Dcu Checking",,U,166,12/08/2017,"Mariiposa Fairgrounds","RV : Campgrounds","RV","Campgrounds","",$105.00,$0.00,$9439.61
"Dcu Checking",,U,,12/08/2017,"Transfer : Target",,,,"",$222.34,$0.00,$9217.27
"Dcu Checking",,U,,12/11/2017,"bank  fee","Personal : BankFee","Personal","BankFee","",$0.75,$0.00,$9216.52
"Dcu Checking",,U,,12/11/2017,"Percorino Romanos","Food : Restaurants","Food","Restaurants","",$50.00,$0.00,$9166.52
"Dcu Checking",,U,171,12/11/2017,"Emerald Physcisans","Personal : Doctor, Dentist","Personal","Doctor, Dentist","",$50.00,$0.00,$9116.52
"Dcu Checking",,U,,12/11/2017,"Transfer : Lisa Cash Account",,,,"",$100.00,$0.00,$9016.52
"Dcu Checking",,U,,12/26/2017,"QUAN CHINESE KITCHEN","Food : Restaurants","Food","Restaurants","",$60.25,$0.00,$8956.27
"Dcu Checking",,U,,12/26/2017,"Safety Insurance","Transportation : Car Insurance","Transportation","Car Insurance","",$350.00,$0.00,$8606.27
"Dcu Checking",,U,,12/28/2017,"Seeking Alpha","Income : Available next month","Income","Available next month","",$0.00,$109.90,$8716.17
"Dcu Checking",,U,167,12/28/2017,"Mariposa","RV : Campgrounds","RV","Campgrounds","",$70.00,$0.00,$8646.17
"Dcu Checking",,U,,12/29/2017,"Transfer : Lisa Cash Account",,,,"",$400.00,$0.00,$8246.17
"Dcu Checking",,U,,01/01/2018,"parking","Transportation : Parking","Transportation","Parking","hartford BBall game",$15.00,$0.00,$8231.17
"Dcu Checking",,U,,01/02/2018,"Save the children","Charity : Other","Charity","Other","",$31.00,$0.00,$8200.17
"Dcu Checking",,U,170,01/02/2018,"serafine","Personal : Gifts","Personal","Gifts","",$50.00,$0.00,$8150.17
"Dcu Checking",,U,,01/03/2018,"alyssa loan","Loans : LoanAlyssa","Loans","LoanAlyssa","",$0.00,$1200.00,$9350.17
"Dcu Checking",,U,,01/03/2018,"parking","Transportation : Parking","Transportation","Parking","",$1.75,$0.00,$9348.42
"Dcu Checking",,U,,01/03/2018,"Transfer : Lisa Cash Account",,,,"",$200.00,$0.00,$9148.42
"Dcu Checking",,U,,01/04/2018,"Transfer : DCU LTD account",,,,"",$0.00,$12000.00,$21148.42
"Dcu Checking",,U,,01/04/2018,"verizon wireless","Housing : Cell Phones","Hidden Categories","Housing ` Cell Phones",,$172.60,$0.00,$20975.82
"Dcu Checking",,U,,01/06/2018,"Transfer : Discover",,,,"",$3879.21,$0.00,$17096.61
"Dcu Checking",,U,,01/10/2018,"Transfer : Target",,,,"",$151.19,$0.00,$16945.42
"Dcu Checking",,U,,01/18/2018,"laundry","RV : Laundry","RV","Laundry","",$6.00,$0.00,$16939.42
"Dcu Checking",,U,,01/18/2018,"laundry","RV : Laundry","RV","Laundry","",$9.00,$0.00,$16930.42
"Dcu Checking",,U,,01/19/2018,"golden short rv","RV : Campgrounds","RV","Campgrounds","",$340.00,$0.00,$16590.42
"Dcu Checking",,U,,01/22/2018,"Ma Health Connector","Personal : Health Insurance","Personal","Health Insurance","",$83.91,$0.00,$16506.51
"Dcu Checking",,U,,01/22/2018,"Safety Insurance","Transportation : Car Insurance","Transportation","Car Insurance","",$350.00,$0.00,$16156.51
"Dcu Checking",,U,169,01/23/2018,"Joshua Mattei-Lownes","Personal : Gifts","Personal","Gifts","",$50.00,$0.00,$16106.51
"Dcu Checking",,U,,01/24/2018,"San Diego Parks","RV : Campgrounds","RV","Campgrounds","",$150.00,$0.00,$15956.51
"Dcu Checking",,U,173,01/30/2018,"share care","Personal : Doctor, Dentist","Personal","Doctor, Dentist","",$29.91,$0.00,$15926.60
"Dcu Checking",,U,,01/30/2018,"cosd parks","RV : Campgrounds","RV","Campgrounds","sweetwater summit regional park near San Diego",$137.00,$0.00,$15789.60
"Dcu Checking",,U,,02/01/2018,"Save the children","Charity : Other","Charity","Other","",$31.00,$0.00,$15758.60
"Dcu Checking",,U,,02/01/2018,"Sequia Rv Park","RV : Campgrounds","RV","Campgrounds","Jan 13 - Park outside Sequoia - Not many people so plenty of space - run down",$40.00,$0.00,$15718.60
"Dcu Checking",,U,172,02/02/2018,"Sequia Rv Park","RV : Campgrounds","RV","Campgrounds","Jan 10-12",$120.00,$0.00,$15598.60
"Dcu Checking",,U,,02/02/2018,"verizon wireless","Housing : Cell Phones","Hidden Categories","Housing ` Cell Phones","",$172.69,$0.00,$15425.91
"Dcu Checking",,U,,02/06/2018,"Transfer : Discover",,,,"",$4013.34,$0.00,$11412.57
"Dcu Checking",,U,,02/07/2018,"Ma Health Connector","Personal : Health Insurance","Personal","Health Insurance","",$83.91,$0.00,$11328.66
"Dcu Checking",,U,,02/10/2018,"Deposit","Income : Available next month","Income","Available next month","My pay and money from moms insurance",$0.00,$575.68,$11904.34
"Dcu Checking",,U,,02/10/2018,"Transfer : Lisa Cash Account",,,,"",$100.00,$0.00,$11804.34
"Dcu Checking",,U,,02/12/2018,"paypal","RV : clubs","RV","clubs","Technomedia Membership",$65.00,$0.00,$11739.34
"Dcu Checking",,U,,02/20/2018,"Mackinow Coast","Personal : cloths","Personal","cloths","MY SUN GLASSES - Nice people but I probably did not need the sunglasses",$44.04,$0.00,$11695.30
"Dcu Checking",,U,,02/23/2018,"Transfer : DCU LTD account",,,,"",$0.00,$75000.00,$86695.30
"Dcu Checking",,U,,02/23/2018,"Kates Saloon","Food : Restaurants","Food","Restaurants","IN TOMBSTONE - which was pretty neat",$50.71,$0.00,$86644.59
"Dcu Checking",,U,168,02/28/2018,"Zach mattei-lownes","Personal : Gifts","Personal","Gifts","",$50.00,$0.00,$86594.59
"Dcu Checking",,U,,03/01/2018,"Save the children","Charity : Other","Charity","Other","",$31.00,$0.00,$86563.59
"Dcu Checking",,U,,03/02/2018,"","Lisa Business : Bank Fees","Lisa Business","Bank Fees","",$15.00,$0.00,$86548.59
"Dcu Checking",,U,,03/02/2018,"Transfer : Etrade Taxable",,,,"Invest",$50000.00,$0.00,$36548.59
"Dcu Checking",,U,,03/03/2018,"bankfee","Personal : BankFee","Personal","BankFee","",$0.75,$0.00,$36547.84
"Dcu Checking",,U,,03/03/2018,"Transfer : Lisa Cash Account",,,,"",$80.00,$0.00,$36467.84
"Dcu Checking",,U,,03/05/2018,"verizon wireless","Housing : Cell Phones","Hidden Categories","Housing ` Cell Phones","",$213.19,$0.00,$36254.65
"Dcu Checking",,U,176,03/07/2018,"Cactus Wrens","Food : Restaurants","Food","Restaurants","meal SKP Saguaro",$16.00,$0.00,$36238.65
"Dcu Checking",,U,,03/07/2018,"Transfer : Discover",,,,"",$3792.96,$0.00,$32445.69
"Dcu Checking",,U,,03/08/2018,"Ma Health Connector","Personal : Health Insurance","Personal","Health Insurance",,$49.91,$0.00,$32395.78
"Dcu Checking",,U,,03/08/2018,"Safety Insurance","Transportation : Car Insurance","Transportation","Car Insurance","",$214.38,$0.00,$32181.40
"Dcu Checking",,U,,03/12/2018,"bank  fee","Personal : BankFee","Personal","BankFee","",$0.75,$0.00,$32180.65
"Dcu Checking",,U,,03/12/2018,"Transfer : Lisa Cash Account",,,,"",$100.00,$0.00,$32080.65
"Dcu Checking",,U,,03/12/2018,"Transfer : Target",,,,"",$234.51,$0.00,$31846.14
"Dcu Checking",,U,,03/13/2018,"Town of Dennis","RV : excise tax","RV","excise tax","",$0.25,$0.00,$31845.89
"Dcu Checking",,U,,03/13/2018,"Town of Dennis","Transportation : Auto Excise","Transportation","Auto Excise","",$0.25,$0.00,$31845.64
"Dcu Checking",,U,,03/13/2018,"Town of Dennis","Transportation : Auto Excise","Transportation","Auto Excise","",$37.50,$0.00,$31808.14
"Dcu Checking",,U,175,03/13/2018,"SKP SAGUARO","RV : propane","RV","propane","",$38.50,$0.00,$31769.64
"Dcu Checking",,U,,03/13/2018,"Town of Dennis","RV : excise tax","RV","excise tax","",$1058.75,$0.00,$30710.89
"Dcu Checking",,U,177,03/20/2018,"SKP SAGUARO","RV : Campgrounds","RV","Campgrounds","",$22.31,$0.00,$30688.58
"Dcu Checking",,U,,03/20/2018,"KARTCHNER CAVERNS","Recreation : Entertainment","Recreation","Entertainment","",$46.00,$0.00,$30642.58
"Dcu Checking",,U,185,03/20/2018,"SKP SAGUARO","RV : Campgrounds","RV","Campgrounds","ELECTRIC",$62.21,$0.00,$30580.37
"Dcu Checking",,U,180,03/20/2018,"SKP ROVERS ROOST","RV : Campgrounds","RV","Campgrounds","",$117.37,$0.00,$30463.00
"Dcu Checking",,U,,03/22/2018,"CANCELLED STAY","RV : Campgrounds","RV","Campgrounds","",$0.00,$50.00,$30513.00
"Dcu Checking",,U,,03/22/2018,"Transfer : Lisa Cash Account",,,,"",$300.00,$0.00,$30213.00
"Dcu Checking",,U,,03/28/2018,"Tax refund MASSACHUSETTS","Income : Available this month","Income","Available this month","",$0.00,$287.00,$30500.00
"Dcu Checking",,U,178,03/29/2018,"SKP ROVERS ROOST","RV : Campgrounds","RV","Campgrounds","Electric",$31.75,$0.00,$30468.25
"Dcu Checking",,U,186,03/29/2018,"Manzano RV","RV : Campgrounds","RV","Campgrounds","Virginia and Ledo - Silver City",$100.80,$0.00,$30367.45
"Dcu Checking",,U,182,03/29/2018,"Mary Mattei","Food : Groceries","Food","Groceries","(Split 1/3) Check for Alyssa Expenses",$500.00,$0.00,$29367.45
"Dcu Checking",,U,182,03/29/2018,"Mary Mattei","Food : Restaurants","Food","Restaurants","(Split 2/3) Check for Alyssa Expenses",$200.00,$0.00,$29367.45
"Dcu Checking",,U,182,03/29/2018,"Mary Mattei","Personal : Miscellaneous","Personal","Miscellaneous","(Split 3/3) Check for Alyssa Expenses",$300.00,$0.00,$29367.45
"Dcu Checking",,U,184,03/30/2018,"SKP SAGUARO","RV : Campgrounds","RV","Campgrounds","Electric",$5.42,$0.00,$29362.03
"Dcu Checking",,U,183,03/30/2018,"SKP SAGUARO","Food : Restaurants","Food","Restaurants","Fish Fry at SKP",$10.00,$0.00,$29352.03
"Dcu Checking",,U,,04/02/2018,"bank  fee","Personal : BankFee","Personal","BankFee","",$0.75,$0.00,$29351.28
"Dcu Checking",,U,,04/02/2018,"Save the children","Charity : Other","Charity","Other","",$31.00,$0.00,$29320.28
"Dcu Checking",,U,,04/02/2018,"Transfer : Lisa Cash Account",,,,"",$100.00,$0.00,$29220.28
"Dcu Checking",,U,,04/03/2018,"parking","Transportation : Parking","Transportation","Parking","",$8.00,$0.00,$29212.28
"Dcu Checking",,U,181,04/03/2018,"Anna Mattei","Personal : Gifts","Personal","Gifts","",$71.00,$0.00,$29141.28
"Dcu Checking",,U,187,04/03/2018,"High Dsert RV","RV : Campgrounds","RV","Campgrounds","",$160.00,$0.00,$28981.28
"Dcu Checking",,U,,04/03/2018,"verizon wireless","Housing : Cell Phones","Hidden Categories","Housing ` Cell Phones",,$224.82,$0.00,$28756.46
"Dcu Checking",,U,,04/03/2018,"Safety Insurance","Transportation : Car Insurance","Transportation","Car Insurance","",$287.12,$0.00,$28469.34
"Dcu Checking",,U,,04/05/2018,"Ma Health Connector","Personal : Health Insurance","Personal","Health Insurance",,$66.91,$0.00,$28402.43
"Dcu Checking",,U,,04/06/2018,"Transfer : Discover",,,,"",$2845.42,$0.00,$25557.01
"Dcu Checking",,U,,04/09/2018,"Transfer : Target",,,,"",$92.15,$0.00,$25464.86
"Dcu Checking",,U,,04/10/2018,"tire air","Transportation : Repairs & Maintenance","Transportation","Repairs & Maintenance","Air for tire",$1.25,$0.00,$25463.61
"Dcu Checking",,U,,04/11/2018,"parking","Transportation : Parking","Transportation","Parking","Santa Fe",$4.00,$0.00,$25459.61
"Dcu Checking",,U,,04/11/2018,"Santa Fe Auto","Transportation : Repairs & Maintenance","Transportation","Repairs & Maintenance","Rudy and Sue - FIXED BREAKS - REALLY NICE GUY",$124.50,$0.00,$25335.11
"Dcu Checking",,U,,04/12/2018,"parking","Transportation : Parking","Transportation","Parking","",$4.00,$0.00,$25331.11
"Dcu Checking",,U,,04/13/2018,"parking","Transportation : Parking","Transportation","Parking","",$4.00,$0.00,$25327.11
"Dcu Checking",,U,,04/23/2018,"Gas","Transportation : Gas","Transportation","Gas","",$1.40,$0.00,$25325.71
"Dcu Checking",,U,,04/23/2018,"bank  fee","Personal : BankFee","Personal","BankFee","",$3.70,$0.00,$25322.01
"Dcu Checking",,U,,04/23/2018,"NM state parks","RV : Campgrounds","RV","Campgrounds","",$44.00,$0.00,$25278.01
"Dcu Checking",,U,,04/23/2018,"skp ranch","RV : Campgrounds","RV","Campgrounds","",$52.98,$0.00,$25225.03
"Dcu Checking",,U,,04/23/2018,"Transfer : Lisa Cash Account",,,,"",$100.00,$0.00,$25125.03
"Dcu Checking",,U,190,05/01/2018,"NM state parks","RV : Campgrounds","RV","Campgrounds","",$14.00,$0.00,$25111.03
"Dcu Checking",,U,,05/01/2018,"Save the children","Charity : Other","Charity","Other","",$31.00,$0.00,$25080.03
"Dcu Checking",,U,,05/02/2018,"parking","Transportation : Parking","Transportation","Parking","",$2.00,$0.00,$25078.03
"Dcu Checking",,U,,05/02/2018,"parking","Transportation : Parking","Transportation","Parking","",$4.00,$0.00,$25074.03
"Dcu Checking",,U,,05/03/2018,"Transfer : DCU LTD account",,,,"",$0.00,$45000.00,$70074.03
"Dcu Checking",,U,,05/03/2018,"bank  fee","Personal : BankFee","Personal","BankFee","",$15.00,$0.00,$70059.03
"Dcu Checking",,U,,05/03/2018,"verizon wireless","Housing : Cell Phones","Hidden Categories","Housing ` Cell Phones","",$192.85,$0.00,$69866.18
"Dcu Checking",,U,,05/03/2018,"Karina Mattei","Loans : Loan Karina","Loans","Loan Karina","",$20000.00,$0.00,$49866.18
"Dcu Checking",,U,,05/06/2018,"Transfer : Discover",,,,"",$4120.52,$0.00,$45745.66
"Dcu Checking",,U,,05/11/2018,"parking","Transportation : Parking","Transportation","Parking","flagstaff",$1.00,$0.00,$45744.66
"Dcu Checking",,U,,05/11/2018,"parking","Transportation : Parking","Transportation","Parking","flagstaff",$2.00,$0.00,$45742.66
"Dcu Checking",,U,,05/11/2018,"harkins cinema","Recreation : Entertainment","Recreation","Entertainment","movie Japanese dogs - 'DOG ISLAND'",$27.50,$0.00,$45715.16
"Dcu Checking",,U,,05/11/2018,"Ma Health Connector","Personal : Health Insurance","Personal","Health Insurance","",$66.91,$0.00,$45648.25
"Dcu Checking",,U,,05/15/2018,"parking","Transportation : Parking","Transportation","Parking","flagstaff",$1.00,$0.00,$45647.25
"Dcu Checking",,U,189,05/16/2018,"The Ranch","RV : Campgrounds","RV","Campgrounds","",$14.80,$0.00,$45632.45
"Dcu Checking",,U,191,05/16/2018,"Fort Tuthill","RV : Campgrounds","RV","Campgrounds","",$26.00,$0.00,$45606.45
"Dcu Checking",,U,,05/17/2018,"bank  fee","Personal : BankFee","Personal","BankFee","",$0.75,$0.00,$45605.70
"Dcu Checking",,U,,05/17/2018,"Transfer : Lisa Cash Account",,,,"",$120.00,$0.00,$45485.70
"Dcu Checking",,U,,05/18/2018,"irs","Income : Available this month","Income","Available this month","",$0.00,$8473.00,$53958.70
"Dcu Checking",,U,,05/19/2018,"parking","Transportation : Parking","Transportation","Parking","",$2.00,$0.00,$53956.70
"Dcu Checking",,U,192,05/23/2018,"Joshua Mattei-Lownes","Personal : Gifts","Personal","Gifts","",$200.00,$0.00,$53756.70
"Dcu Checking",,U,,05/25/2018,"Sol foods supermarket","Food : Groceries","Food","Groceries","",$9.06,$0.00,$53747.64
"Dcu Checking",,U,,06/01/2018,"bank  fee","Personal : BankFee","Personal","BankFee","",$0.75,$0.00,$53746.89
"Dcu Checking",,U,,06/01/2018,"Save the children","Charity : Other","Charity","Other","",$31.00,$0.00,$53715.89
"Dcu Checking",,U,195,06/01/2018,"Laura mattei","Personal : Gifts","Personal","Gifts","Birthday",$50.00,$0.00,$53665.89
"Dcu Checking",,U,,06/01/2018,"Transfer : Lisa Cash Account",,,,"",$100.00,$0.00,$53565.89
"Dcu Checking",,U,,06/01/2018,"verizon wireless","Housing : Cell Phones","Hidden Categories","Housing ` Cell Phones","",$218.50,$0.00,$53347.39
"Dcu Checking",,U,,06/07/2018,"usdi-BLM","RV : Campgrounds","RV","Campgrounds","Kens Lake Campground BLM land near ARCHES NP/ Canyon land NP",$45.00,$0.00,$53302.39
"Dcu Checking",,U,,06/07/2018,"Ma Health Connector","Personal : Health Insurance","Personal","Health Insurance","",$66.91,$0.00,$53235.48
"Dcu Checking",,U,,06/07/2018,"Transfer : Discover",,,,"",$3124.64,$0.00,$50110.84
"Dcu Checking",,U,,06/08/2018,"gasoline","RV : gasoline","RV","gasoline","Maverick Moab",$69.93,$0.00,$50040.91
"Dcu Checking",,U,,06/08/2018,"Transfer : Lisa Cash Account",,,,"",$200.00,$0.00,$49840.91
"Dcu Checking",,U,162,06/11/2018,"THousand Lakes RV","RV : Campgrounds","RV","Campgrounds","",$40.28,$0.00,$49800.63
"Dcu Checking",,U,194,06/11/2018,"Cliff Lander","Personal : Gifts","Personal","Gifts","",$50.00,$0.00,$49750.63
"Dcu Checking",,U,196,06/11/2018,"THousand Lakes RV","RV : Campgrounds","RV","Campgrounds","Torrey Utah",$84.98,$0.00,$49665.65
"Dcu Checking",,U,,06/11/2018,"Transfer : Target",,,,"",$101.94,$0.00,$49563.71
"Dcu Checking",,U,,06/14/2018,"Boondockers welcome","RV : clubs","RV","clubs","",$30.00,$0.00,$49533.71
"Dcu Checking",,U,,06/15/2018,"safeway fuel","Transportation : Gas","Transportation","Gas","",$16.61,$0.00,$49517.10
"Dcu Checking",,U,,06/15/2018,"redbubble","Personal : Gifts","Personal","Gifts","grampy fathers day",$25.38,$0.00,$49491.72
"Dcu Checking",,U,198,06/15/2018,"Diamond Campground","RV : Campgrounds","RV","Campgrounds","Two Nights",$52.30,$0.00,$49439.42
"Dcu Checking",,U,,06/15/2018,"Transfer : Lisa Cash Account",,,,"",$201.00,$0.00,$49238.42
"Dcu Checking",,U,193,06/18/2018,"Mom and dad","Personal : Gifts","Personal","Gifts","anniversary",$100.00,$0.00,$49138.42
"Dcu Checking",,U,,06/19/2018,"Larimire County","RV : Campgrounds","RV","Campgrounds","Up Mountain siwthcback Road Bobcat campground",$131.50,$0.00,$49006.92
"Dcu Checking",,U,,06/20/2018,"Plymouth and Brock","Transportation : Air/train/bus/etc","Transportation","Air/train/bus/etc","",$49.00,$0.00,$48957.92
"Dcu Checking",,U,,06/21/2018,"awesome t-shirts Estes Park","Personal : cloths","Personal","cloths","alyssa sweatshirt",$6.49,$0.00,$48951.43
"Dcu Checking",,U,,06/21/2018,"RIng Brothers Market place","Food : Groceries","Food","Groceries","",$6.91,$0.00,$48944.52
"Dcu Checking",,U,,06/22/2018,"crocker nurseries","Personal : Gifts","Personal","Gifts","plants mom and dad",$18.06,$0.00,$48926.46
"Dcu Checking",,U,,06/22/2018,"monnlight restauratn","Food : Restaurants","Food","Restaurants","breakfast for Lisa while waiting for tire place to open",$30.15,$0.00,$48896.31
"Dcu Checking",,U,,06/22/2018,"Pilot","RV : gasoline","RV","gasoline","",$142.84,$0.00,$48753.47
"Dcu Checking",,U,,06/23/2018,"Scargo cafe","Food : Restaurants","Food","Restaurants","",$84.21,$0.00,$48669.26
"Dcu Checking",,U,,06/23/2018,"stop & shop","Food : Groceries","Food","Groceries","",$128.00,$0.00,$48541.26
"Dcu Checking",,U,,06/23/2018,"delta","Personal : Gifts","Personal","Gifts","Cliff Ohio?",$311.40,$0.00,$48229.86
"Dcu Checking",,U,,06/23/2018,"delta","Personal : Gifts","Personal","Gifts","mom and dad ohio",$311.40,$0.00,$47918.46
"Dcu Checking",,U,,06/23/2018,"delta","Personal : Gifts","Personal","Gifts","Mom and Dad Ohio",$311.40,$0.00,$47607.06
"Dcu Checking",,U,,06/23/2018,"delta","Transportation : Air/train/bus/etc","Transportation","Air/train/bus/etc","OHIO trip",$311.40,$0.00,$47295.66
"Dcu Checking",,U,200,06/26/2018,"Geno RV","RV : Campgrounds","RV","Campgrounds","3 nights",$115.00,$0.00,$47180.66
"Dcu Checking",,U,201,06/29/2018,"Ellis Lakeside Campground","RV : Campgrounds","RV","Campgrounds","Nice campground in Ellis KS (no sewer) 30 amp",$20.00,$0.00,$47160.66
"Dcu Checking",,U,,06/29/2018,"Ivy's Cove","RV : Campgrounds","RV","Campgrounds","Russelville Arkansas - Pull Thru FHU",$39.78,$0.00,$47120.88
"Dcu Checking",,U,,07/02/2018,"Save the children","Charity : Other","Charity","Other","",$31.00,$0.00,$47089.88
"Dcu Checking",,U,,07/05/2018,"verizon wireless","Housing : Cell Phones","Hidden Categories","Housing ` Cell Phones","",$218.50,$0.00,$46871.38
"Dcu Checking",,U,,07/06/2018,"Transfer : Discover",,,,"",$2821.69,$0.00,$44049.69
"Dcu Checking",,U,204,07/10/2018,"NRRS","RV : Campgrounds","RV","Campgrounds","",$20.00,$0.00,$44029.69
"Dcu Checking",,U,203,07/10/2018,"NRRS","RV : Campgrounds","RV","Campgrounds","",$40.00,$0.00,$43989.69
"Dcu Checking",,U,,07/11/2018,"Ma Health Connector","Personal : Health Insurance","Personal","Health Insurance",,$66.91,$0.00,$43922.78
"Dcu Checking",,U,,07/11/2018,"Shell MS","RV : gasoline","RV","gasoline","",$80.00,$0.00,$43842.78
"Dcu Checking",,U,,07/11/2018,"Big Star Red Bay","Food : Groceries","Food","Groceries","",$107.50,$0.00,$43735.28
"Dcu Checking",,U,,07/12/2018,"Red Box","Recreation : Entertainment","Recreation","Entertainment","",$1.82,$0.00,$43733.46
"Dcu Checking",,U,,07/14/2018,"redbox","Recreation : Entertainment","Recreation","Entertainment","",$1.82,$0.00,$43731.64
"Dcu Checking",,U,,07/14/2018,"Dollar general","Food : Groceries","Food","Groceries","",$8.08,$0.00,$43723.56
"Dcu Checking",,U,,07/14/2018,"chevron MS","Transportation : Gas","Transportation","Gas","",$21.62,$0.00,$43701.94
"Dcu Checking",,U,,07/14/2018,"Vanelli Bistro","Food : Restaurants","Food","Restaurants","TUpelo - we met VOZ - also does animations",$42.48,$0.00,$43659.46
"Dcu Checking",,U,,07/14/2018,"Tupelo Auto Museum","Recreation : Entertainment","Recreation","Entertainment","",$47.16,$0.00,$43612.30
"Dcu Checking",,U,,07/18/2018,"Tiffin red bay","RV : Maintenance","RV","Maintenance","New Water FILTER - long over due",$15.52,$0.00,$43596.78
"Dcu Checking",,U,,07/18/2018,"Tiffin red bay","RV : Campgrounds","RV","Campgrounds","",$150.00,$0.00,$43446.78
"Dcu Checking",,U,,07/18/2018,"Bay Diesel Red Bay","RV : Maintenance","RV","Maintenance","Oil change and engine check 17k+",$159.97,$0.00,$43286.81
"Dcu Checking",,U,,07/18/2018,"Krokers, TN","Food : Groceries","Food","Groceries","",$167.22,$0.00,$43119.59
"Dcu Checking",,U,,07/19/2018,"Red bicycle","Food : Restaurants","Food","Restaurants","Coffee Nashville",$7.51,$0.00,$43112.08
"Dcu Checking",,U,,07/19/2018,"Chefs  Market Cafe","Food : Restaurants","Food","Restaurants","",$40.16,$0.00,$43071.92
"Dcu Checking",,U,,07/19/2018,"Cowboys Hertselle","RV : gasoline","RV","gasoline","2.49 a gallon - pretty cheap!",$75.00,$0.00,$42996.92
"Dcu Checking",,U,,07/19/2018,"target","Food : Groceries","Food","Groceries","(Split 1/2) food",$30.00,$0.00,$42905.37
"Dcu Checking",,U,,07/19/2018,"target","RV : Equipment/Supplies","RV","Equipment/Supplies","(Split 2/2) ",$61.55,$0.00,$42905.37
"Dcu Checking",,U,,07/19/2018,"KY reserve","RV : Campgrounds","RV","Campgrounds","Kentucky Horse Park",$154.76,$0.00,$42750.61
"Dcu Checking",,U,,07/20/2018,"Deposit","Income : Available next month","Income","Available next month","",$0.00,$79.00,$42829.61
"Dcu Checking",,U,,07/20/2018,"Wal-mart","Food : Groceries","Food","Groceries","",$12.94,$0.00,$42816.67
"Dcu Checking",,U,,07/20/2018,"Godaddy","Lisa Business : Advertizing","Lisa Business","Advertizing","",$15.17,$0.00,$42801.50
"Dcu Checking",,U,,07/20/2018,"Recreation.gov","Recreation : Entertainment","Recreation","Entertainment","mammoth cave",$51.00,$0.00,$42750.50
"Dcu Checking",,U,,07/20/2018,"ACME FEED NASHVILLE","Food : Restaurants","Food","Restaurants","",$59.66,$0.00,$42690.84
"Dcu Checking",,U,,07/20/2018,"Transfer : Lisa Cash Account",,,,"",$100.00,$0.00,$42590.84
"Dcu Checking",,U,,07/20/2018,"grand Ole RV Ressort","RV : Campgrounds","RV","Campgrounds","",$101.60,$0.00,$42489.24
"Dcu Checking",,U,,07/21/2018,"Pantheon nashville","Recreation : Entertainment","Recreation","Entertainment","",$12.28,$0.00,$42476.96
"Dcu Checking",,U,,07/21/2018,"books a million","Recreation : Entertainment","Recreation","Entertainment","",$19.31,$0.00,$42457.65
"Dcu Checking",,U,,07/21/2018,"Walmart","Food : Groceries","Food","Groceries","Madison TN",$20.00,$0.00,$42437.65
"Dcu Checking",,U,,07/23/2018,"Red Box","Recreation : Entertainment","Recreation","Entertainment","",$1.86,$0.00,$42435.79
"Dcu Checking",,U,,07/23/2018,"restaurants","Food : Restaurants","Food","Restaurants","MUSIC BAR?",$15.50,$0.00,$42420.29
"Dcu Checking",,U,,07/23/2018,"chasers Kentucky Chocolate","Personal : Gifts","Personal","Gifts","",$31.07,$0.00,$42389.22
"Dcu Checking",,U,,07/23/2018,"Pilot KY","RV : gasoline","RV","gasoline","",$100.05,$0.00,$42289.17
"Dcu Checking",,U,,07/23/2018,"Krogers","Food : Groceries","Food","Groceries","",$120.11,$0.00,$42169.06
"Dcu Checking",,U,,07/25/2018,"redbox","Recreation : Entertainment","Recreation","Entertainment","",$1.86,$0.00,$42167.20
"Dcu Checking",,U,,07/25/2018,"cinemark theatres","Recreation : Entertainment","Recreation","Entertainment","",$17.49,$0.00,$42149.71
"Dcu Checking",,U,,07/25/2018,"Bourbon Toul","Food : Restaurants","Food","Restaurants","Cheap eats lexington",$31.62,$0.00,$42118.09
"Dcu Checking",,U,,07/25/2018,"Walmart","Food : Groceries","Food","Groceries","",$74.06,$0.00,$42044.03
"Dcu Checking",,U,,07/26/2018,"lexpark","Lisa Business : Parking","Lisa Business","Parking","",$1.25,$0.00,$42042.78
"Dcu Checking",,U,,07/26/2018,"speedway","Transportation : Gas","Transportation","Gas","",$20.00,$0.00,$42022.78
"Dcu Checking",,U,,07/26/2018,"lexiinton diner","Food : Restaurants","Food","Restaurants","",$28.00,$0.00,$41994.78
"Dcu Checking",,U,,07/26/2018,"tonys autorepair","Transportation : Repairs & Maintenance","Transportation","Repairs & Maintenance","oil change tire rotation",$53.50,$0.00,$41941.28
"Dcu Checking",,U,,07/27/2018,"Kentucky Horse park","RV : Campgrounds","RV","Campgrounds","",$98.58,$0.00,$41842.70
"Dcu Checking",,U,,07/27/2018,"luftstansa","Transportation : Air/train/bus/etc","Transportation","Air/train/bus/etc","",$795.23,$0.00,$41047.47
"Dcu Checking",,U,,07/27/2018,"luftstansa","Transportation : Air/train/bus/etc","Transportation","Air/train/bus/etc","",$795.23,$0.00,$40252.24
"Dcu Checking",,U,,07/28/2018,"fisesta Amigos Louisville","Food : Restaurants","Food","Restaurants","",$34.00,$0.00,$40218.24
"Dcu Checking",,U,,07/28/2018,"Kentucky Derbie Museum","Recreation : Entertainment","Recreation","Entertainment","",$47.70,$0.00,$40170.54
"Dcu Checking",,U,,07/28/2018,"MD Parks","RV : Campgrounds","RV","Campgrounds","Rocky Gap State Park MD",$63.23,$0.00,$40107.31
"Dcu Checking",,U,,07/30/2018,"Walmart","Food : Groceries","Food","Groceries","coffee",$6.18,$0.00,$40101.13
"Dcu Checking",,U,,07/30/2018,"Kentucky Horse park","Personal : Gifts","Personal","Gifts","",$7.00,$0.00,$40094.13
"Dcu Checking",,U,,07/30/2018,"Walmart","Personal : cloths","Personal","cloths","",$8.48,$0.00,$40085.65
"Dcu Checking",,U,,07/30/2018,"Love S country","Personal : Gifts","Personal","Gifts","",$23.77,$0.00,$40061.88
"Dcu Checking",,U,,07/30/2018,"Krokers, TN","Food : Groceries","Food","Groceries","",$33.10,$0.00,$40028.78
"Dcu Checking",,U,,07/30/2018,"Kentuckcy Artisan","Personal : Gifts","Personal","Gifts","",$38.42,$0.00,$39990.36
"Dcu Checking",,U,,07/30/2018,"noodle nervana","Food : Restaurants","Food","Restaurants","meal with Hung and Mike",$60.35,$0.00,$39930.01
"Dcu Checking",,U,,07/30/2018,"State Parks Pa","RV : Campgrounds","RV","Campgrounds","",$105.50,$0.00,$39824.51
"Dcu Checking",,U,,07/31/2018,"Yamoto","Food : Restaurants","Food","Restaurants","",$78.13,$0.00,$39746.38
"Dcu Checking",,U,,07/31/2018,"Shell Grayson Kentucky","RV : gasoline","RV","gasoline","",$95.00,$0.00,$39651.38
"Dcu Checking",,U,,08/01/2018,"Save the children","Charity : Other","Charity","Other","",$31.00,$0.00,$39620.38
"Dcu Checking",,U,,08/01/2018,"Gas Walmart","RV : gasoline","RV","gasoline","",$100.00,$0.00,$39520.38
"Dcu Checking",,U,,08/01/2018,"verizon wireless","Housing : Cell Phones","Hidden Categories","Housing ` Cell Phones",,$218.29,$0.00,$39302.09
"Dcu Checking",,U,,08/01/2018,"Grand Prix Driving School","Personal : Miscellaneous","Personal","Miscellaneous","Driving School",$300.00,$0.00,$39002.09
"Dcu Checking",,U,,08/02/2018,"google storage","business (bob) : computer","Hidden Categories","business (bob) ` computer","",$1.99,$0.00,$39000.10
"Dcu Checking",,U,,08/03/2018,"Lovers MD","Food : Restaurants","Food","Restaurants","subway?",$12.91,$0.00,$38987.19
"Dcu Checking",,U,,08/03/2018,"loves md","RV : gasoline","RV","gasoline","",$125.00,$0.00,$38862.19
"Dcu Checking",,U,,08/04/2018,"showrite pa","Food : Groceries","Food","Groceries","",$9.67,$0.00,$38852.52
"Dcu Checking",,U,,08/04/2018,"shoprite  pa","Food : Groceries","Food","Groceries","",$25.20,$0.00,$38827.32
"Dcu Checking",,U,,08/06/2018,"Cumberland Farms","Transportation : Gas","Transportation","Gas","GAS? Mansfield CT",$28.31,$0.00,$38799.01
"Dcu Checking",,U,,08/06/2018,"Gerrity","Food : Groceries","Food","Groceries","PA",$70.39,$0.00,$38728.62
"Dcu Checking",,U,,08/06/2018,"Shell","RV : gasoline","RV","gasoline","Montgomery NY",$95.00,$0.00,$38633.62
"Dcu Checking",,U,,08/07/2018,"Safety Insurance","Transportation : Car Insurance","Transportation","Car Insurance","",$66.60,$0.00,$38567.02
"Dcu Checking",,U,,08/07/2018,"Jalkes","Food : Restaurants","Food","Restaurants","Lunch ANN ZACH JOSH",$68.00,$0.00,$38499.02
"Dcu Checking",,U,,08/07/2018,"Transfer : Lisa Cash Account",,,,"",$200.00,$0.00,$38299.02
"Dcu Checking",,U,,08/07/2018,"Transfer : Discover",,,,"",$5641.32,$0.00,$32657.70
"Dcu Checking",,U,,08/08/2018,"charlie brown","Recreation : Entertainment","Recreation","Entertainment","tubes",$11.80,$0.00,$32645.90
"Dcu Checking",,U,,08/08/2018,"Price Chopper","Food : Groceries","Food","Groceries","",$145.94,$0.00,$32499.96
"Dcu Checking",,U,,08/10/2018,"Exxon mobile","Transportation : Gas","Transportation","Gas","Ashland CT",$24.98,$0.00,$32474.98
"Dcu Checking",,U,,08/10/2018,"e-ZPass","RV : Tolls","RV","Tolls","",$45.00,$0.00,$32429.98
"Dcu Checking",,U,,08/11/2018,"riteaid","Personal : nom-prescription medication","Personal","nom-prescription medication","",$12.47,$0.00,$32417.51
"Dcu Checking",,U,,08/11/2018,"DunRoamin","RV : Campgrounds","RV","Campgrounds","",$680.00,$0.00,$31737.51
"Dcu Checking",,U,,08/13/2018,"","Loans : Loan Karina","Loans","Loan Karina","",$0.00,$20000.00,$51737.51
"Dcu Checking",,U,,08/13/2018,"stop & shop","Food : Groceries","Food","Groceries","dennis",$62.74,$0.00,$51674.77
"Dcu Checking",,U,199,08/14/2018,"Peppertree","RV : Campgrounds","RV","Campgrounds","",$200.00,$0.00,$51474.77
"Dcu Checking",,U,,08/16/2018,"QUAN CHINESE KITCHEN","Food : Restaurants","Food","Restaurants","",$93.13,$0.00,$51381.64
"Dcu Checking",,U,,08/17/2018,"Transfer : Lisa Cash Account",,,,"",$100.00,$0.00,$51281.64
"Dcu Checking",,U,,08/27/2018,"google storage","business (bob) : computer","Hidden Categories","business (bob) ` computer","",$1.99,$0.00,$51279.65
"Dcu Checking",,U,,08/27/2018,"skianes","Food : Restaurants","Food","Restaurants","lobster ROLLS!!!",$42.80,$0.00,$51236.85
"Dcu Checking",,U,,08/27/2018,"Joshua Mattei-Lownes","Personal : Gifts","Personal","Gifts","",$250.00,$0.00,$50986.85
"Dcu Checking",,U,,08/28/2018,"NRRS","RV : Campgrounds","RV","Campgrounds","where?",$28.00,$0.00,$50958.85
"Dcu Checking",,U,,09/04/2018,"Save the children","Charity : Other","Charity","Other","",$31.00,$0.00,$50927.85
"Dcu Checking",,U,,09/04/2018,"Captain Frosty","Food : Restaurants","Food","Restaurants","Dennis",$32.47,$0.00,$50895.38
"Dcu Checking",,U,,09/04/2018,"verizon wireless","RV : Cell Phones and Data","RV","Cell Phones and Data","",$218.29,$0.00,$50677.09
"Dcu Checking",,U,,09/04/2018,"Safety Insurance","Transportation : Car Insurance","Transportation","Car Insurance","",$768.40,$0.00,$49908.69
"Dcu Checking",,U,207,09/05/2018,"Wangni Tian","Financial Help : Alyssa","Financial Help","Alyssa","",$2085.00,$0.00,$47823.69
"Dcu Checking",,U,,09/07/2018,"Transfer : Discover",,,,"Overpaid balance?",$9.46,$0.00,$47814.23
"Dcu Checking",,U,,09/14/2018,"Deposit","Income : Available next month","Income","Available next month","",$0.00,$279.54,$48093.77
"Dcu Checking",,U,,09/17/2018,"e-ZPass","RV : Tolls","RV","Tolls","",$10.00,$0.00,$48083.77
"Dcu Checking",,U,,09/19/2018,"Wal-mart","Food : Groceries","Food","Groceries","",$56.36,$0.00,$48027.41
"Dcu Checking",,U,,09/19/2018,"irs","income tax : federal","income tax","federal","",$3000.00,$0.00,$45027.41
"Dcu Checking",,U,,09/21/2018,"e-ZPass","RV : Tolls","RV","Tolls","",$10.00,$0.00,$45017.41
"Dcu Checking",,U,,09/24/2018,"Transfer : Lisa Cash Account",,,,"",$80.00,$0.00,$44937.41
"Dcu Checking",,U,,09/26/2018,"google storage","Personal : Miscellaneous","Personal","Miscellaneous","",$1.99,$0.00,$44935.42
"Dcu Checking",,U,,10/01/2018,"Save the children","Charity : Other","Charity","Other","",$31.00,$0.00,$44904.42
"Dcu Checking",,U,209,10/01/2018,"Zach mattei-lownes","Personal : Gifts","Personal","Gifts","",$50.00,$0.00,$44854.42
"Dcu Checking",,U,,10/02/2018,"Bahn","Transportation : Air/train/bus/etc","Transportation","Air/train/bus/etc","",$23.14,$0.00,$44831.28
"Dcu Checking",,U,,10/02/2018,"Bahn","Transportation : Air/train/bus/etc","Transportation","Air/train/bus/etc","",$23.14,$0.00,$44808.14
"Dcu Checking",,U,,10/02/2018,"Bahn","Transportation : Air/train/bus/etc","Transportation","Air/train/bus/etc","",$71.51,$0.00,$44736.63
"Dcu Checking",,U,,10/03/2018,"verizon wireless","RV : Cell Phones and Data","RV","Cell Phones and Data","",$218.29,$0.00,$44518.34
"Dcu Checking",,U,,10/06/2018,"Captain Frosty","Food : Restaurants","Food","Restaurants","",$68.94,$0.00,$44449.40
"Dcu Checking",,U,,10/06/2018,"Transfer : Discover",,,,"",$3008.71,$0.00,$41440.69
"Dcu Checking",,U,,10/09/2018,"Transfer : Target",,,,"",$132.72,$0.00,$41307.97
"Dcu Checking",,U,,10/15/2018,"bank  fee","Personal : BankFee","Personal","BankFee","",$0.75,$0.00,$41307.22
"Dcu Checking",,U,,10/15/2018,"Transfer : Lisa Cash Account",,,,"Ettlingen Withdrawal",$348.29,$0.00,$40958.93
"Dcu Checking",,U,,10/17/2018,"DM Market","Food : Groceries","Food","Groceries","Ettlingen",$16.22,$0.00,$40942.71
"Dcu Checking",,U,,10/17/2018,"Traint ticket","Transportation : Air/train/bus/etc","Transportation","Air/train/bus/etc","Train to Karlshue",$16.27,$0.00,$40926.44
"Dcu Checking",,U,,10/17/2018,"Real","Food : Groceries","Food","Groceries","ettlingen",$34.36,$0.00,$40892.08
"Dcu Checking",,U,,10/17/2018,"casa del guston","Food : Restaurants","Food","Restaurants","ettlingen",$76.47,$0.00,$40815.61
"Dcu Checking",,U,,10/17/2018,"Soki Garden Ettlingen","Food : Restaurants","Food","Restaurants","",$116.24,$0.00,$40699.37
"Dcu Checking",,U,,10/18/2018,"wallstreet","Food : Restaurants","Food","Restaurants","baden baden",$74.93,$0.00,$40624.44
"Dcu Checking",,U,,10/18/2018,"Bahn","Transportation : Air/train/bus/etc","Transportation","Air/train/bus/etc","Train to paris",$279.45,$0.00,$40344.99
"Dcu Checking",,U,,10/20/2018,"Alnatur Produktions","Food : Groceries","Food","Groceries","ettlingen",$48.59,$0.00,$40296.40
"Dcu Checking",,U,,10/22/2018,"bank  fee","Personal : BankFee","Personal","BankFee","",$0.75,$0.00,$40295.65
"Dcu Checking",,U,,10/22/2018,"Schwan Bugplatz","Food : Restaurants","Food","Restaurants","Dusseldorg",$57.68,$0.00,$40237.97
"Dcu Checking",,U,,10/22/2018,"Los Chicos","Food : Restaurants","Food","Restaurants","Dusseldorf",$73.83,$0.00,$40164.14
"Dcu Checking",,U,,10/22/2018,"Transfer : Lisa Cash Account",,,,"Ettlingen",$345.42,$0.00,$39818.72
"Dcu Checking",,U,,10/23/2018,"Total Service Stattion","Food : Restaurants","Food","Restaurants","coffee",$8.76,$0.00,$39809.96
"Dcu Checking",,U,211,10/23/2018,,,,,"",$150.00,$0.00,$39659.96
"Dcu Checking",,U,,10/23/2018,"Derag LH","Recreation : Hotel","Recreation","Hotel","Dusseldorf",$451.00,$0.00,$39208.96
"Dcu Checking",,U,,10/24/2018,"RATP","Transportation : Air/train/bus/etc","Transportation","Air/train/bus/etc","Trains paris",$44.83,$0.00,$39164.13
"Dcu Checking",,U,,10/24/2018,"Le Bastringue Paris","Food : Restaurants","Food","Restaurants","Met teachers from Denver here",$55.53,$0.00,$39108.60
"Dcu Checking",,U,,10/25/2018,"EPML De Dab Aut","Recreation : Entertainment","Recreation","Entertainment","Musee du Louvre tickets",$34.43,$0.00,$39074.17
"Dcu Checking",,U,,10/25/2018,"Eiffel Sufffren","Food : Restaurants","Food","Restaurants","Restaurant near eiffel tower",$70.02,$0.00,$39004.15
"Dcu Checking",,U,,10/26/2018,"google storage","Personal : Miscellaneous","Personal","Miscellaneous","",$1.99,$0.00,$39002.16
"Dcu Checking",,U,,10/26/2018,"Eiffel Tour","Recreation : Entertainment","Recreation","Entertainment","Going up to top of eiffel",$57.17,$0.00,$38944.99
"Dcu Checking",,U,,10/29/2018,"Museen Shops Baden Baden",,,,"",$43.40,$0.00,$38901.59
"Dcu Checking",,U,,10/29/2018,"Pavillion Tinz","Food : Restaurants","Food","Restaurants","Bruschal Germany (Near Palace)",$61.34,$0.00,$38840.25
"Dcu Checking",,U,,10/29/2018,"Au Cygne wissembourg","Food : Restaurants","Food","Restaurants","Restaurant in cute town in france with G&G",$127.93,$0.00,$38712.32
"Dcu Checking",,U,,10/30/2018,"Shceck-in Center","Food : Groceries","Food","Groceries","",$176.78,$0.00,$38535.54
"Dcu Checking",,U,,10/31/2018,"starbucks","Food : Restaurants","Food","Restaurants","stuttgart",$17.60,$0.00,$38517.94
"Dcu Checking",,U,,10/31/2018,"Bahn","Transportation : Air/train/bus/etc","Transportation","Air/train/bus/etc","Train to Frankfort",$68.11,$0.00,$38449.83
"Dcu Checking",,U,,10/31/2018,"Ratsstuben","Food : Restaurants","Food","Restaurants","ettlingen last meal of trip with G&G",$162.86,$0.00,$38286.97
"Dcu Checking",,U,,11/01/2018,"Goc Pho","Food : Restaurants","Food","Restaurants","Vietnamese Frankfort",$29.54,$0.00,$38257.43
"Dcu Checking",,U,,11/01/2018,"Save the children","Charity : Other","Charity","Other","",$31.00,$0.00,$38226.43
"Dcu Checking",,U,,11/01/2018,"Doori Betriebsgesellsc","Food : Restaurants","Food","Restaurants","Frankfort - indian food",$57.38,$0.00,$38169.05
"Dcu Checking",,U,,11/01/2018,"Holiday inn","Food : Restaurants","Food","Restaurants","HR Express in dusseldorf - nice with great breakfast",$112.54,$0.00,$38056.51
"Dcu Checking",,U,,11/01/2018,"verizon wireless","RV : Cell Phones and Data","RV","Cell Phones and Data","",$218.53,$0.00,$37837.98
"Dcu Checking",,U,,11/02/2018,"heinben duty free","Food : Groceries","Food","Groceries","Food for M&D",$17.44,$0.00,$37820.54
"Dcu Checking",,U,,11/05/2018,"agway","Personal : Gifts","Personal","Gifts","",$38.23,$0.00,$37782.31
"Dcu Checking",,U,,11/05/2018,"rite aid","Personal : Prescriptions, Medicine","Personal","Prescriptions, Medicine","",$46.26,$0.00,$37736.05
"Dcu Checking",,U,,11/05/2018,"Bamboo Restaurant","Food : Restaurants","Food","Restaurants","Take out with M&D",$84.96,$0.00,$37651.09
"Dcu Checking",,U,,11/06/2018,"stop & shop","Food : Groceries","Food","Groceries","",$31.09,$0.00,$37620.00
"Dcu Checking",,U,,11/06/2018,"Amazon","RV : Equipment/Supplies","RV","Equipment/Supplies","",$76.32,$0.00,$37543.68
"Dcu Checking",,U,,11/06/2018,"Amazon","RV : Equipment/Supplies","RV","Equipment/Supplies","",$110.85,$0.00,$37432.83
"Dcu Checking",,U,,11/07/2018,"Ma Health Connector","Personal : Health Insurance","Personal","Health Insurance","",$139.82,$0.00,$37293.01
"Dcu Checking",,U,,11/07/2018,"Transfer : Discover",,,,"",$6193.79,$0.00,$31099.22
"Dcu Checking",,U,,11/08/2018,"","Recreation : Entertainment","Recreation","Entertainment","(Split 1/2) Sherri ed Sheeran ticket",$0.00,$100.00,$31249.22
"Dcu Checking",,U,,11/08/2018,"","Income : Available next month","Income","Available next month","(Split 2/2) ",$0.00,$50.00,$31249.22
"Dcu Checking",,U,,11/08/2018,"Hot Topic","Financial Help : Alyssa","Financial Help","Alyssa","",$28.11,$0.00,$31221.11
"Dcu Checking",,U,,11/13/2018,"Shell","RV : gasoline","RV","gasoline","Dupount Pa",$63.94,$0.00,$31157.17
"Dcu Checking",,U,,11/13/2018,"Shell","RV : gasoline","RV","gasoline","Cape Cod",$95.00,$0.00,$31062.17
"Dcu Checking",,U,,11/14/2018,"e-ZPass","RV : Tolls","RV","Tolls","",$10.00,$0.00,$31052.17
"Dcu Checking",,U,,11/15/2018,"Loves gas","RV : gasoline","RV","gasoline","Cheap gs in VA 224.9 used two cards",$9.10,$0.00,$31043.07
"Dcu Checking",,U,,11/15/2018,"Briarcliff RV resort","RV : Campgrounds","RV","Campgrounds","",$454.80,$0.00,$30588.27
"Dcu Checking",,U,,11/19/2018,"Amazon","RV : Equipment/Supplies","RV","Equipment/Supplies","",$0.00,$57.87,$30646.14
"Dcu Checking",,U,,11/20/2018,"parking","Transportation : Parking","Transportation","Parking","",$2.00,$0.00,$30644.14
"Dcu Checking",,U,,11/23/2018,"Fl Parks and REc","RV : Campgrounds","RV","Campgrounds","",$135.60,$0.00,$30508.54
"Dcu Checking",,U,,11/24/2018,"Pilot","RV : gasoline","RV","gasoline","",$11.59,$0.00,$30496.95
"Dcu Checking",,U,,11/26/2018,"google storage","Personal : Miscellaneous","Personal","Miscellaneous","",$1.99,$0.00,$30494.96
"Dcu Checking",,U,213,11/26/2018,"keep it clean RV","RV : Maintenance","RV","Maintenance","Clean and wax at myrtle beach",$300.00,$0.00,$30194.96
"Dcu Checking",,U,,11/30/2018,"bank  fee","Personal : BankFee","Personal","BankFee","",$0.75,$0.00,$30194.21
"Dcu Checking",,U,,11/30/2018,"Transfer : Lisa Cash Account",,,,"",$100.00,$0.00,$30094.21
"Dcu Checking",,U,,12/01/2018,"giant oil","Transportation : Gas","Transportation","Gas","",$12.27,$0.00,$30081.94
"Dcu Checking",,U,,12/03/2018,"Save the children","Charity : Other","Charity","Other","",$31.00,$0.00,$30050.94
"Dcu Checking",,U,214,12/03/2018,"serafine","Personal : Gifts","Personal","Gifts","",$50.00,$0.00,$30000.94
"Dcu Checking",,U,212,12/03/2018,"Normandy Farms","RV : Campgrounds","RV","Campgrounds","",$3693.50,$0.00,$26307.44
"Dcu Checking",,U,,12/04/2018,"verizon wireless","RV : Cell Phones and Data","RV","Cell Phones and Data","",$354.87,$0.00,$25952.57
"Dcu Checking",,U,,12/06/2018,"Transfer : Discover",,,,"",$1389.81,$0.00,$24562.76
"Dcu Checking",,U,,12/10/2018,"bank  fee","Personal : BankFee","Personal","BankFee","",$0.75,$0.00,$24562.01
"Dcu Checking",,U,,12/10/2018,"7-11","Transportation : Gas","Transportation","Gas","",$22.72,$0.00,$24539.29
"Dcu Checking",,U,,12/10/2018,"Ma Health Connector","Personal : Health Insurance","Personal","Health Insurance","",$36.46,$0.00,$24502.83
"Dcu Checking",,U,,12/10/2018,"Transfer : Lisa Cash Account",,,,"",$100.00,$0.00,$24402.83
"Dcu Checking",,U,215,12/12/2018,"Royal Palm Rv","RV : Campgrounds","RV","Campgrounds","",$769.13,$0.00,$23633.70
"Dcu Checking",,U,,12/15/2018,"key west parking","Transportation : Parking","Transportation","Parking","",$9.00,$0.00,$23624.70
"Dcu Checking",,U,,12/17/2018,"bank  fee","Personal : BankFee","Personal","BankFee","",$0.75,$0.00,$23623.95
"Dcu Checking",,U,,12/17/2018,"key west parking","Transportation : Parking","Transportation","Parking","",$32.00,$0.00,$23591.95
"Dcu Checking",,U,,12/17/2018,"Transfer : Lisa Cash Account",,,,"",$100.00,$0.00,$23491.95
"Dcu Checking",,U,,12/22/2018,"bank  fee","Personal : BankFee","Personal","BankFee","",$0.75,$0.00,$23491.20
"Dcu Checking",,U,,12/22/2018,"Transfer : Lisa Cash Account",,,,"",$100.00,$0.00,$23391.20
"Dcu Checking",,U,,12/24/2018,"Amazon","Personal : Gifts","Personal","Gifts","",$64.83,$0.00,$23326.37
"Dcu Checking",,U,217,12/24/2018,"Normandy Farms","RV : Campgrounds","RV","Campgrounds","",$3324.15,$0.00,$20002.22
"Dcu Checking",,U,,12/26/2018,"google storage","Personal : Miscellaneous","Personal","Miscellaneous","",$1.99,$0.00,$20000.23
"Dcu Checking",,U,,12/26/2018,"Harlande Clark","Personal : Miscellaneous","Personal","Miscellaneous","Checks",$25.00,$0.00,$19975.23
"Dcu Checking",,U,219,12/28/2018,"Zach mattei-lownes","Personal : Gifts","Personal","Gifts","",$75.00,$0.00,$19900.23
"Dcu Checking",,U,,12/28/2018,"Boathouse Bar and Grill","Food : Restaurants","Food","Restaurants","With April and Kevin",$100.94,$0.00,$19799.29
"Dcu Checking",,U,,12/31/2018,"bankfee","Personal : BankFee","Personal","BankFee","",$0.75,$0.00,$19798.54
"Dcu Checking",,U,220,12/31/2018,"Anna Mattei","Personal : Gifts","Personal","Gifts","Joshua",$75.00,$0.00,$19723.54
"Dcu Checking",,U,,12/31/2018,"rip of withdrawal / Transfer : Lisa Cash Account",,,,"(Split 1/2) ",$100.00,$0.00,$19617.59
"Dcu Checking",,U,,12/31/2018,"rip of withdrawal",,,,"(Split 2/2) ",$5.95,$0.00,$19617.59
"Dcu Checking",,U,,01/01/2019,"parking miami","Transportation : Parking","Transportation","Parking","",$0.88,$0.00,$19616.71
"Dcu Checking",,U,,01/01/2019,"parking miami","Transportation : Parking","Transportation","Parking","",$5.25,$0.00,$19611.46
"Dcu Checking",,U,,01/02/2019,"Save the children","Charity : Other","Charity","Other","",$31.00,$0.00,$19580.46
"Dcu Checking",,U,,01/03/2019,"verizon wireless","RV : Cell Phones and Data","RV","Cell Phones and Data","",$218.53,$0.00,$19361.93
"Dcu Checking",,U,,01/04/2019,"parking miami","Transportation : Parking","Transportation","Parking","",$1.50,$0.00,$19360.43
"Dcu Checking",,U,,01/04/2019,"parking","Transportation : Parking","Transportation","Parking","",$3.00,$0.00,$19357.43
"Dcu Checking",,U,,01/04/2019,"parking","Transportation : Parking","Transportation","Parking","",$6.00,$0.00,$19351.43
"Dcu Checking",,U,,01/04/2019,"bravo supermarket","Food : Groceries","Food","Groceries","hollywod fl",$68.64,$0.00,$19282.79
"Dcu Checking",,U,,01/07/2019,"Transfer : Discover",,,,"",$5967.63,$0.00,$13315.16
"Dcu Checking",,U,,01/08/2019,"bankfee","Personal : BankFee","Personal","BankFee","",$0.75,$0.00,$13314.41
"Dcu Checking",,U,,01/08/2019,"rip of withdrawal / Transfer : Lisa Cash Account",,,,"(Split 1/2) ",$100.00,$0.00,$13211.41
"Dcu Checking",,U,,01/08/2019,"rip of withdrawal",,,,"(Split 2/2) ",$3.00,$0.00,$13211.41
"Dcu Checking",,U,,01/12/2019,"miami parking","Transportation : Parking","Transportation","Parking","",$3.25,$0.00,$13208.16
"Dcu Checking",,U,,01/12/2019,"miami parking","Transportation : Parking","Transportation","Parking","",$3.25,$0.00,$13204.91
"Dcu Checking",,U,,01/22/2019,"bank  fee","Personal : BankFee","Personal","BankFee","",$0.75,$0.00,$13204.16
"Dcu Checking",,U,,01/22/2019,"Transfer : Lisa Cash Account",,,,"",$100.00,$0.00,$13104.16
"Dcu Checking",,U,,01/22/2019,"Shrimpers","Food : Restaurants","Food","Restaurants","Ben and Loretta",$126.67,$0.00,$12977.49
"Dcu Checking",,U,,01/24/2019,"Ma Health Connector","Personal : Health Insurance","Personal","Health Insurance","",$36.46,$0.00,$12941.03
"Dcu Checking",,U,,01/24/2019,"Shrimpers","Food : Restaurants","Food","Restaurants","Chris Jones B-day Anita) dinner",$124.00,$0.00,$12817.03
"Dcu Checking",,U,,01/26/2019,"google storage","Personal : Miscellaneous","Personal","Miscellaneous","",$1.99,$0.00,$12815.04
"Dcu Checking",,U,216,01/31/2019,"Cliff Lander","Personal : Gifts","Personal","Gifts","",$50.00,$0.00,$12765.04
"Dcu Checking",,U,221,01/31/2019,"Anna Mattei","Personal : Gifts","Personal","Gifts","",$75.00,$0.00,$12690.04
"Dcu Checking",,U,,01/31/2019,"Royal Thai","Food : Restaurants","Food","Restaurants","Mike and Ann - we picked up check",$92.23,$0.00,$12597.81
"Dcu Checking",,U,,02/01/2019,"Save the children","Charity : Other","Charity","Other","",$31.00,$0.00,$12566.81
"Dcu Checking",,U,,02/01/2019,"verizon wireless","RV : Cell Phones and Data","RV","Cell Phones and Data",,$220.09,$0.00,$12346.72
"Dcu Checking",,U,,02/04/2019,"stop & shop","Food : Groceries","Food","Groceries","",$3.99,$0.00,$12342.73
"Dcu Checking",,U,224,02/04/2019,"FL Skp","RV : Campgrounds","RV","Campgrounds","",$149.68,$0.00,$12193.05
"Dcu Checking",,U,222,02/05/2019,"Northside hair","Personal : Miscellaneous","Personal","Miscellaneous","Haircout",$55.00,$0.00,$12138.05
"Dcu Checking",,U,,02/06/2019,"Transfer : Discover",,,,"",$2358.19,$0.00,$9779.86
"Dcu Checking",,U,,02/11/2019,"Pay Pal ETC?","RV : MISC","RV","MISC","Technomedia?",$65.00,$0.00,$9714.86
"Dcu Checking",,U,,02/11/2019,"Transfer : Target",,,,"",$124.57,$0.00,$9590.29
"Dcu Checking",,U,,02/13/2019,"bank  fee","Personal : BankFee","Personal","BankFee","",$0.75,$0.00,$9589.54
"Dcu Checking",,U,,02/13/2019,"Pho Cali","Food : Restaurants","Food","Restaurants","",$35.92,$0.00,$9553.62
"Dcu Checking",,U,,02/13/2019,"Transfer : Lisa Cash Account",,,,"",$100.00,$0.00,$9453.62
"Dcu Checking",,U,,02/15/2019,"Amazon","Personal : Miscellaneous","Personal","Miscellaneous","",$0.08,$0.00,$9453.54
"Dcu Checking",,U,,02/21/2019,"parking","Transportation : Parking","Transportation","Parking","Port Charlotte",$0.75,$0.00,$9452.79
"Dcu Checking",,U,,02/25/2019,"Ma Health Connector","Personal : Health Insurance","Personal","Health Insurance","",$15.46,$0.00,$9437.33
"Dcu Checking",,U,,02/26/2019,"google storage","Personal : Miscellaneous","Personal","Miscellaneous","",$1.99,$0.00,$9435.34
"Dcu Checking",,U,,02/27/2019,"Seeking Alpha","Income : Available next month","Income","Available next month","",$0.00,$104.80,$9540.14
"Dcu Checking",,U,,02/28/2019,"bank fee","Personal : BankFee","Personal","BankFee","",$0.75,$0.00,$9539.39
"Dcu Checking",,U,,02/28/2019,"bank  fee","Personal : BankFee","Personal","BankFee","",$2.00,$0.00,$9537.39
"Dcu Checking",,U,,02/28/2019,"Transfer : Lisa Cash Account",,,,"",$100.00,$0.00,$9437.39
"Dcu Checking",,U,,03/01/2019,"Save the children","Charity : Other","Charity","Other","",$31.00,$0.00,$9406.39
"Dcu Checking",,U,225,03/04/2019,"FL Skp","RV : Campgrounds","RV","Campgrounds","",$565.20,$0.00,$8841.19
"Dcu Checking",,U,,03/05/2019,"verizon wireless","RV : Cell Phones and Data","RV","Cell Phones and Data","",$220.09,$0.00,$8621.10
"Dcu Checking",,U,223,03/05/2019,"Nancy & Dennis","Personal : Gifts","Personal","Gifts","",$300.00,$0.00,$8321.10
"Dcu Checking",,U,,03/07/2019,"Transfer : Target",,,,"",$41.77,$0.00,$8279.33
"Dcu Checking",,U,,03/07/2019,"Transfer : Discover",,,,"",$2762.38,$0.00,$5516.95
"Dcu Checking",,U,,03/12/2019,"bank  fee","Personal : BankFee","Personal","BankFee","",$0.25,$0.00,$5516.70
"Dcu Checking",,U,,03/12/2019,"bankfee","Personal : BankFee","Personal","BankFee","",$0.25,$0.00,$5516.45
"Dcu Checking",,U,,03/12/2019,"Town of Dennis","Transportation : Auto Excise","Transportation","Auto Excise","",$37.50,$0.00,$5478.95
"Dcu Checking",,U,,03/12/2019,"Town of Dennis","RV : excise tax","RV","excise tax","",$661.25,$0.00,$4817.70
"Dcu Checking",,U,,03/14/2019,"Transfer : DCU LTD account",,,,"",$0.00,$10000.00,$14817.70
"Dcu Checking",,U,,03/15/2019,"bank  fee","Personal : BankFee","Personal","BankFee","",$0.75,$0.00,$14816.95
"Dcu Checking",,U,,03/15/2019,"Transfer : Lisa Cash Account",,,,"",$100.00,$0.00,$14716.95
"Dcu Checking",,U,,03/19/2019,"Common Wealth Ma","income tax : state","income tax","state","",$1156.00,$0.00,$13560.95
"Dcu Checking",,U,,03/22/2019,"irs","income tax : federal","income tax","federal","",$0.00,$2022.00,$15582.95
"Dcu Checking",,U,,03/25/2019,"Ma Health Connector","Personal : Health Insurance","Personal","Health Insurance","",$15.46,$0.00,$15567.49
"Dcu Checking",,U,,03/26/2019,"google storage","Personal : Miscellaneous","Personal","Miscellaneous","",$1.99,$0.00,$15565.50
"Dcu Checking",,U,,03/27/2019,"Amazon","Financial Help : Alyssa","Financial Help","Alyssa","Film",$13.75,$0.00,$15551.75
"Dcu Checking",,U,,04/01/2019,"Save the children","Charity : Other","Charity","Other","",$31.00,$0.00,$15520.75
"Dcu Checking",,U,,04/03/2019,"verizon wireless","RV : Cell Phones and Data","RV","Cell Phones and Data",,$220.06,$0.00,$15300.69
"Dcu Checking",,U,,04/04/2019,"newfs","Recreation : Entertainment","Recreation","Entertainment","membership",$75.00,$0.00,$15225.69
"Dcu Checking",,U,,04/05/2019,"Amazon","Recreation : Entertainment","Recreation","Entertainment","PRIME MEMBERSHIP",$119.00,$0.00,$15106.69
"Dcu Checking",,U,,04/06/2019,"Transfer : Discover",,,,"",$1509.69,$0.00,$13597.00
"Dcu Checking",,U,,04/11/2019,"e-ZPass","RV : Tolls","RV","Tolls","",$10.00,$0.00,$13587.00
"Dcu Checking",,U,citgo,04/15/2019,"gasoline","RV : gasoline","RV","gasoline","CT",$79.13,$0.00,$13507.87
"Dcu Checking",,U,,04/18/2019,"e-ZPass","RV : Tolls","RV","Tolls","",$45.00,$0.00,$13462.87
"Dcu Checking",,U,,04/19/2019,"bank  fee","Personal : BankFee","Personal","BankFee","",$3.00,$0.00,$13459.87
"Dcu Checking",,U,,04/19/2019,"Transfer : Lisa Cash Account",,,,"",$200.00,$0.00,$13259.87
"Dcu Checking",,U,,04/24/2019,"Ma Health Connector","Personal : Health Insurance","Personal","Health Insurance","",$15.46,$0.00,$13244.41
"Dcu Checking",,U,226,04/24/2019,"John Hassay","Financial Help : Mom And Dad","Financial Help","Mom And Dad","Electrician at Mom and Dads",$193.00,$0.00,$13051.41
"Dcu Checking",,U,,04/26/2019,"google storage","Personal : Miscellaneous","Personal","Miscellaneous","",$1.99,$0.00,$13049.42
"Dcu Checking",,U,,04/26/2019,"silk road bistro","Food : Restaurants","Food","Restaurants","",$21.60,$0.00,$13027.82
"Dcu Checking",,U,,04/29/2019,"Brookline Mass","Transportation : Parking","Transportation","Parking","",$1.05,$0.00,$13026.77
"Dcu Checking",,U,,04/29/2019,"Brookline Mass","Transportation : Parking","Transportation","Parking","",$2.80,$0.00,$13023.97
"Dcu Checking",,U,,05/01/2019,"Save the children","Charity : Other","Charity","Other","",$31.00,$0.00,$12992.97
"Dcu Checking",,U,,05/01/2019,"verizon wireless","RV : Cell Phones and Data","RV","Cell Phones and Data","",$219.94,$0.00,$12773.03
"Dcu Checking",,U,,05/07/2019,"Transfer : Discover",,,,"",$3680.86,$0.00,$9092.17
"Dcu Checking",,U,227,05/17/2019,"MPIUA","Financial Help : Mom And Dad","Financial Help","Mom And Dad","House Ins",$1329.00,$0.00,$7763.17
"Dcu Checking",,U,,05/20/2019,"Transfer : DCU LTD account",,,,"",$0.00,$10000.00,$17763.17
"Dcu Checking",,U,,05/21/2019,"Pho Viets","Food : Restaurants","Food","Restaurants","",$47.00,$0.00,$17716.17
"Dcu Checking",,U,,05/24/2019,"Ma Health Connector","Personal : Health Insurance","Personal","Health Insurance","",$15.46,$0.00,$17700.71
"Dcu Checking",,U,,05/25/2019,"Captain Frosty","Food : Restaurants","Food","Restaurants",,$71.89,$0.00,$17628.82
"Dcu Checking",,U,,05/28/2019,"google storage","Personal : Miscellaneous","Personal","Miscellaneous","",$1.99,$0.00,$17626.83
"Dcu Checking",,U,,05/30/2019,"Pumpkin Brook","Income : Available next month","Income","Available next month","",$0.00,$666.40,$18293.23
"Dcu Checking",,U,,06/01/2019,"silk road bistro","Food : Restaurants","Food","Restaurants","",$53.23,$0.00,$18240.00
"Dcu Checking",,U,,06/03/2019,"Deposit","Income : Available next month","Income","Available next month","",$0.00,$1220.00,$19460.00
"Dcu Checking",,U,,06/03/2019,"Save the children","Charity : Other","Charity","Other","",$31.00,$0.00,$19429.00
"Dcu Checking",,U,,06/03/2019,"Transfer : Lisa Cash Account",,,,"",$200.00,$0.00,$19229.00
"Dcu Checking",,U,,06/03/2019,"verizon wireless","RV : Cell Phones and Data","RV","Cell Phones and Data",,$219.94,$0.00,$19009.06
"Dcu Checking",,U,228,06/04/2019,"Cliff Lander","Personal : Gifts","Personal","Gifts","",$100.00,$0.00,$18909.06
"Dcu Checking",,U,,06/06/2019,"Transfer : Discover",,,,"",$3466.07,$0.00,$15442.99
"Dcu Checking",,U,,06/10/2019,"Common Wealth Ma","income tax : state","income tax","state","",$34.09,$0.00,$15408.90
"Dcu Checking",,U,,06/10/2019,"Transfer : Target",,,,"",$74.53,$0.00,$15334.37
"Dcu Checking",,U,,06/12/2019,"income","Income : Available next month","Income","Available next month","",$0.00,$513.73,$15848.10
"Dcu Checking",,U,,06/12/2019,"e-ZPass","RV : Tolls","RV","Tolls","",$10.00,$0.00,$15838.10
"Dcu Checking",,U,,06/12/2019,"Shell","Transportation : Gas","Transportation","Gas","Wrentham",$27.17,$0.00,$15810.93
"Dcu Checking",,U,,06/12/2019,"delivery.com","Food : Restaurants","Food","Restaurants","Indian place in roslindale",$75.12,$0.00,$15735.81
"Dcu Checking",,U,,06/14/2019,"Transfer : Lisa Cash Account",,,,"",$200.00,$0.00,$15535.81
"Dcu Checking",,U,,06/15/2019,"Shell","Transportation : Gas","Transportation","Gas","Wrentham",$20.16,$0.00,$15515.65
"Dcu Checking",,U,,06/15/2019,"Pan Mass Challenge","Charity : Other","Charity","Other","DON",$25.56,$0.00,$15490.09
"Dcu Checking",,U,,06/15/2019,"Inidan Market Shrewsbury","Food : Groceries","Food","Groceries","",$79.06,$0.00,$15411.03
"Dcu Checking",,U,,06/17/2019,"Trombetta","RV : MISC","RV","MISC","plants",$11.98,$0.00,$15399.05
"Dcu Checking",,U,,06/17/2019,"Trombetta","Food : Restaurants","Food","Restaurants","",$19.22,$0.00,$15379.83
"Dcu Checking",,U,,06/20/2019,"Deposit","Income : Available next month","Income","Available next month","",$0.00,$846.27,$16226.10
"Dcu Checking",,U,,06/20/2019,"Sunoco","Transportation : Gas","Transportation","Gas","Medfield",$23.12,$0.00,$16202.98
"Dcu Checking",,U,,06/20/2019,"Transfer : Lisa Cash Account",,,,"",$150.00,$0.00,$16052.98
"Dcu Checking",,U,,06/24/2019,"Ma Health Connector","Personal : Health Insurance","Personal","Health Insurance",,$15.46,$0.00,$16037.52
"Dcu Checking",,U,,06/26/2019,"Pumpkin Brook","Income : Available next month","Income","Available next month","",$0.00,$512.06,$16549.58
"Dcu Checking",,U,,06/26/2019,"google storage","Personal : Miscellaneous","Personal","Miscellaneous","",$1.99,$0.00,$16547.59
"Dcu Checking",,U,,06/26/2019,"Common Wealth Ma","income tax : state","income tax","state","",$1000.00,$0.00,$15547.59
"Dcu Checking",,U,,06/26/2019,"irs","income tax : federal","income tax","federal",,$1000.00,$0.00,$14547.59
"Dcu Checking",,U,,07/01/2019,"Save the children","Charity : Other","Charity","Other",,$31.00,$0.00,$14516.59
"Dcu Checking",,U,,07/03/2019,"verizon wireless","RV : Cell Phones and Data","RV","Cell Phones and Data","",$219.94,$0.00,$14296.65
"Dcu Checking",,U,230,07/05/2019,"Primary Care Cape Cod","Personal : Doctor, Dentist","Personal","Doctor, Dentist","",$10.00,$0.00,$14286.65
"Dcu Checking",,U,,07/06/2019,"Transfer : Discover",,,,"",$4544.46,$0.00,$9742.19
"Dcu Checking",,U,229,07/08/2019,"Pumpkin Brook","Personal : Miscellaneous","Personal","Miscellaneous","Plants",$15.40,$0.00,$9726.79
"Dcu Checking",,U,,07/10/2019,"Transfer : Target",,,,"",$67.66,$0.00,$9659.13
"Dcu Checking",,U,,07/11/2019,"Pumpkin Brook","Income : Available next month","Income","Available next month","",$0.00,$569.95,$10229.08
"Dcu Checking",,U,,07/15/2019,"Transfer : Lisa Cash Account",,,,"",$200.00,$0.00,$10029.08
"Dcu Checking",,U,,07/17/2019,"Godaddy","Personal : Miscellaneous","Personal","Miscellaneous","",$18.17,$0.00,$10010.91
"Dcu Checking",,U,,07/22/2019,"e-ZPass","RV : Tolls","RV","Tolls","",$10.00,$0.00,$10000.91
"Dcu Checking",,U,,07/24/2019,"Ma Health Connector","Personal : Health Insurance","Personal","Health Insurance","",$36.46,$0.00,$9964.45
"Dcu Checking",,U,,07/25/2019,"Pumpkin Brook","Income : Available next month","Income","Available next month","",$0.00,$560.30,$10524.75
"Dcu Checking",,U,,07/26/2019,"google storage","Personal : Miscellaneous","Personal","Miscellaneous","",$1.99,$0.00,$10522.76
"Dcu Checking",,U,,08/01/2019,"Save the children","Charity : Other","Charity","Other","",$31.00,$0.00,$10491.76
"Dcu Checking",,U,,08/01/2019,"verizon wireless","RV : Cell Phones and Data","RV","Cell Phones and Data","",$220.57,$0.00,$10271.19
"Dcu Checking",,U,,08/02/2019,"Safety Insurance","Transportation : Car Insurance","Transportation","Car Insurance","",$95.00,$0.00,$10176.19
"Dcu Checking",,U,,08/03/2019,"Transfer : DCU LTD account",,,,"",$0.00,$7500.00,$17676.19
"Dcu Checking",,U,,08/06/2019,"Transfer : Discover",,,,"",$3105.73,$0.00,$14570.46
"Dcu Checking",,U,,08/08/2019,"Pumpkin Brook","Income : Available next month","Income","Available next month","",$0.00,$526.54,$15097.00
"Dcu Checking",,U,,08/12/2019,"ma audobon","Recreation : Entertainment","Recreation","Entertainment","",$8.00,$0.00,$15089.00
"Dcu Checking",,U,,08/12/2019,"Transfer : Target",,,,"",$20.51,$0.00,$15068.49
"Dcu Checking",,U,,08/12/2019,"Transfer : Lisa Cash Account",,,,"",$100.00,$0.00,$14968.49
"Dcu Checking",,U,,08/21/2019,"Denielle McIntosh","Personal : Gifts","Personal","Gifts","Wedding",$100.00,$0.00,$14868.49
"Dcu Checking",,U,,08/22/2019,"Pumpkin Brook","Income : Available next month","Income","Available next month","",$0.00,$541.00,$15409.49
"Dcu Checking",,U,,08/24/2019,"Transfer : Lisa Cash Account",,,,"",$100.00,$0.00,$15309.49
"Dcu Checking",,U,,08/26/2019,"google storage","Personal : Miscellaneous","Personal","Miscellaneous","",$1.99,$0.00,$15307.50
"Dcu Checking",,U,,08/26/2019,"Ma Health Connector","Personal : Health Insurance","Personal","Health Insurance",,$170.00,$0.00,$15137.50
"Dcu Checking",,U,,08/29/2019,"e-ZPass","RV : Tolls","RV","Tolls",,$10.00,$0.00,$15127.50
"Dcu Checking",,U,,08/29/2019,"Dumpling House","Food : Restaurants","Food","Restaurants","",$48.66,$0.00,$15078.84
"Dcu Checking",,U,,08/30/2019,"Safety Insurance","Transportation : Car Insurance","Transportation","Car Insurance","",$400.00,$0.00,$14678.84
"Dcu Checking",,U,,09/03/2019,"save a lot","Food : Groceries","Food","Groceries","",$31.00,$0.00,$14647.84
"Dcu Checking",,U,,09/04/2019,"verizon wireless","RV : Cell Phones and Data","RV","Cell Phones and Data","",$222.43,$0.00,$14425.41
"Dcu Checking",,U,,09/05/2019,"Pumpkin Brook","Income : Available next month","Income","Available next month","",$0.00,$492.78,$14918.19
"Dcu Checking",,U,,09/05/2019,"Transfer : Lisa Cash Account",,,,"",$200.00,$0.00,$14718.19
"Dcu Checking",,U,,09/06/2019,"Transfer : Discover",,,,"",$2400.60,$0.00,$12317.59
"Dcu Checking",,U,,09/09/2019,"Transfer : Target",,,,"",$22.06,$0.00,$12295.53
"Dcu Checking",,U,,09/09/2019,"Transfer : Lisa Cash Account",,,,"",$100.00,$0.00,$12195.53
"Dcu Checking",,U,,09/19/2019,"Pumpkin Brook","Income : Available next month","Income","Available next month","",$0.00,$526.54,$12722.07
"Dcu Checking",,U,,09/23/2019,"tufts health care Reimbursement","Personal : Health Insurance","Personal","Health Insurance","",$0.00,$822.24,$13544.31
"Dcu Checking",,U,,09/23/2019,"Kate Campos","Personal : Gifts","Personal","Gifts","",$25.00,$0.00,$13519.31
"Dcu Checking",,U,,09/24/2019,"Ma Health Connector","Personal : Health Insurance","Personal","Health Insurance",,$170.00,$0.00,$13349.31
"Dcu Checking",,U,,09/27/2019,"google storage","Personal : Miscellaneous","Personal","Miscellaneous","",$1.99,$0.00,$13347.32
"Dcu Checking",,U,,10/01/2019,"Save the children","Charity : Other","Charity","Other","",$31.00,$0.00,$13316.32
"Dcu Checking",,U,,10/02/2019,"verizon wireless","RV : Cell Phones and Data","RV","Cell Phones and Data","",$222.43,$0.00,$13093.89
"Dcu Checking",,U,,10/03/2019,"Pumpkin Brook","Income : Available next month","Income","Available next month","",$0.00,$632.86,$13726.75
"Dcu Checking",,U,,10/04/2019,"Rons Ice Cream","Food : Restaurants","Food","Restaurants","",$14.84,$0.00,$13711.91
"Dcu Checking",,U,,10/04/2019,"Needham driving school","Financial Help : Alyssa","Financial Help","Alyssa","",$65.00,$0.00,$13646.91
"Dcu Checking",,U,,10/04/2019,"Safety Insurance","Transportation : Car Insurance","Transportation","Car Insurance","",$467.00,$0.00,$13179.91
"Dcu Checking",,U,,10/06/2019,"Transfer : Discover",,,,"",$2991.73,$0.00,$10188.18
"Dcu Checking",,U,,10/09/2019,"Transfer : Lisa Cash Account",,,,"",$80.00,$0.00,$10108.18
"Dcu Checking",,U,,10/10/2019,"Transfer : Target",,,,"",$174.69,$0.00,$9933.49
"Dcu Checking",,U,,10/17/2019,"Pumpkin Brook","Income : Available next month","Income","Available next month","",$0.00,$548.32,$10481.81
"Dcu Checking",,U,,10/21/2019,"Needham driving school","Financial Help : Alyssa","Financial Help","Alyssa","",$0.00,$65.00,$10546.81
"Dcu Checking",,U,235,10/21/2019,"Champion Tree","Financial Help : Mom And Dad","Financial Help","Mom And Dad","",$400.00,$0.00,$10146.81
"Dcu Checking",,U,,10/21/2019,"Pumpkin Brook","Income : Available next month","Income","Available next month","",$548.32,$0.00,$9598.49
"Dcu Checking",,U,,10/22/2019,"Transfer : Lisa Cash Account",,,,"",$100.00,$0.00,$9498.49
"Dcu Checking",,U,,10/24/2019,"Ma Health Connector","Personal : Health Insurance","Personal","Health Insurance","",$170.00,$0.00,$9328.49
"Dcu Checking",,U,,10/25/2019,"Little big diner newton","Food : Restaurants","Food","Restaurants","",$65.00,$0.00,$9263.49
"Dcu Checking",,U,,10/26/2019,"google storage","Personal : Miscellaneous","Personal","Miscellaneous","",$1.99,$0.00,$9261.50
"Dcu Checking",,U,,10/28/2019,"Pizza by evan","Food : Restaurants","Food","Restaurants","",$31.03,$0.00,$9230.47
"Dcu Checking",,U,234,10/28/2019,"Zach mattei-lownes","Personal : Gifts","Personal","Gifts","Birthday!!",$50.00,$0.00,$9180.47
"Dcu Checking",,U,,10/31/2019,"comellas","Food : Restaurants","Food","Restaurants","Not great Food - but our last visit with Alyssa before we go",$37.95,$0.00,$9142.52
"Dcu Checking",,U,,11/01/2019,"e-ZPass","RV : Tolls","RV","Tolls","",$10.00,$0.00,$9132.52
"Dcu Checking",,U,,11/01/2019,"Save the children","Charity : Other","Charity","Other","",$31.00,$0.00,$9101.52
"Dcu Checking",,U,,11/01/2019,"verizon wireless","RV : Cell Phones and Data","RV","Cell Phones and Data",,$222.46,$0.00,$8879.06
"Dcu Checking",,U,,11/02/2019,"Sunoco Hawley PA","RV : gasoline","RV","gasoline","",$110.22,$0.00,$8768.84
"Dcu Checking",,U,238,11/04/2019,"Anna Mattei","Personal : Gifts","Personal","Gifts","For Josh",$50.00,$0.00,$8718.84
"Dcu Checking",,U,,11/05/2019,"e-ZPass","RV : Tolls","RV","Tolls","",$45.00,$0.00,$8673.84
"Dcu Checking",,U,,11/07/2019,"Transfer : DCU LTD account",,,,"",$0.00,$11000.00,$19673.84
"Dcu Checking",,U,,11/07/2019,"Transfer : Discover",,,,"",$3200.73,$0.00,$16473.11
"Dcu Checking",,U,239,11/12/2019,,,,,"",$0.00,$0.00,$16473.11
"Dcu Checking",,U,,11/12/2019,"MS dept of wildlife","Recreation : Entertainment","Recreation","Entertainment","State Park Fee",$4.00,$0.00,$16469.11
"Dcu Checking",,U,,11/12/2019,"Transfer : Target",,,,"",$88.56,$0.00,$16380.55
"Dcu Checking",,U,,11/12/2019,"Kelly Matteri","Personal : Gifts","Personal","Gifts","House Warming",$100.00,$0.00,$16280.55
"Dcu Checking",,U,236,11/12/2019,"stephen matter","Personal : Gifts","Personal","Gifts","Wedding gift",$500.00,$0.00,$15780.55
"Dcu Checking",,U,,11/14/2019,"Transfer : Lisa Cash Account",,,,"",$202.50,$0.00,$15578.05
"Dcu Checking",,U,,11/16/2019,"Dollar general","RV : Equipment/Supplies","RV","Equipment/Supplies","Belmont MS",$27.60,$0.00,$15550.45
"Dcu Checking",,U,242,11/16/2019,"Tiffine","RV : Maintenance","RV","Maintenance","Jerry and Chris work at TIFFIN",$1043.28,$0.00,$14507.17
"Dcu Checking",,U,245,11/25/2019,"J.B.s RV","RV : Campgrounds","RV","Campgrounds","",$35.00,$0.00,$14472.17
"Dcu Checking",,U,244,11/25/2019,"serafine","Personal : Gifts","Personal","Gifts","Birthday",$50.00,$0.00,$14422.17
"Dcu Checking",,U,,11/25/2019,"Ma Health Connector","Personal : Health Insurance","Personal","Health Insurance","",$170.00,$0.00,$14252.17
"Dcu Checking",,U,,11/27/2019,"google storage","Personal : Miscellaneous","Personal","Miscellaneous","",$1.99,$0.00,$14250.18
"Dcu Checking",,U,243,11/27/2019,"Belmont RV","RV : Campgrounds","RV","Campgrounds","",$25.00,$0.00,$14225.18
"Dcu Checking",,U,,11/27/2019,"redbubble","Personal : Gifts","Personal","Gifts","",$26.96,$0.00,$14198.22
"Dcu Checking",,U,247,11/27/2019,"Lake Park Campground","RV : Campgrounds","RV","Campgrounds","GREAT DISC GOLF COURSE and only 11:00 for seniros Lewsiville TX",$33.00,$0.00,$14165.22
"Dcu Checking",,U,241,11/27/2019,"Belmont RV","RV : Campgrounds","RV","Campgrounds","Belmont Alabama",$50.00,$0.00,$14115.22
"Dcu Checking",,U,240,11/27/2019,"Belmont RV","RV : Campgrounds","RV","Campgrounds","",$250.00,$0.00,$13865.22
"Dcu Checking",,U,,11/30/2019,"baystate Physcial therapy","Personal : Doctor, Dentist","Personal","Doctor, Dentist","",$20.00,$0.00,$13845.22
"Dcu Checking",,U,,11/30/2019,"Parking ticket","Lisa Business : Parking","Lisa Business","Parking","Burnt in Dallas",$45.00,$0.00,$13800.22
"Dcu Checking",,U,,12/02/2019,"Cheveron","Transportation : Gas","Transportation","Gas","",$20.09,$0.00,$13780.13
"Dcu Checking",,U,,12/02/2019,"Save the children","Charity : Other","Charity","Other","",$31.00,$0.00,$13749.13
"Dcu Checking",,U,,12/04/2019,"verizon wireless","RV : Cell Phones and Data","RV","Cell Phones and Data",,$222.46,$0.00,$13526.67
"Dcu Checking",,U,,12/06/2019,"Transfer : Lisa Cash Account",,,,"",$120.00,$0.00,$13406.67
"Dcu Checking",,U,,12/06/2019,"Transfer : Discover",,,,"",$3028.02,$0.00,$10378.65
"Dcu Checking",,U,,12/07/2019,"La Hacienda Rv Resort Apache junction","RV : Campgrounds","RV","Campgrounds","",$250.00,$0.00,$10128.65
"Dcu Checking",,U,,12/09/2019,"CoinMach","RV : Laundry","RV","Laundry","",$12.00,$0.00,$10116.65
"Dcu Checking",,U,,12/09/2019,"Transfer : Target",,,,"",$250.19,$0.00,$9866.46
"Dcu Checking",,U,,12/14/2019,"costoc","Food : Groceries","Food","Groceries","",$131.44,$0.00,$9735.02
"Dcu Checking",,U,,12/16/2019,"Transfer : Lisa Cash Account",,,,"",$200.00,$0.00,$9535.02
"Dcu Checking",,U,,12/17/2019,"Ma Health Connector","Personal : Health Insurance","Personal","Health Insurance","",$5.45,$0.00,$9529.57
"Dcu Checking",,U,,12/17/2019,"costco","RV : Equipment/Supplies","RV","Equipment/Supplies","New Mattress",$559.53,$0.00,$8970.04
"Dcu Checking",,U,,12/19/2019,"Texas alcohol","Food : Groceries","Food","Groceries","Tax on Liquor from mexico",$15.50,$0.00,$8954.54
"Dcu Checking",,U,,12/19/2019,"El Disco Super Center","Food : Groceries","Food","Groceries","(Split 1/2) liqour / Liqour progresso mexico",$22.00,$0.00,$8908.14
"Dcu Checking",,U,,12/19/2019,"El Disco Super Center","Personal : Gifts","Personal","Gifts","(Split 2/2) liquour / Liqour progresso mexico",$24.40,$0.00,$8908.14
"Dcu Checking",,U,253,12/19/2019,"Dr J Xavier","Personal : Doctor, Dentist","Personal","Doctor, Dentist","teeth cleaning mexico",$50.00,$0.00,$8858.14
"Dcu Checking",,U,249,12/19/2019,"serafine","Personal : Gifts","Personal","Gifts","xmax",$75.00,$0.00,$8783.14
"Dcu Checking",,U,251,12/19/2019,"Anna Mattei","Personal : Gifts","Personal","Gifts","xmax for josh",$75.00,$0.00,$8708.14
"Dcu Checking",,U,246,12/23/2019,"Fau tulsa","Food : Groceries","Food","Groceries","farmers market texas",$44.00,$0.00,$8664.14
"Dcu Checking",,U,,12/26/2019,"google storage","Personal : Miscellaneous","Personal","Miscellaneous","",$1.99,$0.00,$8662.15
"Dcu Checking",,U,,12/27/2019,"Ancient Oaks Rv park","RV : Campgrounds","RV","Campgrounds","",$189.00,$0.00,$8473.15
"Dcu Checking",,U,,12/29/2019,"Transfer : DCU LTD account",,,,"",$0.00,$7000.00,$15473.15
"Dcu Checking",,U,252,12/31/2019,"Auot Masters","Transportation : Repairs & Maintenance","Transportation","Repairs & Maintenance","oil change harlingen",$34.10,$0.00,$15439.05
"Dcu Checking",,U,250,12/31/2019,"Zach mattei-lownes","Personal : Gifts","Personal","Gifts","christmas",$75.00,$0.00,$15364.05
"Dcu Checking",,U,,01/02/2020,"Save the children","Charity : Other","Charity","Other","",$31.00,$0.00,$15333.05
"Dcu Checking",,U,,01/02/2020,"verizon wireless","RV : Cell Phones and Data","RV","Cell Phones and Data","",$222.46,$0.00,$15110.59
"Dcu Checking",,U,254,01/03/2020,"Mom and dad","Financial Help : Mom And Dad","Financial Help","Mom And Dad","",$2000.00,$0.00,$13110.59
"Dcu Checking",,U,255,01/06/2020,"alomo area coop","RV : Campgrounds","RV","Campgrounds","",$21.50,$0.00,$13089.09
"Dcu Checking",,U,248,01/07/2020,"Isalbel Nunex","Personal : Gifts","Personal","Gifts","birthday",$50.00,$0.00,$13039.09
"Dcu Checking",,U,,01/07/2020,"Transfer : Discover",,,,"",$4319.59,$0.00,$8719.50
"Dcu Checking",,U,,01/13/2020,"bankfee","Personal : BankFee","Personal","BankFee","",$3.00,$0.00,$8716.50
"Dcu Checking",,U,,01/13/2020,"porters thriftway","Food : Groceries","Food","Groceries","",$70.21,$0.00,$8646.29
"Dcu Checking",,U,,01/13/2020,"Transfer : Lisa Cash Account",,,,"",$200.00,$0.00,$8446.29
"Dcu Checking",,U,,01/18/2020,"midland van horn","RV : gasoline","RV","gasoline","",$20.15,$0.00,$8426.14
"Dcu Checking",,U,,01/21/2020,"Museum of big bend","Personal : Gifts","Personal","Gifts","",$21.65,$0.00,$8404.49
"Dcu Checking",,U,,01/21/2020,"Tx State Parks","RV : Campgrounds","RV","Campgrounds","",$68.00,$0.00,$8336.49
"Dcu Checking",,U,,01/24/2020,"Ma Health Connector","Personal : Health Insurance","Personal","Health Insurance",,$5.45,$0.00,$8331.04
"Dcu Checking",,U,,01/27/2020,"google storage","Personal : Miscellaneous","Personal","Miscellaneous","",$1.99,$0.00,$8329.05
"Dcu Checking",,U,,01/28/2020,"bank fee","Personal : BankFee","Personal","BankFee","",$2.50,$0.00,$8326.55
"Dcu Checking",,U,,01/28/2020,"Transfer : Lisa Cash Account",,,,"",$100.00,$0.00,$8226.55
"Dcu Checking",,U,,02/03/2020,"Save the children","Charity : Other","Charity","Other","",$31.00,$0.00,$8195.55
"Dcu Checking",,U,,02/03/2020,"verizon wireless","RV : Cell Phones and Data","RV","Cell Phones and Data",,$222.13,$0.00,$7973.42
"Dcu Checking",,U,,02/05/2020,"sbsc incorma","Personal : Gifts","Personal","Gifts","",$4.00,$0.00,$7969.42
"Dcu Checking",,U,,02/05/2020,"KARTCHNER CAVERNS","Recreation : Entertainment","Recreation","Entertainment","with Karina",$46.00,$0.00,$7923.42
"Dcu Checking",,U,,02/05/2020,"Transfer : Lisa Cash Account",,,,"",$80.00,$0.00,$7843.42
"Dcu Checking",,U,,02/06/2020,"Transfer : Discover",,,,"",$2187.09,$0.00,$5656.33
"Dcu Checking",,U,,02/07/2020,"Transfer : DCU LTD account",,,,"",$0.00,$5500.00,$11156.33
"Dcu Checking",,U,,02/07/2020,"Transfer : Lisa Cash Account",,,,"",$120.00,$0.00,$11036.33
"Dcu Checking",,U,256,02/10/2020,"Cactus Wrens","Food : Restaurants","Food","Restaurants","",$14.00,$0.00,$11022.33
"Dcu Checking",,U,,02/11/2020,"techomedia","RV : MISC","RV","MISC","",$65.00,$0.00,$10957.33
"Dcu Checking",,U,,02/11/2020,"Transfer : Lisa Cash Account",,,,"",$80.00,$0.00,$10877.33
"Dcu Checking",,U,,02/14/2020,"Deposit","Income : Available next month","Income","Available next month","",$0.00,$500.00,$11377.33
"Dcu Checking",,U,,02/24/2020,"Ma Health Connector","Personal : Health Insurance","Personal","Health Insurance","",$5.45,$0.00,$11371.88
"Dcu Checking",,U,,02/26/2020,"google storage","Personal : Miscellaneous","Personal","Miscellaneous","",$1.99,$0.00,$11369.89
"Dcu Checking",,U,,02/26/2020,"bread and butter cafe","Food : Restaurants","Food","Restaurants","",$35.76,$0.00,$11334.13
"Dcu Checking",,U,,03/02/2020,"Transfer : DCU LTD account",,,,"",$0.00,$5000.00,$16334.13
"Dcu Checking",,U,,03/02/2020,"Save the children","Charity : Other","Charity","Other","",$31.00,$0.00,$16303.13
"Dcu Checking",,U,257,03/02/2020,"Mescal auto","RV : Maintenance","RV","Maintenance","Oil change",$151.61,$0.00,$16151.52
"Dcu Checking",,U,,03/04/2020,"verizon wireless","RV : Cell Phones and Data","RV","Cell Phones and Data","",$222.13,$0.00,$15929.39
"Dcu Checking",,U,,03/06/2020,"Transfer : Discover",,,,"",$3950.99,$0.00,$11978.40
"Dcu Checking",,U,,03/07/2020,"Transfer : Lisa Cash Account",,,,"",$100.00,$0.00,$11878.40
"Dcu Checking",,U,258,03/11/2020,"La Hacienda Rv Resort Apache junction","RV : Campgrounds","RV","Campgrounds","",$529.50,$0.00,$11348.90
"Dcu Checking",,U,,03/16/2020,"Transfer : Lisa Cash Account",,,,"",$80.00,$0.00,$11268.90
"Dcu Checking",,U,,03/17/2020,"bank  fee","Personal : BankFee","Personal","BankFee","FOR EXCISE TAX",$0.50,$0.00,$11268.40
"Dcu Checking",,U,,03/17/2020,"Town of Dennis","Transportation : Auto Excise","Transportation","Auto Excise","",$37.25,$0.00,$11231.15
"Dcu Checking",,U,,03/17/2020,"Town of Dennis","RV : excise tax","RV","excise tax","",$264.55,$0.00,$10966.60
"Dcu Checking",,U,,03/24/2020,"Ma Health Connector","Personal : Health Insurance","Personal","Health Insurance","",$5.45,$0.00,$10961.15
"Dcu Checking",,U,,03/26/2020,"google storage","Personal : Miscellaneous","Personal","Miscellaneous","",$1.99,$0.00,$10959.16
"Dcu Checking",,U,,03/27/2020,"IRS  tax refund","Income : Available next month","Income","Available next month","",$0.00,$494.00,$11453.16
"Dcu Checking",,U,259,04/01/2020,"Anna Mattei","Personal : Gifts","Personal","Gifts","For Antonia",$30.00,$0.00,$11423.16
"Dcu Checking",,U,,04/01/2020,"Save the children","Charity : Other","Charity","Other","",$31.00,$0.00,$11392.16
"Dcu Checking",,U,,04/01/2020,"verizon wireless","RV : Cell Phones and Data","RV","Cell Phones and Data",,$222.13,$0.00,$11170.03
"Dcu Checking",,U,,04/07/2020,"Transfer : Discover",,,,"",$2364.62,$0.00,$8805.41
"Dcu Checking",,U,262,04/08/2020,"Anna Mattei","Personal : Gifts","Personal","Gifts","Birthday",$100.00,$0.00,$8705.41
"Dcu Checking",,U,,04/09/2020,"IRS  tax refund","Income : Available next month","Income","Available next month","MONEY FOR GOV CORONA",$0.00,$2400.00,$11105.41
"Dcu Checking",,U,,04/09/2020,"La Hacienda Rv Resort Apache junction","RV : Campgrounds","RV","Campgrounds","For April 2020",$759.50,$0.00,$10345.91
"Dcu Checking",,U,,04/24/2020,"Ma Health Connector","Personal : Health Insurance","Personal","Health Insurance","",$5.45,$0.00,$10340.46
"Dcu Checking",,U,,04/27/2020,"google storage","Personal : Miscellaneous","Personal","Miscellaneous","",$1.99,$0.00,$10338.47
"Dcu Checking",,U,,05/01/2020,"Save the children","Charity : Other","Charity","Other","",$31.00,$0.00,$10307.47
"Dcu Checking",,U,,05/04/2020,"verizon wireless","RV : Cell Phones and Data","RV","Cell Phones and Data",,$221.95,$0.00,$10085.52
"Dcu Checking",,U,,05/07/2020,"Transfer : Discover",,,,"",$1928.75,$0.00,$8156.77
"Dcu Checking",,U,,05/11/2020,"e-ZPass","RV : Tolls","RV","Tolls","",$45.00,$0.00,$8111.77
"Dcu Checking",,U,,05/12/2020,"Transfer : Etrade Taxable",,,,"",$0.00,$100.00,$8211.77
"Dcu Checking",,U,,05/12/2020,"e-ZPass","RV : Tolls","RV","Tolls","",$45.00,$0.00,$8166.77
"Dcu Checking",,U,263,05/13/2020,"Anna Mattei","Financial Help : Matteis","Financial Help","Matteis","Check for anna",$1000.00,$0.00,$7166.77
"Dcu Checking",,U,,05/14/2020,"Transfer : Etrade Taxable",,,,"",$0.00,$2000.00,$9166.77
"Dcu Checking",,U,265,05/21/2020,"Luke Lander","Personal : Gifts","Personal","Gifts","",$100.00,$0.00,$9066.77
"Dcu Checking",,U,,05/26/2020,"google storage","Personal : Miscellaneous","Personal","Miscellaneous","",$1.99,$0.00,$9064.78
"Dcu Checking",,U,,05/26/2020,"Ma Health Connector","Personal : Health Insurance","Personal","Health Insurance",,$5.45,$0.00,$9059.33
"Dcu Checking",,U,264,05/26/2020,"La Hacienda Rv Resort Apache junction","RV : Campgrounds","RV","Campgrounds","",$102.47,$0.00,$8956.86
"Dcu Checking",,U,,05/28/2020,"Sweetwater  Pay","Income : Available next month","Income","Available next month","",$0.00,$335.38,$9292.24
"Dcu Checking",,U,,05/28/2020,"Sweetwater  Pay","Income : Available this month","Income","Available this month","",$0.00,$309.07,$9601.31
"Dcu Checking",,U,,06/01/2020,"Save the children","Charity : Other","Charity","Other","",$31.00,$0.00,$9570.31
"Dcu Checking",,U,267,06/03/2020,"Cliff Lander","Personal : Gifts","Personal","Gifts",,$110.00,$0.00,$9460.31
"Dcu Checking",,U,,06/03/2020,"verizon wireless","RV : Cell Phones and Data","RV","Cell Phones and Data",,$221.95,$0.00,$9238.36
"Dcu Checking",,U,,06/04/2020,"Sweetwater  Pay","Income : Available next month","Income","Available next month","",$0.00,$81.64,$9320.00
"Dcu Checking",,U,,06/04/2020,"Sweetwater  Pay","Income : Available next month","Income","Available next month","",$0.00,$75.82,$9395.82
"Dcu Checking",,U,,06/06/2020,"Transfer : Discover",,,,"",$2363.09,$0.00,$7032.73
"Dcu Checking",,U,,06/08/2020,"bank  fee","Personal : BankFee","Personal","BankFee","",$3.00,$0.00,$7029.73
"Dcu Checking",,U,,06/08/2020,"Transfer : Lisa Cash Account",,,,"",$100.00,$0.00,$6929.73
"Dcu Checking",,U,268,06/08/2020,"Nancy & Dennis","Financial Help : Mom And Dad","Financial Help","Mom And Dad","",$1000.00,$0.00,$5929.73
"Dcu Checking",,U,,06/11/2020,"income","Income : Available next month","Income","Available next month","",$0.00,$275.84,$6205.57
"Dcu Checking",,U,270,06/16/2020,"Mom  and Dad Lander Gift","Personal : Gifts","Personal","Gifts","",$80.00,$0.00,$6125.57
"Dcu Checking",,U,,06/18/2020,"parking","Recreation : Entertainment","Recreation","Entertainment","Nickerson State Park",$8.00,$0.00,$6117.57
"Dcu Checking",,U,,06/19/2020,"Sweetwater  Pay","Income : Available next month","Income","Available next month","",$0.00,$345.67,$6463.24
"Dcu Checking",,U,,06/22/2020,"Transfer : Etrade Taxable",,,,"",$0.00,$4000.00,$10463.24
"Dcu Checking",,U,,06/22/2020,"Pizza by evan","Food : Restaurants","Food","Restaurants","",$112.73,$0.00,$10350.51
"Dcu Checking",,U,,06/24/2020,"Ma Health Connector","Personal : Health Insurance","Personal","Health Insurance","",$5.45,$0.00,$10345.06
"Dcu Checking",,U,,06/25/2020,"Sweetwater  Pay","Income : Available next month","Income","Available next month","",$0.00,$343.35,$10688.41
"Dcu Checking",,U,,06/26/2020,"google storage","Personal : Miscellaneous","Personal","Miscellaneous","",$1.99,$0.00,$10686.42
"Dcu Checking",,U,269,06/30/2020,"Kim Campos","Personal : Gifts","Personal","Gifts","",$56.00,$0.00,$10630.42
"Dcu Checking",,U,271,06/30/2020,"Royal Palm Rv","RV : Campgrounds","RV","Campgrounds","Deposit of Dec",$200.00,$0.00,$10430.42
"Dcu Checking",,U,,07/01/2020,"Save the children","Charity : Other","Charity","Other","",$31.00,$0.00,$10399.42
"Dcu Checking",,U,,07/02/2020,"Sweetwater  Pay","Income : Available this month","Income","Available this month","",$0.00,$376.17,$10775.59
"Dcu Checking",,U,,07/02/2020,"verizon wireless","RV : Cell Phones and Data","RV","Cell Phones and Data",,$221.95,$0.00,$10553.64
"Dcu Checking",,U,,07/06/2020,"Transfer : Discover",,,,"",$3612.30,$0.00,$6941.34
"Dcu Checking",,U,,07/09/2020,"Sweetwater  Pay","Income : Available this month","Income","Available this month","",$0.00,$324.47,$7265.81
"Dcu Checking",,U,,07/09/2020,"Exxon mobile","Transportation : Gas","Transportation","Gas","Harwitch",$20.06,$0.00,$7245.75
"Dcu Checking",,U,,07/16/2020,"Sweetwater  Pay","Income : Available this month","Income","Available this month","",$0.00,$341.76,$7587.51
"Dcu Checking",,U,,07/16/2020,"Godaddy","Personal : Miscellaneous","Personal","Miscellaneous","mwbi.net domain",$18.17,$0.00,$7569.34
"Dcu Checking",,U,,07/23/2020,"Sweetwater  Pay","Income : Available this month","Income","Available this month","",$0.00,$344.10,$7913.44
"Dcu Checking",,U,,07/24/2020,"Ma Health Connector","Personal : Health Insurance","Personal","Health Insurance",,$5.45,$0.00,$7907.99
"Dcu Checking",,U,,07/27/2020,"itunes","Recreation : Entertainment","Recreation","Entertainment","",$1.99,$0.00,$7906.00
"Dcu Checking",,U,,07/31/2020,"Transfer : Etrade Taxable",,,,"",$0.00,$4000.00,$11906.00
"Dcu Checking",,U,,07/31/2020,"Sweetwater  Pay","Income : Available this month","Income","Available this month",,$0.00,$364.36,$12270.36
"Dcu Checking",,U,,08/03/2020,"Save the children","Charity : Other","Charity","Other","",$31.00,$0.00,$12239.36
"Dcu Checking",,U,,08/03/2020,"verizon wireless","RV : Cell Phones and Data","RV","Cell Phones and Data",,$223.03,$0.00,$12016.33
"Dcu Checking",,U,,08/06/2020,"Transfer : Discover",,,,"",$1961.70,$0.00,$10054.63
"Dcu Checking",,U,,08/07/2020,"Sweetwater  Pay","Income : Available this month","Income","Available this month","",$0.00,$362.66,$10417.29
"Dcu Checking",,U,,08/07/2020,"Captain Frosty","Food : Restaurants","Food","Restaurants","",$42.05,$0.00,$10375.24
"Dcu Checking",,U,,08/13/2020,"Sweetwater  Pay","Income : Available this month","Income","Available this month","",$0.00,$334.81,$10710.05
"Dcu Checking",,U,,08/13/2020,"State Park  Fee","Recreation : Entertainment","Recreation","Entertainment","",$8.00,$0.00,$10702.05
"Dcu Checking",,U,,08/13/2020,"State Park  Fee","Recreation : Entertainment","Recreation","Entertainment","nickerson",$8.00,$0.00,$10694.05
"Dcu Checking",,U,,08/19/2020,"Max noodles","Food : Restaurants","Food","Restaurants","Billeriica with lisa and christine",$10.49,$0.00,$10683.56
"Dcu Checking",,U,,08/21/2020,"Sweetwater  Pay","Income : Available this month","Income","Available this month","",$0.00,$341.25,$11024.81
"Dcu Checking",,U,,08/24/2020,"Ma Health Connector","Personal : Health Insurance","Personal","Health Insurance","",$5.45,$0.00,$11019.36
"Dcu Checking",,U,,08/26/2020,"google storage","Personal : Miscellaneous","Personal","Miscellaneous","",$1.99,$0.00,$11017.37
"Dcu Checking",,U,,09/01/2020,"Save the children","Charity : Other","Charity","Other","",$36.00,$0.00,$10981.37
"Dcu Checking",,U,,09/02/2020,"verizon wireless","RV : Cell Phones and Data","RV","Cell Phones and Data",,$223.63,$0.00,$10757.74
"Dcu Checking",,U,,09/03/2020,"Sweetwater  Pay","Income : Available this month","Income","Available this month","",$0.00,$346.29,$11104.03
"Dcu Checking",,U,,09/06/2020,"Transfer : Discover",,,,"",$1938.35,$0.00,$9165.68
"Dcu Checking",,U,,09/08/2020,"JT Seafood","Food : Restaurants","Food","Restaurants","",$49.95,$0.00,$9115.73
"Dcu Checking",,U,,09/11/2020,"Sweetwater  Pay","Income : Available this month","Income","Available this month","",$0.00,$320.89,$9436.62
"Dcu Checking",,U,,09/17/2020,"Sweetwater  Pay","Income : Available this month","Income","Available this month","",$0.00,$346.95,$9783.57
"Dcu Checking",,U,,09/18/2020,"Safety Insurance","Transportation : Car Insurance","Transportation","Car Insurance","",$936.95,$0.00,$8846.62
"Dcu Checking",,U,,09/21/2020,"Transfer : Etrade Taxable",,,,"",$0.00,$4000.00,$12846.62
"Dcu Checking",,U,272,09/21/2020,"Matt Swinton","Personal : Gifts","Personal","Gifts","Wedding gift for Matt and Sy",$300.00,$0.00,$12546.62
"Dcu Checking",,U,,09/24/2020,"Sweetwater  Pay","Income : Available this month","Income","Available this month",,$0.00,$291.55,$12838.17
"Dcu Checking",,U,,09/24/2020,"Ma Health Connector","Personal : Health Insurance","Personal","Health Insurance","",$5.45,$0.00,$12832.72
"Dcu Checking",,U,,09/26/2020,"google storage","Personal : Miscellaneous","Personal","Miscellaneous","",$1.99,$0.00,$12830.73
"Dcu Checking",,U,,09/28/2020,"Transfer : Etrade Taxable",,,,"",$0.00,$5000.00,$17830.73
"Dcu Checking",,U,273,09/28/2020,"Kate Campos","Personal : Gifts","Personal","Gifts","Birthday",$50.00,$0.00,$17780.73
"Dcu Checking",,U,,09/29/2020,"Save the children","Charity : Other","Charity","Other","",$36.00,$0.00,$17744.73
"Dcu Checking",,U,,10/02/2020,"Sweetwater  Pay","Income : Available this month","Income","Available this month","",$0.00,$238.52,$17983.25
"Dcu Checking",,U,,10/02/2020,"verizon wireless","RV : Cell Phones and Data","RV","Cell Phones and Data",,$219.13,$0.00,$17764.12
"Dcu Checking",,U,,10/03/2020,"Bombay Royal","Food : Restaurants","Food","Restaurants","",$70.13,$0.00,$17693.99
"Dcu Checking",,U,,10/07/2020,"Transfer : Discover",,,,"",$2749.89,$0.00,$14944.10
"Dcu Checking",,U,,10/08/2020,"target","Personal : cloths","Personal","cloths","",$9.21,$0.00,$14934.89
"Dcu Checking",,U,,10/09/2020,"Sweetwater  Pay","Income : Available this month","Income","Available this month","",$0.00,$245.69,$15180.58
"Dcu Checking",,U,,10/15/2020,"Transfer : Etrade Taxable",,,,"",$0.00,$4000.00,$19180.58
"Dcu Checking",,U,,10/15/2020,"","Personal : Health Insurance","Personal","Health Insurance","",$0.00,$325.39,$19505.97
"Dcu Checking",,U,,10/15/2020,"Sweetwater  Pay","Income : Available this month","Income","Available this month","",$0.00,$279.00,$19784.97
"Dcu Checking",,U,,10/15/2020,"Sweetwater  Pay","Income : Available this month","Income","Available this month","",$0.00,$74.06,$19859.03
"Dcu Checking",,U,,10/15/2020,"","Income : Available next month","Income","Available next month","",$0.00,$7.00,$19866.03
"Dcu Checking",,U,,10/20/2020,,,,,"",$0.00,$7.00,$19873.03
"Dcu Checking",,U,,10/23/2020,"Sweetwater  Pay","Income : Available this month","Income","Available this month","",$0.00,$113.74,$19986.77
"Dcu Checking",,U,,10/26/2020,"google storage","Personal : Miscellaneous","Personal","Miscellaneous","",$1.99,$0.00,$19984.78
"Dcu Checking",,U,,10/26/2020,"Ma Health Connector","Personal : Health Insurance","Personal","Health Insurance",,$5.45,$0.00,$19979.33
"Dcu Checking",,U,276,10/26/2020,"Sweet Water Forest Campground","RV : Maintenance","RV","Maintenance","Winterize",$100.00,$0.00,$19879.33
"Dcu Checking",,U,,10/31/2020,"","Income : Available this month","Income","Available this month","",$0.00,$50.00,$19929.33
"Dcu Checking",,U,,11/02/2020,,"Income : Available this month","Income","Available this month","",$0.00,$80.00,$20009.33
"Dcu Checking",,U,,11/02/2020,"e-ZPass","RV : Tolls","RV","Tolls","",$10.00,$0.00,$19999.33
"Dcu Checking",,U,,11/02/2020,"Save the children","Charity : Other","Charity","Other","",$36.00,$0.00,$19963.33
"Dcu Checking",,U,274,11/02/2020,"Anna Mattei","Personal : Gifts","Personal","Gifts","joshua",$50.00,$0.00,$19913.33
"Dcu Checking",,U,,11/03/2020,"Transfer : DCU Savings",,,,"",$0.00,$2000.00,$21913.33
"Dcu Checking",,U,,11/03/2020,"","Transportation : Car Payment","Transportation","Car Payment","Wire fee",$15.00,$0.00,$21898.33
"Dcu Checking",,U,,11/03/2020,"verizon wireless","RV : Cell Phones and Data","RV","Cell Phones and Data","",$222.94,$0.00,$21675.39
"Dcu Checking",,U,,11/03/2020,"June and Bill for car","Transportation : Car Payment","Transportation","Car Payment","Buy car",$9000.00,$0.00,$12675.39
"Dcu Checking",,U,,11/05/2020,"RMV","Transportation : Car Payment","Transportation","Car Payment","(Split 1/2) sales tax",$647.50,$0.00,$11977.89
"Dcu Checking",,U,,11/05/2020,"RMV","Transportation : Registration","Transportation","Registration","(Split 2/2) ",$50.00,$0.00,$11977.89
"Dcu Checking",,U,,11/06/2020,"Transfer : Discover",,,,"",$4333.14,$0.00,$7644.75
"Dcu Checking",,U,,11/07/2020,,"Income : Available this month","Income","Available this month","",$0.00,$150.00,$7794.75
"Dcu Checking",,U,,11/09/2020,"Transfer : Target",,,,"",$101.40,$0.00,$7693.35
"Dcu Checking",,U,,11/12/2020,"Transfer : Etrade Taxable",,,,"",$0.00,$3000.00,$10693.35
"Dcu Checking",,U,,11/23/2020,"e-ZPass","Transportation : tolls","Transportation","tolls","",$20.00,$0.00,$10673.35
"Dcu Checking",,U,,11/23/2020,"Squareup","Personal : Gifts","Personal","Gifts","",$27.00,$0.00,$10646.35
"Dcu Checking",,U,,11/25/2020,"Ma Health Connector","Personal : Health Insurance","Personal","Health Insurance","",$5.45,$0.00,$10640.90
"Dcu Checking",,U,,11/27/2020,"google storage","Personal : Miscellaneous","Personal","Miscellaneous","",$1.99,$0.00,$10638.91
"Dcu Checking",,U,,11/27/2020,"baseblock","Recreation : His","Recreation","His","Exercise bar",$134.10,$0.00,$10504.81
"Dcu Checking",,U,,11/28/2020,"Shell","Transportation : Gas","Transportation","Gas","",$25.94,$0.00,$10478.87
"Dcu Checking",,U,,12/01/2020,"Save the children","Charity : Other","Charity","Other","",$36.00,$0.00,$10442.87
"Dcu Checking",,U,,12/02/2020,"Twentyone pilots","Personal : Gifts","Personal","Gifts","",$20.25,$0.00,$10422.62
"Dcu Checking",,U,,12/02/2020,"verizon wireless","RV : Cell Phones and Data","RV","Cell Phones and Data",,$223.93,$0.00,$10198.69
"Dcu Checking",,U,,12/07/2020,"Transfer : DCU Savings",,,,"",$0.00,$1000.00,$11198.69
"Dcu Checking",,U,,12/07/2020,"Transfer : Discover",,,,"",$3408.15,$0.00,$7790.54
"Dcu Checking",,U,,12/10/2020,"Transfer : Target",,,,"",$47.04,$0.00,$7743.50
"Dcu Checking",,U,,12/14/2020,"Transfer : Etrade Taxable",,,,"",$0.00,$5000.00,$12743.50
"Dcu Checking",,U,,12/15/2020,"Transfer : Etrade Taxable",,,,"",$0.00,$3000.00,$15743.50
"Dcu Checking",,U,279,12/15/2020,"serafine","Personal : Gifts","Personal","Gifts","",$50.00,$0.00,$15693.50
"Dcu Checking",,U,,12/21/2020,"Mom  and Dad Lander Gift","Personal : Gifts","Personal","Gifts","",$0.00,$95.00,$15788.50
"Dcu Checking",,U,,12/23/2020,"Ma Health Connector","Personal : Health Insurance","Personal","Health Insurance",,$110.00,$0.00,$15678.50
"Dcu Checking",,U,,12/26/2020,"google storage","Personal : Miscellaneous","Personal","Miscellaneous","",$1.99,$0.00,$15676.51
"Dcu Checking",,U,281,12/29/2020,"Anna Mattei","Personal : Gifts","Personal","Gifts","",$200.00,$0.00,$15476.51
"Dcu Checking",,U,,12/30/2020,"irs","Income : Available next month","Income","Available next month","",$0.00,$1200.00,$16676.51
"Dcu Checking",,U,283,12/30/2020,"Mom  and Dad Lander Gift","Financial Help : Mom And Dad","Financial Help","Mom And Dad","",$3000.00,$0.00,$13676.51
"Dcu Checking",,U,280,12/31/2020,"Town of Dennis","Transportation : Auto Excise","Transportation","Auto Excise","",$11.56,$0.00,$13664.95
"Dcu Checking",,U,,12/31/2020,"RObert Lytle","Personal : Doctor, Dentist","Personal","Doctor, Dentist","",$18.00,$0.00,$13646.95
"Dcu Checking",,U,,01/04/2021,"Save the children","Charity : Other","Charity","Other",,$36.00,$0.00,$13610.95
"Dcu Checking",,U,282,01/04/2021,"Zach mattei-lownes","Personal : Gifts","Personal","Gifts","",$100.00,$0.00,$13510.95
"Dcu Checking",,U,,01/04/2021,"verizon wireless","RV : Cell Phones and Data","RV","Cell Phones and Data","",$139.57,$0.00,$13371.38
"Dcu Checking",,U,,01/06/2021,"Transfer : Etrade Taxable",,,,"",$0.00,$2000.00,$15371.38
"Dcu Checking",,U,,01/07/2021,"Transfer : Discover",,,,"",$4362.15,$0.00,$11009.23
"Dcu Checking",,U,,01/11/2021,"Transfer : Target",,,,"",$50.46,$0.00,$10958.77
"Dcu Checking",,U,,01/20/2021,"Transfer : Etrade-Retirement","Income : Available next month","Income","Available next month","",$0.00,$2500.00,$13458.77
"Dcu Checking",,U,,01/21/2021,"Transfer : Etrade-Retirement","Income : Available next month","Income","Available next month","",$0.00,$1500.00,$14958.77
"Dcu Checking",,U,,01/21/2021,"Transfer : Etrade-Retirement","Income : Available next month","Income","Available next month","",$0.00,$1487.50,$16446.27
"Dcu Checking",,U,,01/25/2021,"Ma Health Connector","Personal : Health Insurance","Personal","Health Insurance",,$110.00,$0.00,$16336.27
"Dcu Checking",,U,,01/26/2021,"google storage","RV : MISC","RV","MISC","",$1.99,$0.00,$16334.28
"Dcu Checking",,U,284,01/26/2021,"Primacare","Personal : Doctor, Dentist","Personal","Doctor, Dentist","",$20.00,$0.00,$16314.28
"Dcu Checking",,U,,02/01/2021,"Save the children","Charity : Other","Charity","Other","",$36.00,$0.00,$16278.28
"Dcu Checking",,U,,02/02/2021,"Transfer : Etrade-Retirement","Income : Available next month","Income","Available next month","",$0.00,$1700.00,$17978.28
"Dcu Checking",,U,,02/02/2021,"beacon advocates","Personal : Doctor, Dentist","Personal","Doctor, Dentist","MEdical advocage",$3000.00,$0.00,$14978.28
"Dcu Checking",,U,,02/03/2021,"verizon wireless","RV : Cell Phones and Data","RV","Cell Phones and Data","",$140.42,$0.00,$14837.86
"Dcu Checking",,U,,02/04/2021,"Transfer : Etrade-Retirement","Income : Available next month","Income","Available next month","",$0.00,$2550.00,$17387.86
"Dcu Checking",,U,,02/05/2021,"mom and dad payback","Financial Help : Mom And Dad","Financial Help","Mom And Dad","",$0.00,$80.00,$17467.86
"Dcu Checking",,U,,02/06/2021,"Transfer : Discover",,,,"",$2096.18,$0.00,$15371.68
"Dcu Checking",,U,,02/10/2021,"Transfer : Target",,,,"",$435.74,$0.00,$14935.94
"Dcu Checking",,U,277,02/10/2021,"Sweet Water Forest Campground","RV : Campgrounds","RV","Campgrounds","",$3000.00,$0.00,$11935.94
"Dcu Checking",,U,,02/11/2021,"techomedia","RV : MISC","RV","MISC","",$65.00,$0.00,$11870.94
"Dcu Checking",,U,,02/16/2021,"e-ZPass","Transportation : tolls","Transportation","tolls","",$10.00,$0.00,$11860.94
"Dcu Checking",,U,,02/22/2021,"e-ZPass","Transportation : tolls","Transportation","tolls","",$10.00,$0.00,$11850.94
"Dcu Checking",,U,,02/23/2021,"Transfer : Etrade-Retirement","Income : Available next month","Income","Available next month","",$0.00,$1500.00,$13350.94
"Dcu Checking",,U,,02/23/2021,"Transfer : Etrade-Retirement","Income : Available next month","Income","Available next month","",$0.00,$1487.50,$14838.44
"Dcu Checking",,U,,02/24/2021,"Ma Health Connector","Personal : Health Insurance","Personal","Health Insurance","",$110.00,$0.00,$14728.44
"Dcu Checking",,U,,02/26/2021,"google storage","RV : MISC","RV","MISC","",$1.99,$0.00,$14726.45
"Dcu Checking",,U,287,03/01/2021,"metro west mri","Personal : Doctor, Dentist","Personal","Doctor, Dentist","",$30.00,$0.00,$14696.45
"Dcu Checking",,U,,03/01/2021,"Save the children","Charity : Other","Charity","Other","",$36.00,$0.00,$14660.45
"Dcu Checking",,U,,03/02/2021,"beacon advocates","Personal : Doctor, Dentist","Personal","Doctor, Dentist","",$2000.00,$0.00,$12660.45
"Dcu Checking",,U,,03/03/2021,"verizon wireless","RV : Cell Phones and Data","RV","Cell Phones and Data",,$140.42,$0.00,$12520.03
"Dcu Checking",,U,,03/05/2021,"e-ZPass","Transportation : Auto Excise","Transportation","Auto Excise","",$10.00,$0.00,$12510.03
"Dcu Checking",,U,,03/06/2021,"Transfer : Discover",,,,"",$379.58,$0.00,$12130.45
"Dcu Checking",,U,,03/08/2021,"Town of Dennis","Transportation : Auto Excise","Transportation","Auto Excise","",$0.25,$0.00,$12130.20
"Dcu Checking",,U,,03/08/2021,"Town of Dennis","Transportation : Auto Excise","Transportation","Auto Excise","",$0.25,$0.00,$12129.95
"Dcu Checking",,U,,03/08/2021,"Town of Dennis","Transportation : Auto Excise","Transportation","Auto Excise","",$0.25,$0.00,$12129.70
"Dcu Checking",,U,,03/08/2021,"Town of Dennis","Transportation : Auto Excise","Transportation","Auto Excise","",$37.25,$0.00,$12092.45
"Dcu Checking",,U,,03/08/2021,"Town of Dennis","Transportation : Auto Excise","Transportation","Auto Excise","",$69.36,$0.00,$12023.09
"Dcu Checking",,U,,03/08/2021,"Town of Dennis","Transportation : Auto Excise","Transportation","Auto Excise","",$264.55,$0.00,$11758.54
"Dcu Checking",,U,,03/10/2021,"e-ZPass","Transportation : Auto Excise","Transportation","Auto Excise","",$10.00,$0.00,$11748.54
"Dcu Checking",,U,,03/10/2021,"Transfer : Target",,,,"",$416.14,$0.00,$11332.40
"Dcu Checking",,U,,03/12/2021,"irs","Income : Available next month","Income","Available next month","",$0.00,$2800.00,$14132.40
"Dcu Checking",,U,,03/15/2021,"e-ZPass","Transportation : Auto Excise","Transportation","Auto Excise","",$10.00,$0.00,$14122.40
"Dcu Checking",,U,,03/16/2021,"Pizza by evan","Food : Restaurants","Food","Restaurants","",$26.36,$0.00,$14096.04
"Dcu Checking",,U,288,03/17/2021,"Sweetwater camground","RV : Campgrounds","RV","Campgrounds",,$500.00,$0.00,$13596.04
"Dcu Checking",,U,,03/22/2021,"e-ZPass","Transportation : Auto Excise","Transportation","Auto Excise","",$10.00,$0.00,$13586.04
"Dcu Checking",,U,,03/23/2021,"Transfer : Etrade-Retirement","Income : Available next month","Income","Available next month",,$0.00,$1500.00,$15086.04
"Dcu Checking",,U,,03/23/2021,"Transfer : Etrade-Retirement","Income : Available next month","Income","Available next month","",$0.00,$1487.50,$16573.54
"Dcu Checking",,U,,03/23/2021,"Common Wealth Ma","income tax : state","income tax","state",,$450.00,$0.00,$16123.54
"Dcu Checking",,U,,03/24/2021,"irs","Income : Available next month","Income","Available next month","",$0.00,$398.00,$16521.54
"Dcu Checking",,U,,03/24/2021,"Ma Health Connector","Personal : Health Insurance","Personal","Health Insurance","",$110.00,$0.00,$16411.54
"Dcu Checking",,U,,03/26/2021,"google storage","RV : MISC","RV","MISC","",$1.99,$0.00,$16409.55
"Dcu Checking",,U,,03/26/2021,"e-ZPass","Transportation : Auto Excise","Transportation","Auto Excise","",$10.00,$0.00,$16399.55
"Dcu Checking",,U,,03/29/2021,"beacon advocates","Personal : Doctor, Dentist","Personal","Doctor, Dentist","",$2000.00,$0.00,$14399.55
"Dcu Checking",,U,289,03/30/2021,"Anna Mattei","Financial Help : Matteis","Financial Help","Matteis","",$1500.00,$0.00,$12899.55
"Dcu Checking",,U,,04/01/2021,"Justinguitar","Recreation : Entertainment","Recreation","Entertainment","guitar lessons",$25.00,$0.00,$12874.55
"Dcu Checking",,U,,04/01/2021,"Save the children","Charity : Other","Charity","Other","",$36.00,$0.00,$12838.55
"Dcu Checking",,U,,04/01/2021,"verizon wireless","RV : Cell Phones and Data","RV","Cell Phones and Data","",$138.72,$0.00,$12699.83
"Dcu Checking",,U,285,04/06/2021,"Sweetwater camground","RV : Campgrounds","RV","Campgrounds",,$500.00,$0.00,$12199.83
"Dcu Checking",,U,,04/07/2021,"e-ZPass","Transportation : Auto Excise","Transportation","Auto Excise","",$10.00,$0.00,$12189.83
"Dcu Checking",,U,,04/07/2021,"musopia","Recreation : Entertainment","Recreation","Entertainment","guitar app",$69.05,$0.00,$12120.78
"Dcu Checking",,U,,04/07/2021,"Transfer : Discover",,,,"",$4896.27,$0.00,$7224.51
"Dcu Checking",,U,,04/09/2021,"Transfer : Target",,,,"",$71.12,$0.00,$7153.39
"Dcu Checking",,U,,04/16/2021,"e-ZPass","Transportation : Auto Excise","Transportation","Auto Excise","",$10.00,$0.00,$7143.39
"Dcu Checking",,U,,04/21/2021,"Transfer : Etrade-Retirement","Income : Available next month","Income","Available next month","",$0.00,$1500.00,$8643.39
"Dcu Checking",,U,,04/21/2021,"Transfer : Etrade-Retirement","Income : Available next month","Income","Available next month","",$0.00,$1487.50,$10130.89
"Dcu Checking",,U,,04/22/2021,"e-ZPass","Transportation : Auto Excise","Transportation","Auto Excise","",$10.00,$0.00,$10120.89
"Dcu Checking",,U,,04/26/2021,"google storage","RV : MISC","RV","MISC","",$1.99,$0.00,$10118.90
"Dcu Checking",,U,,04/26/2021,"Ma Health Connector","Personal : Health Insurance","Personal","Health Insurance",,$32.31,$0.00,$10086.59
"Dcu Checking",,U,,04/26/2021,"linguines","Food : Restaurants","Food","Restaurants","",$52.27,$0.00,$10034.32
"Dcu Checking",,U,,04/28/2021,"Tiffin red bay","RV : Maintenance","RV","Maintenance","",$22.23,$0.00,$10012.09
"Dcu Checking",,U,,04/28/2021,"Tiffin red bay","RV : Maintenance","RV","Maintenance","",$31.96,$0.00,$9980.13
"Dcu Checking",,U,,04/29/2021,"e-ZPass","Transportation : Auto Excise","Transportation","Auto Excise","",$10.00,$0.00,$9970.13
"Dcu Checking",,U,,05/03/2021,"e-ZPass","Transportation : Auto Excise","Transportation","Auto Excise","",$10.00,$0.00,$9960.13
"Dcu Checking",,U,,05/03/2021,"Save the children","Charity : Other","Charity","Other","",$36.00,$0.00,$9924.13
"Dcu Checking",,U,,05/04/2021,"verizon wireless","RV : Cell Phones and Data","RV","Cell Phones and Data","",$139.01,$0.00,$9785.12
"Dcu Checking",,U,,05/04/2021,"Transfer : Target",,,,"",$170.66,$0.00,$9614.46
"Dcu Checking",,U,,05/06/2021,"Transfer : Discover",,,,"",$3202.30,$0.00,$6412.16
"Dcu Checking",,U,,05/11/2021,"Transfer : Etrade-Retirement","Income : Available next month","Income","Available next month","",$0.00,$3000.00,$9412.16
"Dcu Checking",,U,290,05/11/2021,"Sweetwater camground","RV : Campgrounds","RV","Campgrounds","",$400.00,$0.00,$9012.16
"Dcu Checking",,U,,05/14/2021,"e-ZPass","Transportation : Auto Excise","Transportation","Auto Excise","",$10.00,$0.00,$9002.16
"Dcu Checking",,U,,05/21/2021,"Transfer : Etrade-Retirement","Income : Available next month","Income","Available next month","",$0.00,$1500.00,$10502.16
"Dcu Checking",,U,,05/21/2021,"Transfer : Etrade-Retirement","Income : Available next month","Income","Available next month","",$0.00,$1487.50,$11989.66
"Dcu Checking",,U,,05/22/2021,"musopia","Recreation : Entertainment","Recreation","Entertainment","",$0.00,$60.76,$12050.42
"Dcu Checking",,U,,05/24/2021,"e-ZPass","Transportation : Auto Excise","Transportation","Auto Excise","",$10.00,$0.00,$12040.42
"Dcu Checking",,U,,05/24/2021,"Pizza  by Evan","Food : Restaurants","Food","Restaurants","",$26.43,$0.00,$12013.99
"Dcu Checking",,U,,05/24/2021,"Ma Health Connector","Personal : Health Insurance","Personal","Health Insurance","",$32.31,$0.00,$11981.68
"Dcu Checking",,U,,05/26/2021,"google storage","RV : MISC","RV","MISC","",$1.99,$0.00,$11979.69
"Dcu Checking",,U,,06/01/2021,"Save the children","Charity : Other","Charity","Other","",$36.00,$0.00,$11943.69
"Dcu Checking",,U,,06/03/2021,"verizon wireless","RV : Cell Phones and Data","RV","Cell Phones and Data",,$139.01,$0.00,$11804.68
"Dcu Checking",,U,292,06/03/2021,"Nancy & Dennis","Financial Help : Mom And Dad","Financial Help","Mom And Dad","Anniversayr",$610.00,$0.00,$11194.68
"Dcu Checking",,U,,06/05/2021,"Transfer : Discover",,,,"",$3666.24,$0.00,$7528.44
"Dcu Checking",,U,,06/09/2021,"e-ZPass","Transportation : Auto Excise","Transportation","Auto Excise","",$10.00,$0.00,$7518.44
"Dcu Checking",,U,291,06/09/2021,"Anna Mattei","Personal : Gifts","Personal","Gifts","Guy and Eilean gift",$35.00,$0.00,$7483.44
"Dcu Checking",,U,,06/09/2021,"Transfer : Target",,,,"",$352.08,$0.00,$7131.36
"Dcu Checking",,U,286,06/15/2021,"Colonial Garden club","Recreation : Entertainment","Recreation","Entertainment","plants?",$41.00,$0.00,$7090.36
"Dcu Checking",,U,town of dennis,06/15/2021,"","Recreation : Entertainment","Recreation","Entertainment","Beach pass",$50.50,$0.00,$7039.86
"Dcu Checking",,U,293,06/15/2021,"Sweetwater camground","RV : Campgrounds","RV","Campgrounds","",$300.00,$0.00,$6739.86
"Dcu Checking",,U,,06/16/2021,"QUAN CHINESE KITCHEN","Food : Restaurants","Food","Restaurants","",$30.00,$0.00,$6709.86
"Dcu Checking",,U,,06/21/2021,"Transfer : Etrade-Retirement","Income : Available next month","Income","Available next month","",$0.00,$1500.00,$8209.86
"Dcu Checking",,U,,06/21/2021,"Transfer : Etrade-Retirement","Income : Available next month","Income","Available next month","",$0.00,$1487.50,$9697.36
"Dcu Checking",,U,,06/21/2021,"Thai Ocha","Food : Restaurants","Food","Restaurants","",$71.00,$0.00,$9626.36
"Dcu Checking",,U,,06/24/2021,"Sweetwater  Pay","Income : Available next month","Income","Available next month","",$0.00,$128.45,$9754.81
"Dcu Checking",,U,,06/24/2021,"Ma Health Connector","Personal : Health Insurance","Personal","Health Insurance","",$32.31,$0.00,$9722.50
"Dcu Checking",,U,,06/26/2021,"google storage","RV : MISC","RV","MISC","",$1.99,$0.00,$9720.51
"Dcu Checking",,U,,07/01/2021,"Sweetwater  Pay","Income : Available next month","Income","Available next month","",$0.00,$266.39,$9986.90
"Dcu Checking",,U,,07/01/2021,"Kate's seafood","Food : Restaurants","Food","Restaurants","",$12.60,$0.00,$9974.30
"Dcu Checking",,U,,07/01/2021,"Save the children","Charity : Other","Charity","Other","",$36.00,$0.00,$9938.30
"Dcu Checking",,U,,07/01/2021,"verizon wireless","RV : Cell Phones and Data","RV","Cell Phones and Data",,$232.65,$0.00,$9705.65
"Dcu Checking",,U,,07/06/2021,"e-ZPass","Transportation : Auto Excise","Transportation","Auto Excise","",$10.00,$0.00,$9695.65
"Dcu Checking",,U,,07/06/2021,"e-ZPass","Transportation : Auto Excise","Transportation","Auto Excise","",$45.00,$0.00,$9650.65
"Dcu Checking",,U,,07/06/2021,"Transfer : Discover",,,,"",$5863.50,$0.00,$3787.15
"Dcu Checking",,U,,07/12/2021,"Transfer : Target",,,,"",$479.73,$0.00,$3307.42
"Dcu Checking",,U,,07/15/2021,"Sweetwater  Pay","Income : Available next month","Income","Available next month","",$0.00,$271.57,$3578.99
"Dcu Checking",,U,,07/17/2021,"Transfer : Etrade-Retirement","Income : Available next month","Income","Available next month","",$0.00,$1487.50,$5066.49
"Dcu Checking",,U,,07/21/2021,"Transfer : Etrade-Retirement","Income : Available next month","Income","Available next month","",$0.00,$1500.00,$6566.49
"Dcu Checking",,U,,07/21/2021,"Godaddy","Personal : Miscellaneous","Personal","Miscellaneous","",$19.17,$0.00,$6547.32
"Dcu Checking",,U,294,07/21/2021,"Cliff Lander","Personal : Gifts","Personal","Gifts","",$100.00,$0.00,$6447.32
"Dcu Checking",,U,,07/26/2021,"google storage","RV : MISC","RV","MISC","",$1.99,$0.00,$6445.33
"Dcu Checking",,U,,07/26/2021,"Ma Health Connector","Personal : Health Insurance","Personal","Health Insurance","",$32.31,$0.00,$6413.02
"Dcu Checking",,U,295,07/26/2021,"Shorehills Campground","RV : Campgrounds","RV","Campgrounds","",$50.00,$0.00,$6363.02
"Dcu Checking",,U,,07/28/2021,"Transfer : Etrade Taxable",,,,"",$0.00,$700.00,$7063.02
"Dcu Checking",,U,,07/29/2021,"Sweetwater  Pay","Income : Available next month","Income","Available next month","",$0.00,$392.29,$7455.31
"Dcu Checking",,U,,08/02/2021,"Save the children","Charity : Other","Charity","Other","",$36.00,$0.00,$7419.31
"Dcu Checking",,U,,08/03/2021,"Transfer : Etrade-Retirement","Income : Available next month","Income","Available next month",,$0.00,$1600.00,$9019.31
"Dcu Checking",,U,,08/03/2021,"Transfer : Etrade-Retirement","Income : Available next month","Income","Available next month",,$0.00,$1000.00,$10019.31
"Dcu Checking",,U,,08/03/2021,"verizon wireless","RV : Cell Phones and Data","RV","Cell Phones and Data","",$178.75,$0.00,$9840.56
"Dcu Checking",,U,,08/05/2021,"Sweetwater  Pay","Income : Available next month","Income","Available next month",,$0.00,$84.00,$9924.56
"Dcu Checking",,U,,08/06/2021,"Transfer : Discover",,,,"",$3289.92,$0.00,$6634.64
"Dcu Checking",,U,,08/12/2021,"Sweetwater  Pay","Income : Available next month","Income","Available next month","",$0.00,$308.12,$6942.76
"Dcu Checking",,U,,08/13/2021,"Transfer : Lisa Cash Account",,,,"",$200.00,$0.00,$6742.76
"Dcu Checking",,U,,08/19/2021,"Sweetwater  Pay","Income : Available next month","Income","Available next month","MISTAKE!!",$0.00,$2498.12,$9240.88
"Dcu Checking",,U,,08/20/2021,"bangkok cuisine","Food : Restaurants","Food","Restaurants","",$35.99,$0.00,$9204.89
"Dcu Checking",,U,,08/23/2021,"Transfer : Etrade-Retirement","Income : Available next month","Income","Available next month",,$0.00,$1500.00,$10704.89
"Dcu Checking",,U,,08/23/2021,"Transfer : Etrade-Retirement","Income : Available next month","Income","Available next month",,$0.00,$1487.50,$12192.39
"Dcu Checking",,U,,08/24/2021,"Sweetwater  Pay","Income : Available next month","Income","Available next month","",$0.00,$266.51,$12458.90
"Dcu Checking",,U,,08/24/2021,"Ma Health Connector","Personal : Health Insurance","Personal","Health Insurance","",$32.31,$0.00,$12426.59
"Dcu Checking",,U,,08/24/2021,"Sweetwater  Pay","Income : Available next month","Income","Available next month","CORRECRION",$2498.12,$0.00,$9928.47
"Dcu Checking",,U,,08/25/2021,"google storage","RV : MISC","RV","MISC","",$1.99,$0.00,$9926.48
"Dcu Checking",,U,299,08/25/2021,"Shorehills Campground","RV : Campgrounds","RV","Campgrounds","",$100.00,$0.00,$9826.48
"Dcu Checking",,U,297,08/25/2021,"Shorehills Campground","RV : Campgrounds","RV","Campgrounds","",$135.00,$0.00,$9691.48
"Dcu Checking",,U,298,08/25/2021,"Shorehills Campground","RV : Campgrounds","RV","Campgrounds","",$498.47,$0.00,$9193.01
"Dcu Checking",,U,,08/26/2021,"Sweetwater  Pay","Income : Available next month","Income","Available next month",,$0.00,$193.09,$9386.10
"Dcu Checking",,U,296,08/26/2021,"brain cotnori","Personal : Gifts","Personal","Gifts","wedding Brian an Martine",$100.00,$0.00,$9286.10
"Dcu Checking",,U,,08/27/2021,"Transfer : Etrade-Retirement","Income : Available next month","Income","Available next month","",$0.00,$1275.00,$10561.10
"Dcu Checking",,U,,09/01/2021,"Save the children","Charity : Other","Charity","Other","",$36.00,$0.00,$10525.10
"Dcu Checking",,U,,09/01/2021,"verizon wireless","RV : Cell Phones and Data","RV","Cell Phones and Data","",$221.32,$0.00,$10303.78
"Dcu Checking",,U,,09/02/2021,"Sweetwater  Pay","Income : Available next month","Income","Available next month",,$0.00,$256.21,$10559.99
"Dcu Checking",,U,,09/06/2021,"Transfer : Discover",,,,"",$6614.29,$0.00,$3945.70
"Dcu Checking",,U,300,09/08/2021,"sweetwater","RV : Equipment/Supplies","RV","Equipment/Supplies","winterize",$125.00,$0.00,$3820.70
"Dcu Checking",,U,,09/09/2021,"Sweetwater  Pay","Income : Available next month","Income","Available next month","",$0.00,$268.33,$4089.03
"Dcu Checking",,U,,09/13/2021,"Transfer : Lisa Cash Account",,,,"",$80.00,$0.00,$4009.03
"Dcu Checking",,U,,09/16/2021,"Sweetwater  Pay","Income : Available next month","Income","Available next month",,$0.00,$389.01,$4398.04
"Dcu Checking",,U,,09/16/2021,"Deposit","Income : Available next month","Income","Available next month","",$0.00,$98.80,$4496.84
"Dcu Checking",,U,,09/16/2021,"Deposit","Income : Available next month","Income","Available next month","",$0.00,$78.00,$4574.84
"Dcu Checking",,U,,09/21/2021,"Transfer : Etrade-Retirement","Income : Available next month","Income","Available next month","",$0.00,$2000.00,$6574.84
"Dcu Checking",,U,,09/21/2021,"Transfer : Etrade-Retirement","Income : Available next month","Income","Available next month",,$0.00,$1700.00,$8274.84
"Dcu Checking",,U,,09/21/2021,"Transfer : Etrade-Retirement","Income : Available next month","Income","Available next month",,$0.00,$1500.00,$9774.84
"Dcu Checking",,U,,09/21/2021,"Transfer : Etrade-Retirement","Income : Available next month","Income","Available next month",,$0.00,$1487.50,$11262.34
"Dcu Checking",,U,,09/23/2021,"Sweetwater  Pay","Income : Available next month","Income","Available next month",,$0.00,$392.75,$11655.09
"Dcu Checking",,U,,09/24/2021,"google storage","RV : MISC","RV","MISC","",$1.99,$0.00,$11653.10
"Dcu Checking",,U,,09/24/2021,"Gas","Transportation : Gas","Transportation","Gas","BUzzards bay",$36.26,$0.00,$11616.84
"Dcu Checking",,U,,09/24/2021,"Ma Health Connector","Personal : Health Insurance","Personal","Health Insurance","",$78.31,$0.00,$11538.53
"Dcu Checking",,U,,09/30/2021,"Sweetwater  Pay","Income : Available next month","Income","Available next month","",$0.00,$154.72,$11693.25
"Dcu Checking",,U,,10/01/2021,"Save the children","Charity : Other","Charity","Other","",$36.00,$0.00,$11657.25
"Dcu Checking",,U,,10/04/2021,"Deposit","Income : Available next month","Income","Available next month","",$0.00,$63.28,$11720.53
"Dcu Checking",,U,,10/04/2021,"verizon wireless","RV : Cell Phones and Data","RV","Cell Phones and Data","",$208.56,$0.00,$11511.97
"Dcu Checking",,U,,10/06/2021,"Transfer : Discover",,,,"",$4953.83,$0.00,$6558.14
"Dcu Checking",,U,,10/07/2021,"Sweetwater  Pay","Income : Available next month","Income","Available next month",,$0.00,$282.33,$6840.47
"Dcu Checking",,U,,10/07/2021,"QUAN CHINESE KITCHEN","Food : Restaurants","Food","Restaurants","",$31.22,$0.00,$6809.25
"Dcu Checking",,U,,10/14/2021,"Sweetwater  Pay","Income : Available next month","Income","Available next month",,$0.00,$327.52,$7136.77
"Dcu Checking",,U,,10/16/2021,"Fresh Pickents","Food : Groceries","Food","Groceries","Baton Rouge LA",$19.73,$0.00,$7117.04
"Dcu Checking",,U,,10/19/2021,"sprouts","Food : Groceries","Food","Groceries","",$80.56,$0.00,$7036.48
"Dcu Checking",,U,,10/21/2021,"Transfer : Etrade-Retirement","Income : Available next month","Income","Available next month",,$0.00,$1500.00,$8536.48
"Dcu Checking",,U,,10/21/2021,"Transfer : Etrade-Retirement","Income : Available next month","Income","Available next month",,$0.00,$1487.50,$10023.98
"Dcu Checking",,U,,10/25/2021,"Ma Health Connector","Personal : Health Insurance","Personal","Health Insurance","",$78.31,$0.00,$9945.67
"Dcu Checking",,U,,10/26/2021,"google storage","RV : MISC","RV","MISC","",$1.99,$0.00,$9943.68
"Dcu Checking",,U,301,10/26/2021,"Anna Mattei","Personal : Gifts","Personal","Gifts","Joshua BDAY",$100.00,$0.00,$9843.68
"Dcu Checking",,U,302,10/26/2021,"Zach mattei-lownes","Personal : Gifts","Personal","Gifts","",$100.00,$0.00,$9743.68
"Dcu Checking",,U,,10/28/2021,"houston","Transportation : Parking","Transportation","Parking","",$2.25,$0.00,$9741.43
"Dcu Checking",,U,,11/01/2021,"Save the children","Charity : Other","Charity","Other","",$36.00,$0.00,$9705.43
"Dcu Checking",,U,,11/03/2021,"e-ZPass","Transportation : Auto Excise","Transportation","Auto Excise","",$10.00,$0.00,$9695.43
"Dcu Checking",,U,,11/03/2021,"e-ZPass","Transportation : Auto Excise","Transportation","Auto Excise","",$10.00,$0.00,$9685.43
"Dcu Checking",,U,,11/03/2021,"verizon wireless","RV : Cell Phones and Data","RV","Cell Phones and Data",,$208.38,$0.00,$9477.05
"Dcu Checking",,U,,11/06/2021,"Transfer : Discover",,,,"",$2664.76,$0.00,$6812.29
"Dcu Checking",,U,,11/10/2021,"e-ZPass","Transportation : Auto Excise","Transportation","Auto Excise","",$10.00,$0.00,$6802.29
"Dcu Checking",,U,,11/10/2021,"Transfer : Target",,,,"",$33.25,$0.00,$6769.04
"Dcu Checking",,U,,11/22/2021,"Transfer : Etrade-Retirement","Income : Available next month","Income","Available next month",,$0.00,$4000.00,$10769.04
"Dcu Checking",,U,,11/23/2021,"Transfer : Etrade-Retirement","Income : Available next month","Income","Available next month",,$0.00,$1500.00,$12269.04
"Dcu Checking",,U,,11/23/2021,"Transfer : Etrade-Retirement","Income : Available next month","Income","Available next month",,$0.00,$1487.50,$13756.54
"Dcu Checking",,U,,11/24/2021,"QUAN CHINESE KITCHEN","Food : Restaurants","Food","Restaurants","",$43.48,$0.00,$13713.06
"Dcu Checking",,U,,11/24/2021,"Ma Health Connector","Personal : Health Insurance","Personal","Health Insurance","",$78.31,$0.00,$13634.75
"Dcu Checking",,U,,11/26/2021,"google storage","RV : MISC","RV","MISC","",$1.99,$0.00,$13632.76
"Avidia-AlyssaAccount",,C,,09/01/2015,"Starting Balance","Income : Available next month","Income","Available next month","",$0.00,$5126.72,$5126.72
"Avidia-AlyssaAccount",,U,,09/09/2015,"Transfer : Avidia Checking",,,,,$1000.00,$0.00,$4126.72
"Avidia-AlyssaAccount",,U,,09/14/2015,"Deposit","Income : Available this month","Income","Available this month","",$0.00,$4434.00,$8560.72
"Avidia-AlyssaAccount",,U,,09/15/2015,"Transfer : Avidia Checking",,,,"",$3334.00,$0.00,$5226.72
"Avidia-AlyssaAccount",,U,,09/20/2015,"interest","Income : Available next month","Income","Available next month","",$0.00,$0.42,$5227.14
"Avidia-AlyssaAccount",,U,,10/16/2015,"Deposit","Income : Available this month","Income","Available this month","",$0.00,$250.00,$5477.14
"Avidia-AlyssaAccount",,U,,10/19/2015,"Transfer : Avidia Checking",,,,"",$250.00,$0.00,$5227.14
"Avidia-AlyssaAccount",,U,,10/20/2015,"interest","Income : Available next month","Income","Available next month","",$0.00,$0.43,$5227.57
"Avidia-AlyssaAccount",,U,,11/20/2015,"interest","Income : Available next month","Income","Available next month","",$0.00,$0.45,$5228.02
"Avidia-AlyssaAccount",,U,,12/11/2015,"Transfer : avidia - Lisa Business",,,,"",$0.00,$1000.00,$6228.02
"Avidia-AlyssaAccount",,U,,12/11/2015,"Transfer : Avidia Checking",,,,"",$1000.00,$0.00,$5228.02
"Avidia-AlyssaAccount",,U,,12/20/2015,"income","Income : Available next month","Income","Available next month","",$0.00,$0.43,$5228.45
"Avidia-AlyssaAccount",,U,,01/15/2016,"Deposit","Income : Available this month","Income","Available this month","",$0.00,$1350.00,$6578.45
"Avidia-AlyssaAccount",,U,,01/20/2016,"interest","Income : Available next month","Income","Available next month","",$0.00,$0.45,$6578.90
"Avidia-AlyssaAccount",,U,,01/20/2016,"Transfer : Avidia Checking",,,,"",$1000.00,$0.00,$5578.90
"Avidia-AlyssaAccount",,U,,02/01/2016,"Transfer : Avidia Checking",,,,"",$1000.00,$0.00,$4578.90
"Avidia-AlyssaAccount",,U,,02/20/2016,"interest","Income : Available next month","Income","Available next month","",$0.00,$0.42,$4579.32
"Avidia-AlyssaAccount",,U,,03/09/2016,"Transfer : Avidia Checking",,,,"",$1000.00,$0.00,$3579.32
"Avidia-AlyssaAccount",,U,,03/15/2016,"Transfer : Avidia Checking",,,,"",$2500.00,$0.00,$1079.32
"Avidia-AlyssaAccount",,U,,03/20/2016,"interest","Income : Available next month","Income","Available next month","",$0.00,$0.29,$1079.61
"Avidia-AlyssaAccount",,U,,04/06/2016,"Transfer : Avidia Checking",,,,"",$1000.00,$0.00,$79.61
"Avidia-AlyssaAccount",,U,,04/13/2016,"Tax refund MASSACHUSETTS","Income : Available this month","Income","Available this month","",$0.00,$25.00,$104.61
"Avidia-AlyssaAccount",,U,,04/14/2016,"IRS  tax refund","Income : Available next month","Income","Available next month",,$0.00,$24.00,$128.61
"Avidia-AlyssaAccount",,U,,04/20/2016,"interest","Income : Available next month","Income","Available next month","",$0.00,$0.05,$128.66
"Avidia-AlyssaAccount",,U,,04/20/2016,"Fee","Lisa Business : Bank Fees","Lisa Business","Bank Fees","",$5.00,$0.00,$123.66
"DCU LTD account",,U,,12/24/2016,"Transfer : Dcu Checking",,,,"",$0.00,$270000.00,$270000.00
"DCU LTD account",,U,,12/24/2016,"Transfer : Dcu Checking",,,,"",$0.00,$30000.00,$300000.00
"DCU LTD account",,U,,12/31/2016,"interest","Income : Available next month","Income","Available next month","",$0.00,$55.90,$300055.90
"DCU LTD account",,U,,01/30/2017,"Transfer : Dcu Checking",,,,"",$85000.00,$0.00,$215055.90
"DCU LTD account",,U,,01/31/2017,"interest","Income : Available next month","Income","Available next month","",$0.00,$212.73,$215268.63
"DCU LTD account",,U,,02/28/2017,"interest","Income : Available next month","Income","Available next month","",$0.00,$140.41,$215409.04
"DCU LTD account",,C,,03/16/2017,"Starting Balance","Income : Available this month","Income","Available this month",,$0.00,$0.00,$215409.04
"DCU LTD account",,U,,03/31/2017,"interest","Personal : Miscellaneous","Personal","Miscellaneous","",$0.00,$183.03,$215592.07
"DCU LTD account",,U,,04/04/2017,"Transfer : Dcu Checking",,,,"To make payment to retirement",$15000.00,$0.00,$200592.07
"DCU LTD account",,U,,04/30/2017,"interest","Income : Available next month","Income","Available next month","",$0.00,$166.17,$200758.24
"DCU LTD account",,U,,05/05/2017,"Transfer : Dcu Checking",,,,"",$30000.00,$0.00,$170758.24
"DCU LTD account",,U,,05/31/2017,"interest","Income : Available next month","Income","Available next month","",$0.00,$148.38,$170906.62
"DCU LTD account",,U,,06/30/2017,"interest","Income : Available next month","Income","Available next month","",$0.00,$140.53,$171047.15
"DCU LTD account",,U,,07/09/2017,"Transfer : Dcu Checking",,,,"",$0.00,$22000.00,$193047.15
"DCU LTD account",,U,,07/09/2017,"Transfer : DCU Savings",,,,"",$0.00,$15000.00,$208047.15
"DCU LTD account",,U,,07/31/2017,"interest","Income : Available next month","Income","Available next month","",$0.00,$168.66,$208215.81
"DCU LTD account",,U,,08/31/2017,"interest","Income : Available next month","Income","Available next month","",$0.00,$176.91,$208392.72
"DCU LTD account",,U,,09/19/2017,"Transfer : Dcu Checking",,,,"",$10000.00,$0.00,$198392.72
"DCU LTD account",,U,,09/30/2017,"interest","Income : Available next month","Income","Available next month","",$0.00,$168.61,$198561.33
"DCU LTD account",,U,,10/25/2017,"Transfer : Dcu Checking",,,,"",$10000.00,$0.00,$188561.33
"DCU LTD account",,U,,10/31/2017,"interest","Income : Available next month","Income","Available next month","",$0.00,$166.79,$188728.12
"DCU LTD account",,U,,11/30/2017,"interest","Income : Available next month","Income","Available next month","",$0.00,$155.18,$188883.30
"DCU LTD account",,U,,12/31/2017,"interest","Income : Available next month","Income","Available next month","",$0.00,$160.49,$189043.79
"DCU LTD account",,U,,01/04/2018,"Transfer : Dcu Checking",,,,"",$12000.00,$0.00,$177043.79
"DCU LTD account",,U,,01/31/2018,"interest","Income : Available next month","Income","Available next month","",$0.00,$151.42,$177195.21
"DCU LTD account",,U,,02/23/2018,"Transfer : Dcu Checking",,,,"",$75000.00,$0.00,$102195.21
"DCU LTD account",,U,,02/28/2018,"interest","Income : Available next month","Income","Available next month","",$0.00,$123.65,$102318.86
"DCU LTD account",,U,,03/31/2018,"interest","Income : Available next month","Income","Available next month","",$0.00,$86.94,$102405.80
"DCU LTD account",,U,,04/30/2018,"interest","Income : Available next month","Income","Available next month","",$0.00,$88.41,$102494.21
"DCU LTD account",,U,,05/03/2018,"Transfer : Dcu Checking",,,,"",$45000.00,$0.00,$57494.21
"DCU LTD account",,U,,05/31/2018,"interest","Income : Available next month","Income","Available next month","",$0.00,$53.89,$57548.10
"DCU LTD account",,U,,06/30/2018,"interest","Income : Available next month","Income","Available next month","",$0.00,$49.69,$57597.79
"DCU LTD account",,U,,07/31/2018,"interest","Income : Available next month","Income","Available next month","",$0.00,$51.39,$57649.18
"DCU LTD account",,U,,08/31/2018,"interest","Income : Available next month","Income","Available next month","",$0.00,$51.43,$57700.61
"DCU LTD account",,U,,09/30/2018,"interest","Income : Available next month","Income","Available next month","",$0.00,$49.82,$57750.43
"DCU LTD account",,U,,10/31/2018,"interest","Income : Available next month","Income","Available next month","",$0.00,$68.71,$57819.14
"DCU LTD account",,U,,11/30/2018,"interest","Income : Available next month","Income","Available next month","",$0.00,$66.57,$57885.71
"DCU LTD account",,U,,12/31/2018,"interest","Income : Available next month","Income","Available next month","",$0.00,$68.87,$57954.58
"DCU LTD account",,U,,01/30/2019,"interest","Income : Available next month","Income","Available next month","",$0.00,$72.13,$58026.71
"DCU LTD account",,U,,02/28/2019,"interest","Income : Available next month","Income","Available next month","",$0.00,$84.64,$58111.35
"DCU LTD account",,U,,03/14/2019,"Transfer : Dcu Checking",,,,"",$10000.00,$0.00,$48111.35
"DCU LTD account",,U,,03/31/2019,"interest","Income : Available next month","Income","Available next month","",$0.00,$84.47,$48195.82
"DCU LTD account",,U,,04/30/2019,"interest","Income : Available next month","Income","Available next month","",$0.00,$75.32,$48271.14
"DCU LTD account",,U,,05/20/2019,"Transfer : Dcu Checking",,,,"",$10000.00,$0.00,$38271.14
"DCU LTD account",,U,,05/31/2019,"interest","Income : Available next month","Income","Available next month","",$0.00,$71.71,$38342.85
"DCU LTD account",,U,,06/30/2019,"interest","Income : Available next month","Income","Available next month","",$0.00,$59.92,$38402.77
"DCU LTD account",,U,,07/31/2019,"interest","Income : Available next month","Income","Available next month","",$0.00,$62.02,$38464.79
"DCU LTD account",,U,,08/03/2019,"Transfer : Dcu Checking",,,,"",$7500.00,$0.00,$30964.79
"DCU LTD account",,U,,08/31/2019,"interest","Income : Available next month","Income","Available next month","",$0.00,$50.79,$31015.58
"DCU LTD account",,U,,09/30/2019,"interest","Income : Available next month","Income","Available next month","",$0.00,$48.47,$31064.05
"DCU LTD account",,U,,10/31/2019,"interest","Income : Available next month","Income","Available next month","",$0.00,$50.17,$31114.22
"DCU LTD account",,U,,11/07/2019,"Transfer : Dcu Checking",,,,"",$11000.00,$0.00,$20114.22
"DCU LTD account",,U,,11/30/2019,"interest","Income : Available next month","Income","Available next month","",$0.00,$9.73,$20123.95
"DCU LTD account",,U,,12/29/2019,"Transfer : Dcu Checking",,,,"",$7000.00,$0.00,$13123.95
"DCU LTD account",,U,,02/07/2020,"Transfer : Dcu Checking",,,,"",$5500.00,$0.00,$7623.95
"DCU LTD account",,U,,03/02/2020,"Transfer : Dcu Checking",,,,"",$5000.00,$0.00,$2623.95
"DCU LTD account",,U,,04/17/2020,"Transfer : DCU Savings",,,,"",$2623.94,$0.00,$0.01
"Etrade Taxable",,U,,03/02/2018,"Transfer : Dcu Checking",,,,"Invest",$0.00,$50000.00,$50000.00
"Etrade Taxable",,C,,03/02/2018,"Starting Balance","Income : Available next month","Income","Available next month","",$0.00,$12.86,$50012.86
"Etrade Taxable",,U,,05/12/2020,"Transfer : Dcu Checking",,,,"",$100.00,$0.00,$49912.86
"Etrade Taxable",,U,,05/14/2020,"Transfer : Dcu Checking",,,,"",$2000.00,$0.00,$47912.86
"Etrade Taxable",,U,,06/22/2020,"Transfer : Dcu Checking",,,,"",$4000.00,$0.00,$43912.86
"Etrade Taxable",,U,,07/31/2020,"Transfer : Dcu Checking",,,,"",$4000.00,$0.00,$39912.86
"Etrade Taxable",,U,,09/21/2020,"Transfer : Dcu Checking",,,,"",$4000.00,$0.00,$35912.86
"Etrade Taxable",,U,,09/28/2020,"Transfer : Dcu Checking",,,,"",$5000.00,$0.00,$30912.86
"Etrade Taxable",,U,,10/15/2020,"Transfer : Dcu Checking",,,,"",$4000.00,$0.00,$26912.86
"Etrade Taxable",,U,,11/12/2020,"Transfer : Dcu Checking",,,,"",$3000.00,$0.00,$23912.86
"Etrade Taxable",,U,,12/14/2020,"Transfer : Dcu Checking",,,,"",$5000.00,$0.00,$18912.86
"Etrade Taxable",,U,,12/15/2020,"Transfer : Dcu Checking",,,,"",$3000.00,$0.00,$15912.86
"Etrade Taxable",,U,,01/06/2021,"Transfer : Dcu Checking",,,,"",$2000.00,$0.00,$13912.86
"Etrade Taxable",,U,,07/28/2021,"Transfer : Dcu Checking",,,,"",$700.00,$0.00,$13212.86
"Etrade-Retirement",,U,,04/10/2017,"Transfer : Dcu Checking",,,,"",$0.00,$6500.00,$6500.00
"Etrade-Retirement",,U,,04/10/2017,"Transfer : Dcu Checking",,,,"",$0.00,$6500.00,$13000.00
"Etrade-Retirement",,U,,01/20/2021,"Transfer : Dcu Checking",,,,"",$2500.00,$0.00,$10500.00
"Etrade-Retirement",,U,,01/21/2021,"Transfer : Dcu Checking",,,,"",$1487.50,$0.00,$9012.50
"Etrade-Retirement",,U,,01/21/2021,"Transfer : Dcu Checking",,,,"",$1500.00,$0.00,$7512.50
"Etrade-Retirement",,U,,02/02/2021,"Transfer : Dcu Checking",,,,"",$1700.00,$0.00,$5812.50
"Etrade-Retirement",,U,,02/04/2021,"Transfer : Dcu Checking",,,,"",$2550.00,$0.00,$3262.50
"Etrade-Retirement",,C,,02/08/2021,"Starting Balance",,,,,$0.00,$0.00,$3262.50
"Etrade-Retirement",,U,,02/23/2021,"Transfer : Dcu Checking",,,,"",$1487.50,$0.00,$1775.00
"Etrade-Retirement",,U,,02/23/2021,"Transfer : Dcu Checking",,,,"",$1500.00,$0.00,$275.00
"Etrade-Retirement",,U,,03/23/2021,"Transfer : Dcu Checking",,,,"",$1487.50,$0.00,-$1212.50
"Etrade-Retirement",,U,,03/23/2021,"Transfer : Dcu Checking",,,,,$1500.00,$0.00,-$2712.50
"Etrade-Retirement",,U,,04/21/2021,"Transfer : Dcu Checking",,,,"",$1487.50,$0.00,-$4200.00
"Etrade-Retirement",,U,,04/21/2021,"Transfer : Dcu Checking",,,,"",$1500.00,$0.00,-$5700.00
"Etrade-Retirement",,U,,05/11/2021,"Transfer : Dcu Checking",,,,"",$3000.00,$0.00,-$8700.00
"Etrade-Retirement",,U,,05/21/2021,"Transfer : Dcu Checking",,,,"",$1487.50,$0.00,-$10187.50
"Etrade-Retirement",,U,,05/21/2021,"Transfer : Dcu Checking",,,,"",$1500.00,$0.00,-$11687.50
"Etrade-Retirement",,U,,06/21/2021,"Transfer : Dcu Checking",,,,"",$1487.50,$0.00,-$13175.00
"Etrade-Retirement",,U,,06/21/2021,"Transfer : Dcu Checking",,,,"",$1500.00,$0.00,-$14675.00
"Etrade-Retirement",,U,,07/17/2021,"Transfer : Dcu Checking",,,,"",$1487.50,$0.00,-$16162.50
"Etrade-Retirement",,U,,07/21/2021,"Transfer : Dcu Checking",,,,"",$1500.00,$0.00,-$17662.50
"Etrade-Retirement",,U,,08/03/2021,"Transfer : Dcu Checking",,,,,$1000.00,$0.00,-$18662.50
"Etrade-Retirement",,U,,08/03/2021,"Transfer : Dcu Checking",,,,,$1600.00,$0.00,-$20262.50
"Etrade-Retirement",,U,,08/23/2021,"Transfer : Dcu Checking",,,,,$1487.50,$0.00,-$21750.00
"Etrade-Retirement",,U,,08/23/2021,"Transfer : Dcu Checking",,,,,$1500.00,$0.00,-$23250.00
"Etrade-Retirement",,U,,08/27/2021,"Transfer : Dcu Checking",,,,"",$1275.00,$0.00,-$24525.00
"Etrade-Retirement",,U,,09/21/2021,"Transfer : Dcu Checking",,,,,$1487.50,$0.00,-$26012.50
"Etrade-Retirement",,U,,09/21/2021,"Transfer : Dcu Checking",,,,,$1500.00,$0.00,-$27512.50
"Etrade-Retirement",,U,,09/21/2021,"Transfer : Dcu Checking",,,,,$1700.00,$0.00,-$29212.50
"Etrade-Retirement",,U,,09/21/2021,"Transfer : Dcu Checking",,,,"",$2000.00,$0.00,-$31212.50
"Etrade-Retirement",,U,,10/21/2021,"Transfer : Dcu Checking",,,,,$1487.50,$0.00,-$32700.00
"Etrade-Retirement",,U,,10/21/2021,"Transfer : Dcu Checking",,,,,$1500.00,$0.00,-$34200.00
"Etrade-Retirement",,U,,11/22/2021,"Transfer : Dcu Checking",,,,,$4000.00,$0.00,-$38200.00
"Etrade-Retirement",,U,,11/23/2021,"Transfer : Dcu Checking",,,,,$1487.50,$0.00,-$39687.50
"Etrade-Retirement",,U,,11/23/2021,"Transfer : Dcu Checking",,,,,$1500.00,$0.00,-$41187.50
